,GEOID,AGE,FEM,MALE,TOT
0,1001,15-19,1905,1904,3809
1,1001,20-24,1578,1636,3214
2,1001,25-29,1908,1878,3786
3,1001,30-34,2144,1845,3989
4,1001,35-39,2025,1993,4018
5,1001,40-44,2040,1858,3898
6,1001,45-49,1971,1854,3825
7,1001,50-54,1991,1922,3913
8,1001,55-59,2070,2008,4078
9,1001,60-64,1965,1819,3784
10,1001,65+,5256,4228,9484
11,1003,15-19,7116,7202,14318
12,1003,20-24,5967,5867,11834
13,1003,25-29,6245,6252,12497
14,1003,30-34,7100,6624,13724
15,1003,35-39,7182,6930,14112
16,1003,40-44,7674,7182,14856
17,1003,45-49,7444,7059,14503
18,1003,50-54,8135,7674,15809
19,1003,55-59,8877,8054,16931
20,1003,60-64,9544,8428,17972
21,1003,65+,27462,23914,51376
22,1005,15-19,687,732,1419
23,1005,20-24,579,897,1476
24,1005,25-29,632,1076,1708
25,1005,30-34,616,1062,1678
26,1005,35-39,670,931,1601
27,1005,40-44,606,984,1590
28,1005,45-49,646,881,1527
29,1005,50-54,700,818,1518
30,1005,55-59,827,874,1701
31,1005,60-64,764,773,1537
32,1005,65+,2806,2181,4987
33,1007,15-19,556,691,1247
34,1007,20-24,532,776,1308
35,1007,25-29,659,991,1650
36,1007,30-34,662,1024,1686
37,1007,35-39,623,940,1563
38,1007,40-44,603,839,1442
39,1007,45-49,675,904,1579
40,1007,50-54,705,843,1548
41,1007,55-59,752,852,1604
42,1007,60-64,684,712,1396
43,1007,65+,2085,1677,3762
44,1009,15-19,1859,1861,3720
45,1009,20-24,1551,1695,3246
46,1009,25-29,1736,1793,3529
47,1009,30-34,1789,1756,3545
48,1009,35-39,1735,1716,3451
49,1009,40-44,1774,1876,3650
50,1009,45-49,1864,1879,3743
51,1009,50-54,1983,2024,4007
52,1009,55-59,2036,2073,4109
53,1009,60-64,1863,1963,3826
54,1009,65+,5983,5073,11056
55,1011,15-19,253,315,568
56,1011,20-24,223,325,548
57,1011,25-29,246,456,702
58,1011,30-34,282,502,784
59,1011,35-39,266,485,751
60,1011,40-44,293,399,692
61,1011,45-49,240,429,669
62,1011,50-54,243,353,596
63,1011,55-59,311,336,647
64,1011,60-64,343,369,712
65,1011,65+,1010,806,1816
66,1013,15-19,508,617,1125
67,1013,20-24,505,531,1036
68,1013,25-29,530,493,1023
69,1013,30-34,596,487,1083
70,1013,35-39,606,508,1114
71,1013,40-44,688,524,1212
72,1013,45-49,582,484,1066
73,1013,50-54,614,532,1146
74,1013,55-59,672,519,1191
75,1013,60-64,716,635,1351
76,1013,65+,2359,1652,4011
77,1015,15-19,3793,3968,7761
78,1015,20-24,3836,3799,7635
79,1015,25-29,3666,3543,7209
80,1015,30-34,3894,3692,7586
81,1015,35-39,3539,3384,6923
82,1015,40-44,3661,3418,7079
83,1015,45-49,3450,3287,6737
84,1015,50-54,3776,3541,7317
85,1015,55-59,3911,3818,7729
86,1015,60-64,4194,3728,7922
87,1015,65+,12092,9319,21411
88,1017,15-19,926,972,1898
89,1017,20-24,941,959,1900
90,1017,25-29,1170,1083,2253
91,1017,30-34,1058,1063,2121
92,1017,35-39,1035,855,1890
93,1017,40-44,1010,932,1942
94,1017,45-49,1142,989,2131
95,1017,50-54,1216,1179,2395
96,1017,55-59,1320,1202,2522
97,1017,60-64,1312,1237,2549
98,1017,65+,3963,3045,7008
99,1019,15-19,683,666,1349
100,1019,20-24,643,642,1285
101,1019,25-29,656,718,1374
102,1019,30-34,651,671,1322
103,1019,35-39,625,564,1189
104,1019,40-44,660,649,1309
105,1019,45-49,779,780,1559
106,1019,50-54,846,918,1764
107,1019,55-59,952,999,1951
108,1019,60-64,1068,1022,2090
109,1019,65+,3135,2858,5993
110,1021,15-19,1440,1483,2923
111,1021,20-24,1228,1341,2569
112,1021,25-29,1448,1380,2828
113,1021,30-34,1383,1391,2774
114,1021,35-39,1344,1327,2671
115,1021,40-44,1496,1362,2858
116,1021,45-49,1373,1440,2813
117,1021,50-54,1434,1556,2990
118,1021,55-59,1551,1517,3068
119,1021,60-64,1531,1513,3044
120,1021,65+,4309,3599,7908
121,1023,15-19,318,404,722
122,1023,20-24,335,290,625
123,1023,25-29,337,357,694
124,1023,30-34,325,297,622
125,1023,35-39,340,284,624
126,1023,40-44,361,297,658
127,1023,45-49,386,358,744
128,1023,50-54,425,390,815
129,1023,55-59,498,480,978
130,1023,60-64,543,481,1024
131,1023,65+,1681,1295,2976
132,1025,15-19,691,709,1400
133,1025,20-24,700,638,1338
134,1025,25-29,715,691,1406
135,1025,30-34,677,572,1249
136,1025,35-39,615,580,1195
137,1025,40-44,754,634,1388
138,1025,45-49,746,597,1343
139,1025,50-54,747,728,1475
140,1025,55-59,872,780,1652
141,1025,60-64,849,791,1640
142,1025,65+,2599,2061,4660
143,1027,15-19,344,430,774
144,1027,20-24,400,421,821
145,1027,25-29,399,372,771
146,1027,30-34,422,342,764
147,1027,35-39,408,383,791
148,1027,40-44,418,399,817
149,1027,45-49,461,427,888
150,1027,50-54,486,511,997
151,1027,55-59,562,545,1107
152,1027,60-64,518,534,1052
153,1027,65+,1640,1372,3012
154,1029,15-19,422,472,894
155,1029,20-24,372,412,784
156,1029,25-29,442,406,848
157,1029,30-34,424,460,884
158,1029,35-39,474,418,892
159,1029,40-44,395,442,837
160,1029,45-49,493,493,986
161,1029,50-54,490,541,1031
162,1029,55-59,537,528,1065
163,1029,60-64,542,493,1035
164,1029,65+,1638,1337,2975
165,1031,15-19,1696,1788,3484
166,1031,20-24,1485,1618,3103
167,1031,25-29,1624,1697,3321
168,1031,30-34,1714,1792,3506
169,1031,35-39,1757,1784,3541
170,1031,40-44,1711,1740,3451
171,1031,45-49,1820,1770,3590
172,1031,50-54,1749,1771,3520
173,1031,55-59,1651,1702,3353
174,1031,60-64,1749,1633,3382
175,1031,65+,5185,4087,9272
176,1033,15-19,1572,1612,3184
177,1033,20-24,1614,1581,3195
178,1033,25-29,1795,1739,3534
179,1033,30-34,1908,1865,3773
180,1033,35-39,1707,1658,3365
181,1033,40-44,1746,1601,3347
182,1033,45-49,1763,1640,3403
183,1033,50-54,1971,1912,3883
184,1033,55-59,2083,1977,4060
185,1033,60-64,2126,1831,3957
186,1033,65+,6513,5128,11641
187,1035,15-19,304,306,610
188,1035,20-24,315,298,613
189,1035,25-29,307,310,617
190,1035,30-34,303,298,601
191,1035,35-39,288,276,564
192,1035,40-44,328,278,606
193,1035,45-49,366,287,653
194,1035,50-54,369,361,730
195,1035,55-59,439,382,821
196,1035,60-64,451,431,882
197,1035,65+,1470,1264,2734
198,1037,15-19,221,247,468
199,1037,20-24,235,255,490
200,1037,25-29,268,316,584
201,1037,30-34,242,278,520
202,1037,35-39,267,276,543
203,1037,40-44,278,258,536
204,1037,45-49,345,325,670
205,1037,50-54,409,403,812
206,1037,55-59,432,459,891
207,1037,60-64,487,475,962
208,1037,65+,1289,1293,2582
209,1039,15-19,1087,1154,2241
210,1039,20-24,965,947,1912
211,1039,25-29,1018,1044,2062
212,1039,30-34,1123,1119,2242
213,1039,35-39,1140,965,2105
214,1039,40-44,1090,1060,2150
215,1039,45-49,1107,1021,2128
216,1039,50-54,1175,1183,2358
217,1039,55-59,1371,1269,2640
218,1039,60-64,1398,1364,2762
219,1039,65+,4545,3589,8134
220,1041,15-19,384,438,822
221,1041,20-24,345,329,674
222,1041,25-29,416,381,797
223,1041,30-34,415,423,838
224,1041,35-39,370,327,697
225,1041,40-44,383,368,751
226,1041,45-49,436,366,802
227,1041,50-54,378,423,801
228,1041,55-59,485,441,926
229,1041,60-64,451,496,947
230,1041,65+,1419,1153,2572
231,1043,15-19,2561,2745,5306
232,1043,20-24,2463,2545,5008
233,1043,25-29,2718,2826,5544
234,1043,30-34,2985,3011,5996
235,1043,35-39,2625,2720,5345
236,1043,40-44,2705,2720,5425
237,1043,45-49,2765,2787,5552
238,1043,50-54,2811,2926,5737
239,1043,55-59,3101,3137,6238
240,1043,60-64,3042,3012,6054
241,1043,65+,9169,7580,16749
242,1045,15-19,1381,1481,2862
243,1045,20-24,1459,1645,3104
244,1045,25-29,1714,1901,3615
245,1045,30-34,1792,1812,3604
246,1045,35-39,1531,1398,2929
247,1045,40-44,1467,1342,2809
248,1045,45-49,1439,1301,2740
249,1045,50-54,1481,1402,2883
250,1045,55-59,1609,1522,3131
251,1045,60-64,1688,1612,3300
252,1045,65+,4817,3933,8750
253,1047,15-19,1219,1322,2541
254,1047,20-24,1167,1129,2296
255,1047,25-29,1132,940,2072
256,1047,30-34,1186,942,2128
257,1047,35-39,1148,950,2098
258,1047,40-44,1167,970,2137
259,1047,45-49,1188,874,2062
260,1047,50-54,1174,1020,2194
261,1047,55-59,1453,1202,2655
262,1047,60-64,1568,1289,2857
263,1047,65+,4221,3178,7399
264,1049,15-19,2372,2522,4894
265,1049,20-24,2072,2170,4242
266,1049,25-29,2107,2217,4324
267,1049,30-34,2078,2122,4200
268,1049,35-39,2025,1992,4017
269,1049,40-44,2273,2246,4519
270,1049,45-49,2235,2321,4556
271,1049,50-54,2371,2474,4845
272,1049,55-59,2379,2355,4734
273,1049,60-64,2356,2365,4721
274,1049,65+,6924,5770,12694
275,1051,15-19,2685,2824,5509
276,1051,20-24,2572,2853,5425
277,1051,25-29,3032,2848,5880
278,1051,30-34,3331,3124,6455
279,1051,35-39,3114,2768,5882
280,1051,40-44,3008,2730,5738
281,1051,45-49,3055,2742,5797
282,1051,50-54,3036,2838,5874
283,1051,55-59,3192,2970,6162
284,1051,60-64,3097,2856,5953
285,1051,65+,7978,6576,14554
286,1053,15-19,1092,1094,2186
287,1053,20-24,991,1029,2020
288,1053,25-29,1058,1351,2409
289,1053,30-34,1091,1418,2509
290,1053,35-39,1056,1214,2270
291,1053,40-44,1008,1269,2277
292,1053,45-49,1054,1267,2321
293,1053,50-54,1121,1214,2335
294,1053,55-59,1175,1202,2377
295,1053,60-64,1204,1156,2360
296,1053,65+,3892,2861,6753
297,1055,15-19,2934,3200,6134
298,1055,20-24,2984,3059,6043
299,1055,25-29,3223,3163,6386
300,1055,30-34,3278,2995,6273
301,1055,35-39,3149,2957,6106
302,1055,40-44,3238,2950,6188
303,1055,45-49,3340,3248,6588
304,1055,50-54,3559,3523,7082
305,1055,55-59,3487,3328,6815
306,1055,60-64,3708,3460,7168
307,1055,65+,11177,8780,19957
308,1057,15-19,465,489,954
309,1057,20-24,407,449,856
310,1057,25-29,467,468,935
311,1057,30-34,450,455,905
312,1057,35-39,514,448,962
313,1057,40-44,437,458,895
314,1057,45-49,465,462,927
315,1057,50-54,534,532,1066
316,1057,55-59,578,586,1164
317,1057,60-64,608,537,1145
318,1057,65+,1929,1591,3520
319,1059,15-19,996,1086,2082
320,1059,20-24,911,984,1895
321,1059,25-29,933,969,1902
322,1059,30-34,967,1000,1967
323,1059,35-39,918,978,1896
324,1059,40-44,933,1006,1939
325,1059,45-49,983,1060,2043
326,1059,50-54,1035,1088,2123
327,1059,55-59,1063,1069,2132
328,1059,60-64,1005,954,1959
329,1059,65+,2961,2497,5458
330,1061,15-19,782,857,1639
331,1061,20-24,656,655,1311
332,1061,25-29,708,734,1442
333,1061,30-34,806,747,1553
334,1061,35-39,812,741,1553
335,1061,40-44,771,784,1555
336,1061,45-49,829,785,1614
337,1061,50-54,929,898,1827
338,1061,55-59,929,977,1906
339,1061,60-64,1019,894,1913
340,1061,65+,3031,2606,5637
341,1063,15-19,230,219,449
342,1063,20-24,205,201,406
343,1063,25-29,202,212,414
344,1063,30-34,217,220,437
345,1063,35-39,203,180,383
346,1063,40-44,213,171,384
347,1063,45-49,199,189,388
348,1063,50-54,237,195,432
349,1063,55-59,288,222,510
350,1063,60-64,299,270,569
351,1063,65+,1080,807,1887
352,1065,15-19,428,434,862
353,1065,20-24,433,396,829
354,1065,25-29,502,443,945
355,1065,30-34,463,384,847
356,1065,35-39,445,415,860
357,1065,40-44,472,357,829
358,1065,45-49,428,346,774
359,1065,50-54,426,381,807
360,1065,55-59,573,483,1056
361,1065,60-64,539,517,1056
362,1065,65+,1650,1320,2970
363,1067,15-19,489,542,1031
364,1067,20-24,418,423,841
365,1067,25-29,441,457,898
366,1067,30-34,508,449,957
367,1067,35-39,514,470,984
368,1067,40-44,583,562,1145
369,1067,45-49,579,564,1143
370,1067,50-54,561,535,1096
371,1067,55-59,641,534,1175
372,1067,60-64,634,600,1234
373,1067,65+,2247,1789,4036
374,1069,15-19,3093,3457,6550
375,1069,20-24,3069,2988,6057
376,1069,25-29,3448,3238,6686
377,1069,30-34,3715,3210,6925
378,1069,35-39,3591,3250,6841
379,1069,40-44,3426,3142,6568
380,1069,45-49,3416,3034,6450
381,1069,50-54,3478,3370,6848
382,1069,55-59,3733,3446,7179
383,1069,60-64,3783,3384,7167
384,1069,65+,11269,8669,19938
385,1071,15-19,1453,1655,3108
386,1071,20-24,1379,1436,2815
387,1071,25-29,1524,1523,3047
388,1071,30-34,1524,1530,3054
389,1071,35-39,1496,1445,2941
390,1071,40-44,1640,1561,3201
391,1071,45-49,1699,1750,3449
392,1071,50-54,1732,1831,3563
393,1071,55-59,1864,1823,3687
394,1071,60-64,2015,1917,3932
395,1071,65+,6051,5010,11061
396,1073,15-19,21068,20961,42029
397,1073,20-24,21800,19959,41759
398,1073,25-29,24221,22464,46685
399,1073,30-34,25235,23129,48364
400,1073,35-39,23411,21092,44503
401,1073,40-44,22451,20182,42633
402,1073,45-49,20410,18630,39040
403,1073,50-54,20716,19224,39940
404,1073,55-59,21733,19386,41119
405,1073,60-64,23166,19690,42856
406,1073,65+,64233,47153,111386
407,1075,15-19,407,417,824
408,1075,20-24,323,384,707
409,1075,25-29,344,340,684
410,1075,30-34,402,373,775
411,1075,35-39,367,354,721
412,1075,40-44,397,395,792
413,1075,45-49,441,445,886
414,1075,50-54,451,451,902
415,1075,55-59,455,491,946
416,1075,60-64,496,495,991
417,1075,65+,1691,1383,3074
418,1077,15-19,3148,3071,6219
419,1077,20-24,4052,3664,7716
420,1077,25-29,2957,2976,5933
421,1077,30-34,2779,2694,5473
422,1077,35-39,2667,2697,5364
423,1077,40-44,2529,2460,4989
424,1077,45-49,2641,2535,5176
425,1077,50-54,2972,2880,5852
426,1077,55-59,3219,3054,6273
427,1077,60-64,3478,3037,6515
428,1077,65+,10752,8553,19305
429,1079,15-19,925,1052,1977
430,1079,20-24,853,901,1754
431,1079,25-29,975,983,1958
432,1079,30-34,1043,992,2035
433,1079,35-39,981,900,1881
434,1079,40-44,924,937,1861
435,1079,45-49,1039,984,2023
436,1079,50-54,1208,1209,2417
437,1079,55-59,1319,1273,2592
438,1079,60-64,1267,1131,2398
439,1079,65+,3393,2879,6272
440,1081,15-19,7230,7246,14476
441,1081,20-24,10523,11456,21979
442,1081,25-29,6294,6311,12605
443,1081,30-34,5997,5657,11654
444,1081,35-39,5761,5406,11167
445,1081,40-44,5591,5220,10811
446,1081,45-49,5239,4837,10076
447,1081,50-54,5419,5190,10609
448,1081,55-59,5159,5033,10192
449,1081,60-64,4981,4726,9707
450,1081,65+,12742,10450,23192
451,1083,15-19,3232,3341,6573
452,1083,20-24,2870,3069,5939
453,1083,25-29,3321,3476,6797
454,1083,30-34,3464,3787,7251
455,1083,35-39,3660,3840,7500
456,1083,40-44,3574,3888,7462
457,1083,45-49,3526,3682,7208
458,1083,50-54,3757,4051,7808
459,1083,55-59,3860,3976,7836
460,1083,60-64,3539,3617,7156
461,1083,65+,9110,7583,16693
462,1085,15-19,272,281,553
463,1085,20-24,269,269,538
464,1085,25-29,288,268,556
465,1085,30-34,360,295,655
466,1085,35-39,249,273,522
467,1085,40-44,307,251,558
468,1085,45-49,270,239,509
469,1085,50-54,347,299,646
470,1085,55-59,416,378,794
471,1085,60-64,422,339,761
472,1085,65+,1145,880,2025
473,1087,15-19,876,782,1658
474,1087,20-24,1194,936,2130
475,1087,25-29,597,524,1121
476,1087,30-34,533,471,1004
477,1087,35-39,476,363,839
478,1087,40-44,457,393,850
479,1087,45-49,513,429,942
480,1087,50-54,559,479,1038
481,1087,55-59,706,549,1255
482,1087,60-64,686,613,1299
483,1087,65+,2382,1683,4065
484,1089,15-19,12207,12813,25020
485,1089,20-24,12764,13092,25856
486,1089,25-29,13489,14595,28084
487,1089,30-34,14085,14108,28193
488,1089,35-39,13309,13433,26742
489,1089,40-44,12448,11954,24402
490,1089,45-49,11823,11026,22849
491,1089,50-54,13035,12576,25611
492,1089,55-59,14904,14436,29340
493,1089,60-64,13574,13610,27184
494,1089,65+,33932,27330,61262
495,1091,15-19,575,597,1172
496,1091,20-24,493,529,1022
497,1091,25-29,632,558,1190
498,1091,30-34,574,566,1140
499,1091,35-39,544,464,1008
500,1091,40-44,584,498,1082
501,1091,45-49,604,531,1135
502,1091,50-54,688,553,1241
503,1091,55-59,684,628,1312
504,1091,60-64,741,581,1322
505,1091,65+,2143,1717,3860
506,1093,15-19,803,880,1683
507,1093,20-24,724,851,1575
508,1093,25-29,804,844,1648
509,1093,30-34,869,885,1754
510,1093,35-39,783,799,1582
511,1093,40-44,873,868,1741
512,1093,45-49,870,914,1784
513,1093,50-54,1004,1061,2065
514,1093,55-59,1040,1110,2150
515,1093,60-64,1048,1011,2059
516,1093,65+,3377,2795,6172
517,1095,15-19,3247,3391,6638
518,1095,20-24,2658,2879,5537
519,1095,25-29,2872,3000,5872
520,1095,30-34,3010,3026,6036
521,1095,35-39,2892,2979,5871
522,1095,40-44,2817,2883,5700
523,1095,45-49,2897,2823,5720
524,1095,50-54,3089,3282,6371
525,1095,55-59,3257,3168,6425
526,1095,60-64,3252,3169,6421
527,1095,65+,9465,7429,16894
528,1097,15-19,12905,13227,26132
529,1097,20-24,13297,12759,26056
530,1097,25-29,14553,13666,28219
531,1097,30-34,15223,13597,28820
532,1097,35-39,13899,12052,25951
533,1097,40-44,13016,11816,24832
534,1097,45-49,12420,11158,23578
535,1097,50-54,12963,11785,24748
536,1097,55-59,14065,12899,26964
537,1097,60-64,14472,12758,27230
538,1097,65+,39537,30793,70330
539,1099,15-19,574,651,1225
540,1099,20-24,587,582,1169
541,1099,25-29,583,572,1155
542,1099,30-34,540,478,1018
543,1099,35-39,548,441,989
544,1099,40-44,614,503,1117
545,1099,45-49,642,566,1208
546,1099,50-54,670,597,1267
547,1099,55-59,713,713,1426
548,1099,60-64,782,699,1481
549,1099,65+,2408,1865,4273
550,1101,15-19,7213,7659,14872
551,1101,20-24,8012,7651,15663
552,1101,25-29,8069,7472,15541
553,1101,30-34,8621,7694,16315
554,1101,35-39,7888,6955,14843
555,1101,40-44,7455,6580,14035
556,1101,45-49,7087,5939,13026
557,1101,50-54,7155,6371,13526
558,1101,55-59,7589,6534,14123
559,1101,60-64,7646,6314,13960
560,1101,65+,21115,15233,36348
561,1103,15-19,3758,4071,7829
562,1103,20-24,3363,3560,6923
563,1103,25-29,3698,3677,7375
564,1103,30-34,3706,3816,7522
565,1103,35-39,3767,3750,7517
566,1103,40-44,3838,3911,7749
567,1103,45-49,3628,3837,7465
568,1103,50-54,4157,4018,8175
569,1103,55-59,4444,4447,8891
570,1103,60-64,4209,4166,8375
571,1103,65+,12486,9862,22348
572,1105,15-19,359,422,781
573,1105,20-24,368,329,697
574,1105,25-29,257,226,483
575,1105,30-34,221,187,408
576,1105,35-39,206,200,406
577,1105,40-44,262,185,447
578,1105,45-49,251,194,445
579,1105,50-54,241,228,469
580,1105,55-59,277,225,502
581,1105,60-64,321,266,587
582,1105,65+,1025,693,1718
583,1107,15-19,442,616,1058
584,1107,20-24,501,670,1171
585,1107,25-29,561,624,1185
586,1107,30-34,597,700,1297
587,1107,35-39,587,639,1226
588,1107,40-44,570,544,1114
589,1107,45-49,597,597,1194
590,1107,50-54,653,551,1204
591,1107,55-59,692,703,1395
592,1107,60-64,677,645,1322
593,1107,65+,2026,1635,3661
594,1109,15-19,1525,1247,2772
595,1109,20-24,2767,2565,5332
596,1109,25-29,1014,1239,2253
597,1109,30-34,879,889,1768
598,1109,35-39,909,801,1710
599,1109,40-44,867,759,1626
600,1109,45-49,848,750,1598
601,1109,50-54,936,816,1752
602,1109,55-59,963,816,1779
603,1109,60-64,989,876,1865
604,1109,65+,2912,2322,5234
605,1111,15-19,667,697,1364
606,1111,20-24,592,628,1220
607,1111,25-29,639,615,1254
608,1111,30-34,633,549,1182
609,1111,35-39,576,513,1089
610,1111,40-44,593,596,1189
611,1111,45-49,654,631,1285
612,1111,50-54,786,756,1542
613,1111,55-59,854,813,1667
614,1111,60-64,856,843,1699
615,1111,65+,2557,2117,4674
616,1113,15-19,1659,1777,3436
617,1113,20-24,1798,1643,3441
618,1113,25-29,2304,2049,4353
619,1113,30-34,2246,2063,4309
620,1113,35-39,2070,1818,3888
621,1113,40-44,1874,1653,3527
622,1113,45-49,1778,1645,3423
623,1113,50-54,1858,1750,3608
624,1113,55-59,2040,1947,3987
625,1113,60-64,2006,1844,3850
626,1113,65+,5122,3767,8889
627,1115,15-19,2610,2910,5520
628,1115,20-24,2223,2441,4664
629,1115,25-29,2727,2846,5573
630,1115,30-34,3159,3287,6446
631,1115,35-39,3150,3076,6226
632,1115,40-44,2983,2989,5972
633,1115,45-49,3015,2986,6001
634,1115,50-54,3171,3230,6401
635,1115,55-59,3250,3192,6442
636,1115,60-64,3186,3043,6229
637,1115,65+,8947,7216,16163
638,1117,15-19,7575,7736,15311
639,1117,20-24,6790,6544,13334
640,1117,25-29,6838,6520,13358
641,1117,30-34,7349,6747,14096
642,1117,35-39,7819,7199,15018
643,1117,40-44,8069,7707,15776
644,1117,45-49,7794,7760,15554
645,1117,50-54,8136,7809,15945
646,1117,55-59,7677,7322,14999
647,1117,60-64,7392,6891,14283
648,1117,65+,20578,16807,37385
649,1119,15-19,485,415,900
650,1119,20-24,873,687,1560
651,1119,25-29,405,410,815
652,1119,30-34,323,300,623
653,1119,35-39,265,256,521
654,1119,40-44,288,225,513
655,1119,45-49,330,260,590
656,1119,50-54,353,308,661
657,1119,55-59,413,311,724
658,1119,60-64,460,382,842
659,1119,65+,1390,1025,2415
660,1121,15-19,2633,2387,5020
661,1121,20-24,2652,2347,4999
662,1121,25-29,2435,2627,5062
663,1121,30-34,2668,2703,5371
664,1121,35-39,2546,2338,4884
665,1121,40-44,2531,2361,4892
666,1121,45-49,2507,2515,5022
667,1121,50-54,2843,2770,5613
668,1121,55-59,2885,2735,5620
669,1121,60-64,3060,2754,5814
670,1121,65+,8401,7034,15435
671,1123,15-19,1086,1127,2213
672,1123,20-24,1077,1090,2167
673,1123,25-29,1155,1171,2326
674,1123,30-34,1231,1161,2392
675,1123,35-39,1087,955,2042
676,1123,40-44,1106,1054,2160
677,1123,45-49,1227,1058,2285
678,1123,50-54,1479,1357,2836
679,1123,55-59,1557,1536,3093
680,1123,60-64,1690,1593,3283
681,1123,65+,4983,4356,9339
682,1125,15-19,9687,9099,18786
683,1125,20-24,12776,12233,25009
684,1125,25-29,8199,7743,15942
685,1125,30-34,8363,7966,16329
686,1125,35-39,7125,6690,13815
687,1125,40-44,7083,6628,13711
688,1125,45-49,6730,6092,12822
689,1125,50-54,6493,6204,12697
690,1125,55-59,6573,6147,12720
691,1125,60-64,6653,6067,12720
692,1125,65+,18123,14183,32306
693,1127,15-19,1763,1966,3729
694,1127,20-24,1831,1819,3650
695,1127,25-29,1947,2036,3983
696,1127,30-34,1989,1954,3943
697,1127,35-39,1740,1693,3433
698,1127,40-44,1961,1858,3819
699,1127,45-49,1922,1949,3871
700,1127,50-54,2126,2225,4351
701,1127,55-59,2272,2250,4522
702,1127,60-64,2413,2142,4555
703,1127,65+,7166,5692,12858
704,1129,15-19,429,504,933
705,1129,20-24,416,463,879
706,1129,25-29,424,452,876
707,1129,30-34,415,422,837
708,1129,35-39,451,395,846
709,1129,40-44,437,411,848
710,1129,45-49,470,421,891
711,1129,50-54,536,533,1069
712,1129,55-59,565,560,1125
713,1129,60-64,596,557,1153
714,1129,65+,1678,1370,3048
715,1131,15-19,347,326,673
716,1131,20-24,326,348,674
717,1131,25-29,309,327,636
718,1131,30-34,293,291,584
719,1131,35-39,260,227,487
720,1131,40-44,353,250,603
721,1131,45-49,316,257,573
722,1131,50-54,350,272,622
723,1131,55-59,391,344,735
724,1131,60-64,359,330,689
725,1131,65+,1234,981,2215
726,1133,15-19,661,704,1365
727,1133,20-24,633,624,1257
728,1133,25-29,637,648,1285
729,1133,30-34,625,604,1229
730,1133,35-39,648,599,1247
731,1133,40-44,662,669,1331
732,1133,45-49,705,748,1453
733,1133,50-54,811,865,1676
734,1133,55-59,901,960,1861
735,1133,60-64,915,884,1799
736,1133,65+,2861,2384,5245
737,2013,15-19,32,50,82
738,2013,20-24,49,199,248
739,2013,25-29,63,238,301
740,2013,30-34,56,177,233
741,2013,35-39,78,219,297
742,2013,40-44,115,251,366
743,2013,45-49,118,285,403
744,2013,50-54,136,247,383
745,2013,55-59,110,183,293
746,2013,60-64,84,107,191
747,2013,65+,173,226,399
748,2016,15-19,80,96,176
749,2016,20-24,91,210,301
750,2016,25-29,102,343,445
751,2016,30-34,144,291,435
752,2016,35-39,139,311,450
753,2016,40-44,136,371,507
754,2016,45-49,140,351,491
755,2016,50-54,175,370,545
756,2016,55-59,135,290,425
757,2016,60-64,116,245,361
758,2016,65+,154,260,414
759,2020,15-19,8322,9185,17507
760,2020,20-24,9046,11699,20745
761,2020,25-29,10963,12325,23288
762,2020,30-34,12042,12434,24476
763,2020,35-39,11103,11711,22814
764,2020,40-44,9142,9322,18464
765,2020,45-49,7924,8289,16213
766,2020,50-54,8304,8700,17004
767,2020,55-59,8583,8644,17227
768,2020,60-64,8264,8402,16666
769,2020,65+,18775,17199,35974
770,2050,15-19,776,785,1561
771,2050,20-24,650,726,1376
772,2050,25-29,657,676,1333
773,2050,30-34,655,724,1379
774,2050,35-39,543,612,1155
775,2050,40-44,464,494,958
776,2050,45-49,385,441,826
777,2050,50-54,403,483,886
778,2050,55-59,437,550,987
779,2050,60-64,377,501,878
780,2050,65+,781,771,1552
781,2060,15-19,16,15,31
782,2060,20-24,17,22,39
783,2060,25-29,32,31,63
784,2060,30-34,38,29,67
785,2060,35-39,28,26,54
786,2060,40-44,17,25,42
787,2060,45-49,16,28,44
788,2060,50-54,20,29,49
789,2060,55-59,31,37,68
790,2060,60-64,34,43,77
791,2060,65+,61,87,148
792,2063,15-19,159,188,347
793,2063,20-24,158,189,347
794,2063,25-29,197,205,402
795,2063,30-34,234,262,496
796,2063,35-39,224,287,511
797,2063,40-44,218,231,449
798,2063,45-49,159,199,358
799,2063,50-54,187,266,453
800,2063,55-59,235,301,536
801,2063,60-64,282,331,613
802,2063,65+,537,546,1083
803,2066,15-19,82,87,169
804,2066,20-24,52,72,124
805,2066,25-29,58,73,131
806,2066,30-34,79,66,145
807,2066,35-39,74,101,175
808,2066,40-44,82,93,175
809,2066,45-49,52,72,124
810,2066,50-54,67,93,160
811,2066,55-59,72,90,162
812,2066,60-64,90,117,207
813,2066,65+,228,276,504
814,2068,15-19,30,32,62
815,2068,20-24,36,41,77
816,2068,25-29,44,87,131
817,2068,30-34,64,75,139
818,2068,35-39,63,65,128
819,2068,40-44,62,61,123
820,2068,45-49,53,72,125
821,2068,50-54,50,64,114
822,2068,55-59,77,62,139
823,2068,60-64,43,68,111
824,2068,65+,84,120,204
825,2070,15-19,167,166,333
826,2070,20-24,147,177,324
827,2070,25-29,176,196,372
828,2070,30-34,192,191,383
829,2070,35-39,135,163,298
830,2070,40-44,119,124,243
831,2070,45-49,81,97,178
832,2070,50-54,106,116,222
833,2070,55-59,158,160,318
834,2070,60-64,126,155,281
835,2070,65+,256,272,528
836,2090,15-19,2680,2992,5672
837,2090,20-24,3408,6259,9667
838,2090,25-29,3898,5360,9258
839,2090,30-34,3767,4351,8118
840,2090,35-39,3350,3997,7347
841,2090,40-44,2586,3087,5673
842,2090,45-49,2232,2455,4687
843,2090,50-54,2181,2434,4615
844,2090,55-59,2452,2523,4975
845,2090,60-64,2415,2548,4963
846,2090,65+,5559,5807,11366
847,2100,15-19,59,57,116
848,2100,20-24,47,37,84
849,2100,25-29,46,65,111
850,2100,30-34,47,50,97
851,2100,35-39,68,70,138
852,2100,40-44,61,61,122
853,2100,45-49,56,58,114
854,2100,50-54,67,62,129
855,2100,55-59,84,89,173
856,2100,60-64,87,108,195
857,2100,65+,248,252,500
858,2105,15-19,58,49,107
859,2105,20-24,43,41,84
860,2105,25-29,39,66,105
861,2105,30-34,58,83,141
862,2105,35-39,57,66,123
863,2105,40-44,70,46,116
864,2105,45-49,46,68,114
865,2105,50-54,61,109,170
866,2105,55-59,104,105,209
867,2105,60-64,107,125,232
868,2105,65+,247,349,596
869,2110,15-19,969,936,1905
870,2110,20-24,906,947,1853
871,2110,25-29,1052,1190,2242
872,2110,30-34,1223,1179,2402
873,2110,35-39,1228,1281,2509
874,2110,40-44,1044,1109,2153
875,2110,45-49,926,1045,1971
876,2110,50-54,1050,1092,2142
877,2110,55-59,1070,1178,2248
878,2110,60-64,1077,1159,2236
879,2110,65+,2494,2369,4863
880,2122,15-19,1613,1872,3485
881,2122,20-24,1341,1602,2943
882,2122,25-29,1656,1890,3546
883,2122,30-34,1888,2051,3939
884,2122,35-39,1833,2109,3942
885,2122,40-44,1714,1950,3664
886,2122,45-49,1557,1749,3306
887,2122,50-54,1725,1907,3632
888,2122,55-59,1905,2003,3908
889,2122,60-64,2302,2447,4749
890,2122,65+,5585,6031,11616
891,2130,15-19,371,428,799
892,2130,20-24,370,417,787
893,2130,25-29,415,507,922
894,2130,30-34,476,465,941
895,2130,35-39,484,515,999
896,2130,40-44,422,482,904
897,2130,45-49,384,395,779
898,2130,50-54,436,434,870
899,2130,55-59,441,522,963
900,2130,60-64,509,531,1040
901,2130,65+,1227,1211,2438
902,2150,15-19,320,374,694
903,2150,20-24,332,492,824
904,2150,25-29,435,512,947
905,2150,30-34,523,605,1128
906,2150,35-39,516,559,1075
907,2150,40-44,421,449,870
908,2150,45-49,292,343,635
909,2150,50-54,323,345,668
910,2150,55-59,365,447,812
911,2150,60-64,349,478,827
912,2150,65+,839,844,1683
913,2158,15-19,349,395,744
914,2158,20-24,270,306,576
915,2158,25-29,305,300,605
916,2158,30-34,255,385,640
917,2158,35-39,214,242,456
918,2158,40-44,160,185,345
919,2158,45-49,144,172,316
920,2158,50-54,161,184,345
921,2158,55-59,179,213,392
922,2158,60-64,159,189,348
923,2158,65+,308,258,566
924,2164,15-19,53,43,96
925,2164,20-24,44,39,83
926,2164,25-29,50,42,92
927,2164,30-34,42,50,92
928,2164,35-39,47,43,90
929,2164,40-44,36,51,87
930,2164,45-49,40,47,87
931,2164,50-54,34,43,77
932,2164,55-59,40,56,96
933,2164,60-64,49,53,102
934,2164,65+,83,92,175
935,2170,15-19,3571,4056,7627
936,2170,20-24,2816,3416,6232
937,2170,25-29,3465,3809,7274
938,2170,30-34,3858,4269,8127
939,2170,35-39,4045,4381,8426
940,2170,40-44,3490,3920,7410
941,2170,45-49,3003,3492,6495
942,2170,50-54,3108,3354,6462
943,2170,55-59,3317,3668,6985
944,2170,60-64,3441,3737,7178
945,2170,65+,7316,7300,14616
946,2180,15-19,390,409,799
947,2180,20-24,315,395,710
948,2180,25-29,347,381,728
949,2180,30-34,370,385,755
950,2180,35-39,296,341,637
951,2180,40-44,254,311,565
952,2180,45-49,243,249,492
953,2180,50-54,212,234,446
954,2180,55-59,242,294,536
955,2180,60-64,223,270,493
956,2180,65+,394,464,858
957,2185,15-19,352,367,719
958,2185,20-24,256,374,630
959,2185,25-29,269,495,764
960,2185,30-34,360,569,929
961,2185,35-39,267,591,858
962,2185,40-44,244,436,680
963,2185,45-49,204,463,667
964,2185,50-54,206,539,745
965,2185,55-59,229,719,948
966,2185,60-64,202,404,606
967,2185,65+,372,493,865
968,2188,15-19,297,326,623
969,2188,20-24,248,251,499
970,2188,25-29,242,260,502
971,2188,30-34,274,350,624
972,2188,35-39,196,235,431
973,2188,40-44,172,233,405
974,2188,45-49,154,178,332
975,2188,50-54,149,240,389
976,2188,55-59,171,257,428
977,2188,60-64,155,207,362
978,2188,65+,306,318,624
979,2195,15-19,85,82,167
980,2195,20-24,72,102,174
981,2195,25-29,85,76,161
982,2195,30-34,115,116,231
983,2195,35-39,114,107,221
984,2195,40-44,105,111,216
985,2195,45-49,76,91,167
986,2195,50-54,92,125,217
987,2195,55-59,102,121,223
988,2195,60-64,121,128,249
989,2195,65+,338,381,719
990,2198,15-19,131,187,318
991,2198,20-24,122,159,281
992,2198,25-29,133,153,286
993,2198,30-34,192,155,347
994,2198,35-39,166,197,363
995,2198,40-44,133,175,308
996,2198,45-49,139,179,318
997,2198,50-54,185,199,384
998,2198,55-59,207,277,484
999,2198,60-64,227,247,474
1000,2198,65+,481,660,1141
1001,2220,15-19,217,249,466
1002,2220,20-24,215,260,475
1003,2220,25-29,283,307,590
1004,2220,30-34,309,302,611
1005,2220,35-39,290,306,596
1006,2220,40-44,288,312,600
1007,2220,45-49,260,272,532
1008,2220,50-54,236,256,492
1009,2220,55-59,285,275,560
1010,2220,60-64,299,344,643
1011,2220,65+,749,698,1447
1012,2230,15-19,17,17,34
1013,2230,20-24,16,16,32
1014,2230,25-29,38,41,79
1015,2230,30-34,43,50,93
1016,2230,35-39,62,76,138
1017,2230,40-44,56,75,131
1018,2230,45-49,38,38,76
1019,2230,50-54,46,42,88
1020,2230,55-59,22,36,58
1021,2230,60-64,35,38,73
1022,2230,65+,84,105,189
1023,2240,15-19,205,212,417
1024,2240,20-24,144,183,327
1025,2240,25-29,178,243,421
1026,2240,30-34,228,289,517
1027,2240,35-39,199,281,480
1028,2240,40-44,199,260,459
1029,2240,45-49,155,215,370
1030,2240,50-54,179,258,437
1031,2240,55-59,185,251,436
1032,2240,60-64,193,266,459
1033,2240,65+,485,576,1061
1034,2275,15-19,46,49,95
1035,2275,20-24,35,51,86
1036,2275,25-29,57,63,120
1037,2275,30-34,58,68,126
1038,2275,35-39,49,50,99
1039,2275,40-44,39,62,101
1040,2275,45-49,49,50,99
1041,2275,50-54,67,55,122
1042,2275,55-59,65,80,145
1043,2275,60-64,92,105,197
1044,2275,65+,228,288,516
1045,2282,15-19,17,16,33
1046,2282,20-24,13,11,24
1047,2282,25-29,22,30,52
1048,2282,30-34,24,23,47
1049,2282,35-39,16,24,40
1050,2282,40-44,18,22,40
1051,2282,45-49,12,27,39
1052,2282,50-54,20,36,56
1053,2282,55-59,24,40,64
1054,2282,60-64,21,28,49
1055,2282,65+,49,89,138
1056,2290,15-19,147,190,337
1057,2290,20-24,158,153,311
1058,2290,25-29,144,149,293
1059,2290,30-34,164,168,332
1060,2290,35-39,143,187,330
1061,2290,40-44,124,177,301
1062,2290,45-49,125,142,267
1063,2290,50-54,115,121,236
1064,2290,55-59,166,176,342
1065,2290,60-64,178,198,376
1066,2290,65+,380,500,880
1067,4001,15-19,2572,2519,5091
1068,4001,20-24,2024,1990,4014
1069,4001,25-29,2003,2197,4200
1070,4001,30-34,2037,2263,4300
1071,4001,35-39,1793,2052,3845
1072,4001,40-44,1758,1895,3653
1073,4001,45-49,1713,1727,3440
1074,4001,50-54,1828,1788,3616
1075,4001,55-59,2243,2080,4323
1076,4001,60-64,2228,2044,4272
1077,4001,65+,5833,4873,10706
1078,4003,15-19,3635,4288,7923
1079,4003,20-24,3120,4076,7196
1080,4003,25-29,3346,4255,7601
1081,4003,30-34,3631,4252,7883
1082,4003,35-39,3475,4251,7726
1083,4003,40-44,3233,3673,6906
1084,4003,45-49,2923,3212,6135
1085,4003,50-54,3239,3265,6504
1086,4003,55-59,3940,3720,7660
1087,4003,60-64,4595,4089,8684
1088,4003,65+,15480,14409,29889
1089,4005,15-19,7591,6578,14169
1090,4005,20-24,10509,9061,19570
1091,4005,25-29,5096,5513,10609
1092,4005,30-34,4634,4940,9574
1093,4005,35-39,4195,4491,8686
1094,4005,40-44,3946,3960,7906
1095,4005,45-49,3432,3786,7218
1096,4005,50-54,3552,3616,7168
1097,4005,55-59,3838,3809,7647
1098,4005,60-64,4411,4028,8439
1099,4005,65+,10606,9784,20390
1100,4007,15-19,1312,1431,2743
1101,4007,20-24,1107,1208,2315
1102,4007,25-29,1239,1321,2560
1103,4007,30-34,1400,1321,2721
1104,4007,35-39,1245,1391,2636
1105,4007,40-44,1165,1224,2389
1106,4007,45-49,1144,1139,2283
1107,4007,50-54,1465,1442,2907
1108,4007,55-59,1896,1767,3663
1109,4007,60-64,2492,2244,4736
1110,4007,65+,8128,7889,16017
1111,4009,15-19,1408,1548,2956
1112,4009,20-24,1192,1593,2785
1113,4009,25-29,1144,1662,2806
1114,4009,30-34,1197,1705,2902
1115,4009,35-39,1048,1595,2643
1116,4009,40-44,1130,1527,2657
1117,4009,45-49,957,1283,2240
1118,4009,50-54,920,1134,2054
1119,4009,55-59,946,1049,1995
1120,4009,60-64,999,966,1965
1121,4009,65+,2939,2571,5510
1122,4011,15-19,282,316,598
1123,4011,20-24,255,297,552
1124,4011,25-29,333,369,702
1125,4011,30-34,325,376,701
1126,4011,35-39,324,374,698
1127,4011,40-44,304,343,647
1128,4011,45-49,237,273,510
1129,4011,50-54,248,261,509
1130,4011,55-59,207,281,488
1131,4011,60-64,218,251,469
1132,4011,65+,686,673,1359
1133,4012,15-19,317,404,721
1134,4012,20-24,283,345,628
1135,4012,25-29,327,387,714
1136,4012,30-34,369,328,697
1137,4012,35-39,370,326,696
1138,4012,40-44,329,383,712
1139,4012,45-49,308,303,611
1140,4012,50-54,385,351,736
1141,4012,55-59,445,418,863
1142,4012,60-64,567,553,1120
1143,4012,65+,3178,3519,6697
1144,4013,15-19,148717,155996,304713
1145,4013,20-24,145450,150761,296211
1146,4013,25-29,160894,165932,326826
1147,4013,30-34,161118,167004,328122
1148,4013,35-39,150906,156366,307272
1149,4013,40-44,144542,146499,291041
1150,4013,45-49,138180,136526,274706
1151,4013,50-54,140194,140274,280468
1152,4013,55-59,137343,133622,270965
1153,4013,60-64,132470,124797,257267
1154,4013,65+,386348,322929,709277
1155,4015,15-19,4770,5196,9966
1156,4015,20-24,4286,4859,9145
1157,4015,25-29,4829,5815,10644
1158,4015,30-34,5431,6065,11496
1159,4015,35-39,4889,5542,10431
1160,4015,40-44,4827,5227,10054
1161,4015,45-49,4780,5166,9946
1162,4015,50-54,6113,6051,12164
1163,4015,55-59,8150,7548,15698
1164,4015,60-64,10078,9592,19670
1165,4015,65+,34646,34443,69089
1166,4017,15-19,3671,4003,7674
1167,4017,20-24,2828,3204,6032
1168,4017,25-29,2929,3352,6281
1169,4017,30-34,3188,3552,6740
1170,4017,35-39,2939,3234,6173
1171,4017,40-44,2809,3005,5814
1172,4017,45-49,2738,2866,5604
1173,4017,50-54,2859,2871,5730
1174,4017,55-59,3573,3276,6849
1175,4017,60-64,3993,3618,7611
1176,4017,65+,10904,9995,20899
1177,4019,15-19,34049,35302,69351
1178,4019,20-24,44167,44929,89096
1179,4019,25-29,34830,37379,72209
1180,4019,30-34,30854,34011,64865
1181,4019,35-39,30479,32078,62557
1182,4019,40-44,30252,30432,60684
1183,4019,45-49,28271,28027,56298
1184,4019,50-54,28893,27971,56864
1185,4019,55-59,31330,29590,60920
1186,4019,60-64,35164,31290,66454
1187,4019,65+,117876,99565,217441
1188,4021,15-19,12998,14171,27169
1189,4021,20-24,10913,14000,24913
1190,4021,25-29,12458,16428,28886
1191,4021,30-34,13415,17155,30570
1192,4021,35-39,13653,16834,30487
1193,4021,40-44,12894,15513,28407
1194,4021,45-49,11993,14072,26065
1195,4021,50-54,11562,12938,24500
1196,4021,55-59,12610,12531,25141
1197,4021,60-64,14222,13039,27261
1198,4021,65+,49088,45364,94452
1199,4023,15-19,1845,1778,3623
1200,4023,20-24,1414,1548,2962
1201,4023,25-29,1478,1406,2884
1202,4023,30-34,1356,1361,2717
1203,4023,35-39,1332,1224,2556
1204,4023,40-44,1429,1249,2678
1205,4023,45-49,1444,1229,2673
1206,4023,50-54,1393,1304,2697
1207,4023,55-59,1438,1300,2738
1208,4023,60-64,1531,1400,2931
1209,4023,65+,4955,4220,9175
1210,4025,15-19,5394,6259,11653
1211,4025,20-24,4758,5613,10371
1212,4025,25-29,5211,5578,10789
1213,4025,30-34,5491,5596,11087
1214,4025,35-39,5391,5546,10937
1215,4025,40-44,5234,5520,10754
1216,4025,45-49,5512,5414,10926
1217,4025,50-54,6831,6383,13214
1218,4025,55-59,9158,8026,17184
1219,4025,60-64,12316,10517,22833
1220,4025,65+,42633,38943,81576
1221,4027,15-19,6941,7761,14702
1222,4027,20-24,6568,9533,16101
1223,4027,25-29,6598,8361,14959
1224,4027,30-34,6348,7699,14047
1225,4027,35-39,5689,6859,12548
1226,4027,40-44,5145,5854,10999
1227,4027,45-49,4900,4965,9865
1228,4027,50-54,5105,4925,10030
1229,4027,55-59,5163,4845,10008
1230,4027,60-64,5083,4948,10031
1231,4027,65+,20983,19586,40569
1232,5001,15-19,485,500,985
1233,5001,20-24,398,406,804
1234,5001,25-29,525,452,977
1235,5001,30-34,491,448,939
1236,5001,35-39,499,410,909
1237,5001,40-44,559,512,1071
1238,5001,45-49,509,496,1005
1239,5001,50-54,511,525,1036
1240,5001,55-59,585,546,1131
1241,5001,60-64,624,595,1219
1242,5001,65+,1825,1557,3382
1243,5003,15-19,567,577,1144
1244,5003,20-24,482,516,998
1245,5003,25-29,524,490,1014
1246,5003,30-34,515,523,1038
1247,5003,35-39,494,443,937
1248,5003,40-44,582,509,1091
1249,5003,45-49,608,523,1131
1250,5003,50-54,634,575,1209
1251,5003,55-59,689,670,1359
1252,5003,60-64,650,648,1298
1253,5003,65+,2143,1818,3961
1254,5005,15-19,1073,1114,2187
1255,5005,20-24,834,915,1749
1256,5005,25-29,964,991,1955
1257,5005,30-34,1013,1040,2053
1258,5005,35-39,1105,1021,2126
1259,5005,40-44,1033,1006,2039
1260,5005,45-49,1035,988,2023
1261,5005,50-54,1304,1250,2554
1262,5005,55-59,1624,1361,2985
1263,5005,60-64,1855,1602,3457
1264,5005,65+,6847,6050,12897
1265,5007,15-19,9683,10236,19919
1266,5007,20-24,8466,8353,16819
1267,5007,25-29,10272,10482,20754
1268,5007,30-34,11112,11489,22601
1269,5007,35-39,10886,11781,22667
1270,5007,40-44,10273,10829,21102
1271,5007,45-49,8841,9129,17970
1272,5007,50-54,8696,8903,17599
1273,5007,55-59,8236,8242,16478
1274,5007,60-64,7891,7484,15375
1275,5007,65+,21748,18140,39888
1276,5009,15-19,1130,1206,2336
1277,5009,20-24,954,1050,2004
1278,5009,25-29,1087,1124,2211
1279,5009,30-34,1094,1104,2198
1280,5009,35-39,1083,1103,2186
1281,5009,40-44,1109,1105,2214
1282,5009,45-49,1102,1076,2178
1283,5009,50-54,1163,1187,2350
1284,5009,55-59,1291,1277,2568
1285,5009,60-64,1391,1291,2682
1286,5009,65+,4306,3569,7875
1287,5011,15-19,309,342,651
1288,5011,20-24,298,258,556
1289,5011,25-29,286,290,576
1290,5011,30-34,312,317,629
1291,5011,35-39,293,310,603
1292,5011,40-44,312,316,628
1293,5011,45-49,302,295,597
1294,5011,50-54,331,334,665
1295,5011,55-59,385,316,701
1296,5011,60-64,348,335,683
1297,5011,65+,1085,896,1981
1298,5013,15-19,124,135,259
1299,5013,20-24,106,151,257
1300,5013,25-29,132,153,285
1301,5013,30-34,136,139,275
1302,5013,35-39,131,156,287
1303,5013,40-44,116,132,248
1304,5013,45-49,152,135,287
1305,5013,50-54,154,188,342
1306,5013,55-59,163,203,366
1307,5013,60-64,177,198,375
1308,5013,65+,568,461,1029
1309,5015,15-19,801,889,1690
1310,5015,20-24,711,768,1479
1311,5015,25-29,694,786,1480
1312,5015,30-34,753,752,1505
1313,5015,35-39,764,785,1549
1314,5015,40-44,787,762,1549
1315,5015,45-49,775,771,1546
1316,5015,50-54,791,858,1649
1317,5015,55-59,976,988,1964
1318,5015,60-64,1091,1072,2163
1319,5015,65+,3567,3231,6798
1320,5017,15-19,274,317,591
1321,5017,20-24,227,365,592
1322,5017,25-29,208,342,550
1323,5017,30-34,202,323,525
1324,5017,35-39,256,301,557
1325,5017,40-44,246,262,508
1326,5017,45-49,274,307,581
1327,5017,50-54,297,305,602
1328,5017,55-59,364,329,693
1329,5017,60-64,421,368,789
1330,5017,65+,1246,959,2205
1331,5019,15-19,1208,1082,2290
1332,5019,20-24,1613,1472,3085
1333,5019,25-29,597,611,1208
1334,5019,30-34,561,533,1094
1335,5019,35-39,509,507,1016
1336,5019,40-44,541,503,1044
1337,5019,45-49,553,530,1083
1338,5019,50-54,532,492,1024
1339,5019,55-59,635,575,1210
1340,5019,60-64,651,580,1231
1341,5019,65+,1978,1589,3567
1342,5021,15-19,408,461,869
1343,5021,20-24,352,401,753
1344,5021,25-29,420,446,866
1345,5021,30-34,410,451,861
1346,5021,35-39,378,355,733
1347,5021,40-44,399,463,862
1348,5021,45-49,418,394,812
1349,5021,50-54,490,490,980
1350,5021,55-59,496,533,1029
1351,5021,60-64,516,498,1014
1352,5021,65+,1701,1369,3070
1353,5023,15-19,661,674,1335
1354,5023,20-24,525,582,1107
1355,5023,25-29,528,604,1132
1356,5023,30-34,605,657,1262
1357,5023,35-39,675,644,1319
1358,5023,40-44,666,674,1340
1359,5023,45-49,686,683,1369
1360,5023,50-54,723,768,1491
1361,5023,55-59,1007,962,1969
1362,5023,60-64,1006,1016,2022
1363,5023,65+,3629,3156,6785
1364,5025,15-19,236,248,484
1365,5025,20-24,192,182,374
1366,5025,25-29,192,207,399
1367,5025,30-34,197,191,388
1368,5025,35-39,209,219,428
1369,5025,40-44,243,206,449
1370,5025,45-49,230,229,459
1371,5025,50-54,252,254,506
1372,5025,55-59,275,287,562
1373,5025,60-64,259,296,555
1374,5025,65+,863,739,1602
1375,5027,15-19,1153,1102,2255
1376,5027,20-24,1180,1354,2534
1377,5027,25-29,689,626,1315
1378,5027,30-34,623,553,1176
1379,5027,35-39,609,554,1163
1380,5027,40-44,603,578,1181
1381,5027,45-49,600,523,1123
1382,5027,50-54,662,559,1221
1383,5027,55-59,700,674,1374
1384,5027,60-64,704,650,1354
1385,5027,65+,2204,1729,3933
1386,5029,15-19,623,604,1227
1387,5029,20-24,522,549,1071
1388,5029,25-29,564,599,1163
1389,5029,30-34,618,600,1218
1390,5029,35-39,639,618,1257
1391,5029,40-44,628,583,1211
1392,5029,45-49,613,639,1252
1393,5029,50-54,677,630,1307
1394,5029,55-59,799,775,1574
1395,5029,60-64,759,765,1524
1396,5029,65+,2228,1933,4161
1397,5031,15-19,4188,4347,8535
1398,5031,20-24,4066,4242,8308
1399,5031,25-29,4259,3986,8245
1400,5031,30-34,4490,4107,8597
1401,5031,35-39,3850,3652,7502
1402,5031,40-44,3788,3536,7324
1403,5031,45-49,3149,3149,6298
1404,5031,50-54,3179,3077,6256
1405,5031,55-59,3198,3029,6227
1406,5031,60-64,3187,2752,5939
1407,5031,65+,8917,6773,15690
1408,5033,15-19,1936,2102,4038
1409,5033,20-24,1624,1727,3351
1410,5033,25-29,1771,1723,3494
1411,5033,30-34,1890,1907,3797
1412,5033,35-39,1892,1847,3739
1413,5033,40-44,1856,1815,3671
1414,5033,45-49,1847,1888,3735
1415,5033,50-54,1952,1913,3865
1416,5033,55-59,2039,2059,4098
1417,5033,60-64,2017,2056,4073
1418,5033,65+,5789,4850,10639
1419,5035,15-19,1648,1697,3345
1420,5035,20-24,1505,1462,2967
1421,5035,25-29,1651,1484,3135
1422,5035,30-34,1668,1431,3099
1423,5035,35-39,1558,1326,2884
1424,5035,40-44,1531,1297,2828
1425,5035,45-49,1488,1246,2734
1426,5035,50-54,1544,1301,2845
1427,5035,55-59,1576,1481,3057
1428,5035,60-64,1532,1423,2955
1429,5035,65+,3950,2992,6942
1430,5037,15-19,488,549,1037
1431,5037,20-24,430,443,873
1432,5037,25-29,539,472,1011
1433,5037,30-34,487,467,954
1434,5037,35-39,524,449,973
1435,5037,40-44,535,511,1046
1436,5037,45-49,546,520,1066
1437,5037,50-54,525,521,1046
1438,5037,55-59,588,558,1146
1439,5037,60-64,570,551,1121
1440,5037,65+,1715,1415,3130
1441,5039,15-19,172,190,362
1442,5039,20-24,171,155,326
1443,5039,25-29,141,134,275
1444,5039,30-34,153,180,333
1445,5039,35-39,171,175,346
1446,5039,40-44,177,180,357
1447,5039,45-49,158,182,340
1448,5039,50-54,173,194,367
1449,5039,55-59,247,210,457
1450,5039,60-64,237,236,473
1451,5039,65+,910,685,1595
1452,5041,15-19,402,374,776
1453,5041,20-24,310,276,586
1454,5041,25-29,348,248,596
1455,5041,30-34,349,258,607
1456,5041,35-39,339,283,622
1457,5041,40-44,344,278,622
1458,5041,45-49,286,310,596
1459,5041,50-54,329,274,603
1460,5041,55-59,398,337,735
1461,5041,60-64,450,399,849
1462,5041,65+,1204,995,2199
1463,5043,15-19,599,637,1236
1464,5043,20-24,788,823,1611
1465,5043,25-29,537,521,1058
1466,5043,30-34,525,473,998
1467,5043,35-39,489,509,998
1468,5043,40-44,484,466,950
1469,5043,45-49,470,399,869
1470,5043,50-54,511,441,952
1471,5043,55-59,584,526,1110
1472,5043,60-64,542,553,1095
1473,5043,65+,1741,1370,3111
1474,5045,15-19,4709,4493,9202
1475,5045,20-24,7470,6577,14047
1476,5045,25-29,4465,4476,8941
1477,5045,30-34,4360,4122,8482
1478,5045,35-39,4224,4135,8359
1479,5045,40-44,3892,3927,7819
1480,5045,45-49,3655,3545,7200
1481,5045,50-54,3538,3558,7096
1482,5045,55-59,3757,3452,7209
1483,5045,60-64,3481,3318,6799
1484,5045,65+,9174,7370,16544
1485,5047,15-19,526,629,1155
1486,5047,20-24,406,554,960
1487,5047,25-29,461,493,954
1488,5047,30-34,490,479,969
1489,5047,35-39,523,520,1043
1490,5047,40-44,516,507,1023
1491,5047,45-49,517,533,1050
1492,5047,50-54,541,502,1043
1493,5047,55-59,601,574,1175
1494,5047,60-64,608,607,1215
1495,5047,65+,1870,1558,3428
1496,5049,15-19,330,391,721
1497,5049,20-24,257,271,528
1498,5049,25-29,284,298,582
1499,5049,30-34,289,269,558
1500,5049,35-39,323,319,642
1501,5049,40-44,323,297,620
1502,5049,45-49,307,316,623
1503,5049,50-54,409,373,782
1504,5049,55-59,426,434,860
1505,5049,60-64,513,463,976
1506,5049,65+,1656,1484,3140
1507,5051,15-19,2748,3008,5756
1508,5051,20-24,2428,2574,5002
1509,5051,25-29,2745,2703,5448
1510,5051,30-34,2972,2855,5827
1511,5051,35-39,2928,2662,5590
1512,5051,40-44,2913,2854,5767
1513,5051,45-49,2949,2724,5673
1514,5051,50-54,3187,2995,6182
1515,5051,55-59,3560,3244,6804
1516,5051,60-64,3980,3518,7498
1517,5051,65+,13423,11052,24475
1518,5053,15-19,559,586,1145
1519,5053,20-24,485,480,965
1520,5053,25-29,520,549,1069
1521,5053,30-34,574,568,1142
1522,5053,35-39,603,576,1179
1523,5053,40-44,551,621,1172
1524,5053,45-49,570,565,1135
1525,5053,50-54,578,605,1183
1526,5053,55-59,656,638,1294
1527,5053,60-64,622,627,1249
1528,5053,65+,1804,1507,3311
1529,5055,15-19,1474,1617,3091
1530,5055,20-24,1326,1388,2714
1531,5055,25-29,1502,1525,3027
1532,5055,30-34,1595,1541,3136
1533,5055,35-39,1453,1494,2947
1534,5055,40-44,1471,1541,3012
1535,5055,45-49,1455,1460,2915
1536,5055,50-54,1483,1514,2997
1537,5055,55-59,1508,1479,2987
1538,5055,60-64,1408,1338,2746
1539,5055,65+,4179,3312,7491
1540,5057,15-19,621,616,1237
1541,5057,20-24,537,590,1127
1542,5057,25-29,584,553,1137
1543,5057,30-34,608,534,1142
1544,5057,35-39,567,488,1055
1545,5057,40-44,579,536,1115
1546,5057,45-49,581,513,1094
1547,5057,50-54,566,553,1119
1548,5057,55-59,689,675,1364
1549,5057,60-64,692,660,1352
1550,5057,65+,2036,1716,3752
1551,5059,15-19,882,1235,2117
1552,5059,20-24,799,1041,1840
1553,5059,25-29,887,1187,2074
1554,5059,30-34,933,1162,2095
1555,5059,35-39,970,1043,2013
1556,5059,40-44,1002,1153,2155
1557,5059,45-49,1024,1179,2203
1558,5059,50-54,989,1156,2145
1559,5059,55-59,1143,1262,2405
1560,5059,60-64,1107,1145,2252
1561,5059,65+,3527,2996,6523
1562,5061,15-19,450,438,888
1563,5061,20-24,365,347,712
1564,5061,25-29,368,325,693
1565,5061,30-34,392,358,750
1566,5061,35-39,424,355,779
1567,5061,40-44,379,322,701
1568,5061,45-49,350,333,683
1569,5061,50-54,388,362,750
1570,5061,55-59,447,423,870
1571,5061,60-64,395,412,807
1572,5061,65+,1252,1039,2291
1573,5063,15-19,1283,1395,2678
1574,5063,20-24,1126,1095,2221
1575,5063,25-29,1086,1111,2197
1576,5063,30-34,1136,1121,2257
1577,5063,35-39,1148,1167,2315
1578,5063,40-44,1121,1124,2245
1579,5063,45-49,1125,1163,2288
1580,5063,50-54,1205,1138,2343
1581,5063,55-59,1230,1147,2377
1582,5063,60-64,1225,1244,2469
1583,5063,65+,3771,3131,6902
1584,5065,15-19,344,395,739
1585,5065,20-24,302,399,701
1586,5065,25-29,294,447,741
1587,5065,30-34,326,440,766
1588,5065,35-39,330,443,773
1589,5065,40-44,382,457,839
1590,5065,45-49,356,460,816
1591,5065,50-54,386,525,911
1592,5065,55-59,478,550,1028
1593,5065,60-64,546,528,1074
1594,5065,65+,1798,1658,3456
1595,5067,15-19,432,481,913
1596,5067,20-24,508,486,994
1597,5067,25-29,534,691,1225
1598,5067,30-34,610,642,1252
1599,5067,35-39,554,606,1160
1600,5067,40-44,502,574,1076
1601,5067,45-49,505,498,1003
1602,5067,50-54,496,532,1028
1603,5067,55-59,588,536,1124
1604,5067,60-64,555,555,1110
1605,5067,65+,1686,1398,3084
1606,5069,15-19,2225,2305,4530
1607,5069,20-24,2173,2344,4517
1608,5069,25-29,1980,2195,4175
1609,5069,30-34,1950,2184,4134
1610,5069,35-39,1821,2101,3922
1611,5069,40-44,1957,2022,3979
1612,5069,45-49,1825,1872,3697
1613,5069,50-54,1992,2011,4003
1614,5069,55-59,2256,2097,4353
1615,5069,60-64,2398,2140,4538
1616,5069,65+,6872,5429,12301
1617,5071,15-19,955,944,1899
1618,5071,20-24,830,789,1619
1619,5071,25-29,703,725,1428
1620,5071,30-34,813,823,1636
1621,5071,35-39,827,847,1674
1622,5071,40-44,754,771,1525
1623,5071,45-49,702,714,1416
1624,5071,50-54,761,783,1544
1625,5071,55-59,853,871,1724
1626,5071,60-64,848,852,1700
1627,5071,65+,2336,2109,4445
1628,5073,15-19,156,163,319
1629,5073,20-24,142,151,293
1630,5073,25-29,198,183,381
1631,5073,30-34,155,165,320
1632,5073,35-39,153,133,286
1633,5073,40-44,151,166,317
1634,5073,45-49,181,168,349
1635,5073,50-54,214,184,398
1636,5073,55-59,251,254,505
1637,5073,60-64,267,251,518
1638,5073,65+,826,724,1550
1639,5075,15-19,559,576,1135
1640,5075,20-24,515,597,1112
1641,5075,25-29,491,477,968
1642,5075,30-34,486,504,990
1643,5075,35-39,467,478,945
1644,5075,40-44,444,468,912
1645,5075,45-49,476,451,927
1646,5075,50-54,495,482,977
1647,5075,55-59,553,567,1120
1648,5075,60-64,583,526,1109
1649,5075,65+,1693,1409,3102
1650,5077,15-19,201,220,421
1651,5077,20-24,189,332,521
1652,5077,25-29,191,486,677
1653,5077,30-34,182,474,656
1654,5077,35-39,157,410,567
1655,5077,40-44,172,353,525
1656,5077,45-49,187,370,557
1657,5077,50-54,254,294,548
1658,5077,55-59,255,304,559
1659,5077,60-64,279,278,557
1660,5077,65+,988,758,1746
1661,5079,15-19,291,392,683
1662,5079,20-24,266,793,1059
1663,5079,25-29,237,815,1052
1664,5079,30-34,292,877,1169
1665,5079,35-39,270,736,1006
1666,5079,40-44,288,678,966
1667,5079,45-49,266,625,891
1668,5079,50-54,303,593,896
1669,5079,55-59,361,477,838
1670,5079,60-64,317,422,739
1671,5079,65+,1100,943,2043
1672,5081,15-19,353,389,742
1673,5081,20-24,313,327,640
1674,5081,25-29,351,337,688
1675,5081,30-34,340,343,683
1676,5081,35-39,321,337,658
1677,5081,40-44,368,314,682
1678,5081,45-49,402,354,756
1679,5081,50-54,415,355,770
1680,5081,55-59,412,389,801
1681,5081,60-64,452,390,842
1682,5081,65+,1390,1118,2508
1683,5083,15-19,549,747,1296
1684,5083,20-24,523,553,1076
1685,5083,25-29,537,597,1134
1686,5083,30-34,655,580,1235
1687,5083,35-39,579,576,1155
1688,5083,40-44,620,612,1232
1689,5083,45-49,712,624,1336
1690,5083,50-54,702,767,1469
1691,5083,55-59,846,867,1713
1692,5083,60-64,797,757,1554
1693,5083,65+,2343,1961,4304
1694,5085,15-19,2442,2576,5018
1695,5085,20-24,2184,2144,4328
1696,5085,25-29,2466,2518,4984
1697,5085,30-34,2704,2687,5391
1698,5085,35-39,2661,2658,5319
1699,5085,40-44,2517,2389,4906
1700,5085,45-49,2447,2400,4847
1701,5085,50-54,2349,2353,4702
1702,5085,55-59,2373,2355,4728
1703,5085,60-64,2294,2118,4412
1704,5085,65+,5926,4805,10731
1705,5087,15-19,514,542,1056
1706,5087,20-24,443,422,865
1707,5087,25-29,478,493,971
1708,5087,30-34,505,531,1036
1709,5087,35-39,485,529,1014
1710,5087,40-44,478,493,971
1711,5087,45-49,488,467,955
1712,5087,50-54,500,577,1077
1713,5087,55-59,612,623,1235
1714,5087,60-64,600,629,1229
1715,5087,65+,1721,1589,3310
1716,5089,15-19,412,423,835
1717,5089,20-24,305,339,644
1718,5089,25-29,364,357,721
1719,5089,30-34,390,411,801
1720,5089,35-39,414,383,797
1721,5089,40-44,412,431,843
1722,5089,45-49,446,389,835
1723,5089,50-54,501,519,1020
1724,5089,55-59,642,685,1327
1725,5089,60-64,846,762,1608
1726,5089,65+,2507,2435,4942
1727,5091,15-19,1181,1421,2602
1728,5091,20-24,1157,1318,2475
1729,5091,25-29,1316,1406,2722
1730,5091,30-34,1427,1393,2820
1731,5091,35-39,1393,1284,2677
1732,5091,40-44,1394,1370,2764
1733,5091,45-49,1320,1215,2535
1734,5091,50-54,1406,1352,2758
1735,5091,55-59,1426,1427,2853
1736,5091,60-64,1455,1236,2691
1737,5091,65+,4091,3280,7371
1738,5093,15-19,1332,1449,2781
1739,5093,20-24,1231,1299,2530
1740,5093,25-29,1248,1261,2509
1741,5093,30-34,1284,1245,2529
1742,5093,35-39,1225,1152,2377
1743,5093,40-44,1276,1179,2455
1744,5093,45-49,1201,1070,2271
1745,5093,50-54,1176,1117,2293
1746,5093,55-59,1348,1276,2624
1747,5093,60-64,1304,1299,2603
1748,5093,65+,3424,2703,6127
1749,5095,15-19,167,181,348
1750,5095,20-24,165,151,316
1751,5095,25-29,191,160,351
1752,5095,30-34,190,150,340
1753,5095,35-39,158,142,300
1754,5095,40-44,140,165,305
1755,5095,45-49,198,159,357
1756,5095,50-54,201,216,417
1757,5095,55-59,282,244,526
1758,5095,60-64,286,250,536
1759,5095,65+,896,722,1618
1760,5097,15-19,234,227,461
1761,5097,20-24,199,212,411
1762,5097,25-29,206,222,428
1763,5097,30-34,173,198,371
1764,5097,35-39,205,186,391
1765,5097,40-44,210,201,411
1766,5097,45-49,239,238,477
1767,5097,50-54,291,296,587
1768,5097,55-59,388,340,728
1769,5097,60-64,359,411,770
1770,5097,65+,1206,1085,2291
1771,5099,15-19,231,277,508
1772,5099,20-24,199,216,415
1773,5099,25-29,204,205,409
1774,5099,30-34,221,221,442
1775,5099,35-39,243,212,455
1776,5099,40-44,230,230,460
1777,5099,45-49,235,256,491
1778,5099,50-54,289,255,544
1779,5099,55-59,298,300,598
1780,5099,60-64,313,263,576
1781,5099,65+,960,806,1766
1782,5101,15-19,192,232,424
1783,5101,20-24,143,158,301
1784,5101,25-29,156,162,318
1785,5101,30-34,184,188,372
1786,5101,35-39,177,203,380
1787,5101,40-44,193,186,379
1788,5101,45-49,173,191,364
1789,5101,50-54,230,223,453
1790,5101,55-59,265,265,530
1791,5101,60-64,292,311,603
1792,5101,65+,995,977,1972
1793,5103,15-19,658,726,1384
1794,5103,20-24,586,603,1189
1795,5103,25-29,633,657,1290
1796,5103,30-34,638,604,1242
1797,5103,35-39,643,611,1254
1798,5103,40-44,635,540,1175
1799,5103,45-49,635,601,1236
1800,5103,50-54,722,634,1356
1801,5103,55-59,814,777,1591
1802,5103,60-64,942,847,1789
1803,5103,65+,2672,2053,4725
1804,5105,15-19,287,293,580
1805,5105,20-24,238,257,495
1806,5105,25-29,273,266,539
1807,5105,30-34,256,272,528
1808,5105,35-39,278,282,560
1809,5105,40-44,274,290,564
1810,5105,45-49,284,313,597
1811,5105,50-54,344,381,725
1812,5105,55-59,373,369,742
1813,5105,60-64,399,382,781
1814,5105,65+,1095,979,2074
1815,5107,15-19,500,540,1040
1816,5107,20-24,488,405,893
1817,5107,25-29,486,384,870
1818,5107,30-34,450,374,824
1819,5107,35-39,445,381,826
1820,5107,40-44,457,383,840
1821,5107,45-49,451,357,808
1822,5107,50-54,444,439,883
1823,5107,55-59,586,483,1069
1824,5107,60-64,665,514,1179
1825,5107,65+,1799,1418,3217
1826,5109,15-19,303,315,618
1827,5109,20-24,240,296,536
1828,5109,25-29,281,300,581
1829,5109,30-34,272,284,556
1830,5109,35-39,234,300,534
1831,5109,40-44,325,275,600
1832,5109,45-49,310,346,656
1833,5109,50-54,326,359,685
1834,5109,55-59,364,336,700
1835,5109,60-64,378,358,736
1836,5109,65+,1137,943,2080
1837,5111,15-19,720,705,1425
1838,5111,20-24,648,639,1287
1839,5111,25-29,685,685,1370
1840,5111,30-34,736,755,1491
1841,5111,35-39,644,624,1268
1842,5111,40-44,670,672,1342
1843,5111,45-49,672,658,1330
1844,5111,50-54,732,726,1458
1845,5111,55-59,801,807,1608
1846,5111,60-64,741,717,1458
1847,5111,65+,2351,1781,4132
1848,5113,15-19,645,591,1236
1849,5113,20-24,485,548,1033
1850,5113,25-29,491,494,985
1851,5113,30-34,497,486,983
1852,5113,35-39,522,491,1013
1853,5113,40-44,506,494,1000
1854,5113,45-49,542,523,1065
1855,5113,50-54,607,605,1212
1856,5113,55-59,657,663,1320
1857,5113,60-64,773,706,1479
1858,5113,65+,2347,2102,4449
1859,5115,15-19,2500,2624,5124
1860,5115,20-24,2541,2687,5228
1861,5115,25-29,2063,2029,4092
1862,5115,30-34,2152,2179,4331
1863,5115,35-39,1910,1960,3870
1864,5115,40-44,1730,1795,3525
1865,5115,45-49,1785,1815,3600
1866,5115,50-54,1901,1837,3738
1867,5115,55-59,2009,2005,4014
1868,5115,60-64,1929,1907,3836
1869,5115,65+,5672,4698,10370
1870,5117,15-19,194,237,431
1871,5117,20-24,163,189,352
1872,5117,25-29,193,229,422
1873,5117,30-34,233,196,429
1874,5117,35-39,236,237,473
1875,5117,40-44,197,212,409
1876,5117,45-49,245,208,453
1877,5117,50-54,267,295,562
1878,5117,55-59,339,304,643
1879,5117,60-64,288,298,586
1880,5117,65+,1048,921,1969
1881,5119,15-19,11672,12230,23902
1882,5119,20-24,12795,12693,25488
1883,5119,25-29,14824,13529,28353
1884,5119,30-34,15037,13491,28528
1885,5119,35-39,13953,12601,26554
1886,5119,40-44,13231,12099,25330
1887,5119,45-49,12413,10814,23227
1888,5119,50-54,12269,11369,23638
1889,5119,55-59,12887,11554,24441
1890,5119,60-64,13569,11995,25564
1891,5119,65+,37348,28344,65692
1892,5121,15-19,564,636,1200
1893,5121,20-24,463,485,948
1894,5121,25-29,566,575,1141
1895,5121,30-34,586,653,1239
1896,5121,35-39,564,571,1135
1897,5121,40-44,571,560,1131
1898,5121,45-49,527,515,1042
1899,5121,50-54,549,568,1117
1900,5121,55-59,631,599,1230
1901,5121,60-64,586,579,1165
1902,5121,65+,1973,1613,3586
1903,5123,15-19,586,628,1214
1904,5123,20-24,598,718,1316
1905,5123,25-29,569,1029,1598
1906,5123,30-34,603,1212,1815
1907,5123,35-39,524,1182,1706
1908,5123,40-44,519,1023,1542
1909,5123,45-49,573,868,1441
1910,5123,50-54,574,801,1375
1911,5123,55-59,670,723,1393
1912,5123,60-64,740,722,1462
1913,5123,65+,2047,1787,3834
1914,5125,15-19,3698,4108,7806
1915,5125,20-24,3282,3137,6419
1916,5125,25-29,3862,3530,7392
1917,5125,30-34,4294,4006,8300
1918,5125,35-39,4381,4128,8509
1919,5125,40-44,4382,4263,8645
1920,5125,45-49,3882,3888,7770
1921,5125,50-54,3950,3942,7892
1922,5125,55-59,4100,4024,8124
1923,5125,60-64,3954,3808,7762
1924,5125,65+,12435,10487,22922
1925,5127,15-19,286,350,636
1926,5127,20-24,246,250,496
1927,5127,25-29,279,249,528
1928,5127,30-34,284,301,585
1929,5127,35-39,261,285,546
1930,5127,40-44,248,257,505
1931,5127,45-49,249,272,521
1932,5127,50-54,308,308,616
1933,5127,55-59,374,371,745
1934,5127,60-64,363,366,729
1935,5127,65+,1042,1015,2057
1936,5129,15-19,200,224,424
1937,5129,20-24,166,176,342
1938,5129,25-29,175,198,373
1939,5129,30-34,198,212,410
1940,5129,35-39,216,210,426
1941,5129,40-44,186,200,386
1942,5129,45-49,201,228,429
1943,5129,50-54,244,258,502
1944,5129,55-59,328,297,625
1945,5129,60-64,283,354,637
1946,5129,65+,1042,995,2037
1947,5131,15-19,4123,4261,8384
1948,5131,20-24,4133,4165,8298
1949,5131,25-29,4366,4378,8744
1950,5131,30-34,4228,4265,8493
1951,5131,35-39,4036,4020,8056
1952,5131,40-44,3899,3891,7790
1953,5131,45-49,3758,3651,7409
1954,5131,50-54,3982,4009,7991
1955,5131,55-59,4179,4216,8395
1956,5131,60-64,4103,3909,8012
1957,5131,65+,11946,9560,21506
1958,5133,15-19,547,619,1166
1959,5133,20-24,452,530,982
1960,5133,25-29,503,501,1004
1961,5133,30-34,445,490,935
1962,5133,35-39,420,476,896
1963,5133,40-44,441,442,883
1964,5133,45-49,486,447,933
1965,5133,50-54,463,521,984
1966,5133,55-59,466,513,979
1967,5133,60-64,434,461,895
1968,5133,65+,1263,1112,2375
1969,5135,15-19,496,546,1042
1970,5135,20-24,387,446,833
1971,5135,25-29,409,458,867
1972,5135,30-34,470,454,924
1973,5135,35-39,453,421,874
1974,5135,40-44,450,449,899
1975,5135,45-49,483,499,982
1976,5135,50-54,540,563,1103
1977,5135,55-59,634,592,1226
1978,5135,60-64,768,665,1433
1979,5135,65+,2341,2081,4422
1980,5137,15-19,340,348,688
1981,5137,20-24,276,284,560
1982,5137,25-29,300,294,594
1983,5137,30-34,315,303,618
1984,5137,35-39,277,301,578
1985,5137,40-44,323,353,676
1986,5137,45-49,287,325,612
1987,5137,50-54,325,345,670
1988,5137,55-59,498,445,943
1989,5137,60-64,510,526,1036
1990,5137,65+,1866,1660,3526
1991,5139,15-19,1197,1252,2449
1992,5139,20-24,1050,1113,2163
1993,5139,25-29,1135,1119,2254
1994,5139,30-34,1153,1083,2236
1995,5139,35-39,1161,1107,2268
1996,5139,40-44,1199,1182,2381
1997,5139,45-49,1153,1049,2202
1998,5139,50-54,1206,1121,2327
1999,5139,55-59,1275,1294,2569
2000,5139,60-64,1408,1286,2694
2001,5139,65+,3961,3269,7230
2002,5141,15-19,420,478,898
2003,5141,20-24,345,365,710
2004,5141,25-29,315,361,676
2005,5141,30-34,342,356,698
2006,5141,35-39,405,391,796
2007,5141,40-44,428,406,834
2008,5141,45-49,453,463,916
2009,5141,50-54,449,538,987
2010,5141,55-59,616,606,1222
2011,5141,60-64,706,688,1394
2012,5141,65+,2210,1987,4197
2013,5143,15-19,10026,10110,20136
2014,5143,20-24,12514,13423,25937
2015,5143,25-29,9413,9878,19291
2016,5143,30-34,8710,9120,17830
2017,5143,35-39,8434,8890,17324
2018,5143,40-44,7988,8367,16355
2019,5143,45-49,7042,7196,14238
2020,5143,50-54,6532,6825,13357
2021,5143,55-59,6590,6602,13192
2022,5143,60-64,6256,6002,12258
2023,5143,65+,17025,13771,30796
2024,5145,15-19,3024,2930,5954
2025,5145,20-24,2955,2844,5799
2026,5145,25-29,2332,2260,4592
2027,5145,30-34,2574,2317,4891
2028,5145,35-39,2327,2244,4571
2029,5145,40-44,2321,2235,4556
2030,5145,45-49,2249,2256,4505
2031,5145,50-54,2428,2422,4850
2032,5145,55-59,2621,2592,5213
2033,5145,60-64,2443,2429,4872
2034,5145,65+,7134,5670,12804
2035,5147,15-19,155,159,314
2036,5147,20-24,163,178,341
2037,5147,25-29,156,182,338
2038,5147,30-34,163,123,286
2039,5147,35-39,150,152,302
2040,5147,40-44,171,175,346
2041,5147,45-49,178,187,365
2042,5147,50-54,200,174,374
2043,5147,55-59,165,244,409
2044,5147,60-64,250,198,448
2045,5147,65+,824,662,1486
2046,5149,15-19,628,705,1333
2047,5149,20-24,555,593,1148
2048,5149,25-29,582,671,1253
2049,5149,30-34,580,593,1173
2050,5149,35-39,523,582,1105
2051,5149,40-44,568,624,1192
2052,5149,45-49,578,614,1192
2053,5149,50-54,610,648,1258
2054,5149,55-59,766,736,1502
2055,5149,60-64,637,729,1366
2056,5149,65+,2005,1646,3651
2057,6001,15-19,47116,48231,95347
2058,6001,20-24,44970,44749,89719
2059,6001,25-29,57770,58156,115926
2060,6001,30-34,71603,72164,143767
2061,6001,35-39,68072,70318,138390
2062,6001,40-44,60690,61971,122661
2063,6001,45-49,55274,55737,111011
2064,6001,50-54,53579,54714,108293
2065,6001,55-59,52578,52040,104618
2066,6001,60-64,49508,47732,97240
2067,6001,65+,136123,109926,246049
2068,6003,15-19,38,52,90
2069,6003,20-24,27,30,57
2070,6003,25-29,41,42,83
2071,6003,30-34,21,44,65
2072,6003,35-39,33,30,63
2073,6003,40-44,23,27,50
2074,6003,45-49,39,33,72
2075,6003,50-54,39,39,78
2076,6003,55-59,38,48,86
2077,6003,60-64,54,65,119
2078,6003,65+,141,165,306
2079,6005,15-19,819,941,1760
2080,6005,20-24,671,876,1547
2081,6005,25-29,853,1272,2125
2082,6005,30-34,1001,1521,2522
2083,6005,35-39,986,1588,2574
2084,6005,40-44,902,1786,2688
2085,6005,45-49,871,1583,2454
2086,6005,50-54,1085,1563,2648
2087,6005,55-59,1404,1622,3026
2088,6005,60-64,1703,1762,3465
2089,6005,65+,5887,5428,11315
2090,6007,15-19,7572,7368,14940
2091,6007,20-24,11239,11473,22712
2092,6007,25-29,6777,7241,14018
2093,6007,30-34,6317,6836,13153
2094,6007,35-39,6203,6454,12657
2095,6007,40-44,5746,6223,11969
2096,6007,45-49,5119,5252,10371
2097,6007,50-54,5446,5521,10967
2098,6007,55-59,6080,5619,11699
2099,6007,60-64,6590,6223,12813
2100,6007,65+,20655,17337,37992
2101,6009,15-19,1036,1224,2260
2102,6009,20-24,881,964,1845
2103,6009,25-29,1027,1098,2125
2104,6009,30-34,1210,1170,2380
2105,6009,35-39,1211,1335,2546
2106,6009,40-44,1155,1268,2423
2107,6009,45-49,1037,1134,2171
2108,6009,50-54,1463,1399,2862
2109,6009,55-59,1782,1710,3492
2110,6009,60-64,2265,2133,4398
2111,6009,65+,6791,6398,13189
2112,6011,15-19,767,923,1690
2113,6011,20-24,691,689,1380
2114,6011,25-29,723,715,1438
2115,6011,30-34,642,777,1419
2116,6011,35-39,761,769,1530
2117,6011,40-44,661,670,1331
2118,6011,45-49,606,595,1201
2119,6011,50-54,626,655,1281
2120,6011,55-59,578,641,1219
2121,6011,60-64,641,665,1306
2122,6011,65+,1714,1661,3375
2123,6013,15-19,36684,38497,75181
2124,6013,20-24,32053,32977,65030
2125,6013,25-29,33606,34461,68067
2126,6013,30-34,37871,37439,75310
2127,6013,35-39,41125,40505,81630
2128,6013,40-44,41165,40127,81292
2129,6013,45-49,39383,38195,77578
2130,6013,50-54,40427,40166,80593
2131,6013,55-59,40398,39490,79888
2132,6013,60-64,37748,36021,73769
2133,6013,65+,107413,86516,193929
2134,6015,15-19,692,830,1522
2135,6015,20-24,606,929,1535
2136,6015,25-29,657,1195,1852
2137,6015,30-34,707,1320,2027
2138,6015,35-39,815,1362,2177
2139,6015,40-44,773,1168,1941
2140,6015,45-49,647,922,1569
2141,6015,50-54,674,846,1520
2142,6015,55-59,890,905,1795
2143,6015,60-64,1015,981,1996
2144,6015,65+,2811,2512,5323
2145,6017,15-19,5392,5798,11190
2146,6017,20-24,4428,4639,9067
2147,6017,25-29,4488,4842,9330
2148,6017,30-34,5196,5346,10542
2149,6017,35-39,5837,5948,11785
2150,6017,40-44,5915,6019,11934
2151,6017,45-49,5406,5633,11039
2152,6017,50-54,6434,6408,12842
2153,6017,55-59,7464,7341,14805
2154,6017,60-64,8470,8046,16516
2155,6017,65+,22562,21115,43677
2156,6019,15-19,37438,39172,76610
2157,6019,20-24,34064,35010,69074
2158,6019,25-29,36735,38231,74966
2159,6019,30-34,37810,39503,77313
2160,6019,35-39,34446,36528,70974
2161,6019,40-44,31424,32546,63970
2162,6019,45-49,27536,28666,56202
2163,6019,50-54,27024,27824,54848
2164,6019,55-59,27107,26944,54051
2165,6019,60-64,25813,25032,50845
2166,6019,65+,69832,57953,127785
2167,6021,15-19,1003,1077,2080
2168,6021,20-24,879,956,1835
2169,6021,25-29,868,938,1806
2170,6021,30-34,901,977,1878
2171,6021,35-39,865,941,1806
2172,6021,40-44,807,880,1687
2173,6021,45-49,755,757,1512
2174,6021,50-54,748,788,1536
2175,6021,55-59,869,873,1742
2176,6021,60-64,866,899,1765
2177,6021,65+,2448,2358,4806
2178,6023,15-19,4473,4526,8999
2179,6023,20-24,6311,6073,12384
2180,6023,25-29,4461,4630,9091
2181,6023,30-34,4220,4356,8576
2182,6023,35-39,4365,4563,8928
2183,6023,40-44,4451,4815,9266
2184,6023,45-49,3635,4127,7762
2185,6023,50-54,3436,3841,7277
2186,6023,55-59,3930,3752,7682
2187,6023,60-64,4717,4285,9002
2188,6023,65+,14067,12038,26105
2189,6025,15-19,6743,6981,13724
2190,6025,20-24,5638,6936,12574
2191,6025,25-29,5843,7308,13151
2192,6025,30-34,5744,7594,13338
2193,6025,35-39,5419,6786,12205
2194,6025,40-44,4881,5844,10725
2195,6025,45-49,4655,4924,9579
2196,6025,50-54,4805,4880,9685
2197,6025,55-59,4772,4554,9326
2198,6025,60-64,4543,4360,8903
2199,6025,65+,13208,10825,24033
2200,6027,15-19,476,551,1027
2201,6027,20-24,393,414,807
2202,6027,25-29,477,465,942
2203,6027,30-34,535,545,1080
2204,6027,35-39,639,690,1329
2205,6027,40-44,510,613,1123
2206,6027,45-49,473,529,1002
2207,6027,50-54,515,516,1031
2208,6027,55-59,631,605,1236
2209,6027,60-64,766,766,1532
2210,6027,65+,2335,2232,4567
2211,6029,15-19,34500,36420,70920
2212,6029,20-24,30037,34648,64685
2213,6029,25-29,32872,37535,70407
2214,6029,30-34,33001,37757,70758
2215,6029,35-39,30180,34750,64930
2216,6029,40-44,27144,30814,57958
2217,6029,45-49,24497,26652,51149
2218,6029,50-54,24168,25108,49276
2219,6029,55-59,24098,24348,48446
2220,6029,60-64,23078,23282,46360
2221,6029,65+,55806,48832,104638
2222,6031,15-19,5069,5525,10594
2223,6031,20-24,5050,7310,12360
2224,6031,25-29,5266,7544,12810
2225,6031,30-34,5174,7424,12598
2226,6031,35-39,4770,7220,11990
2227,6031,40-44,4091,6263,10354
2228,6031,45-49,3533,5511,9044
2229,6031,50-54,3235,4823,8058
2230,6031,55-59,3530,4132,7662
2231,6031,60-64,3203,3600,6803
2232,6031,65+,8631,7791,16422
2233,6033,15-19,1789,1963,3752
2234,6033,20-24,1504,1655,3159
2235,6033,25-29,1698,1863,3561
2236,6033,30-34,2051,2134,4185
2237,6033,35-39,1974,2165,4139
2238,6033,40-44,1869,1972,3841
2239,6033,45-49,1726,1728,3454
2240,6033,50-54,2102,1946,4048
2241,6033,55-59,2441,2320,4761
2242,6033,60-64,2774,2676,5450
2243,6033,65+,8165,7699,15864
2244,6035,15-19,686,906,1592
2245,6035,20-24,565,1782,2347
2246,6035,25-29,787,2309,3096
2247,6035,30-34,810,2245,3055
2248,6035,35-39,772,1950,2722
2249,6035,40-44,683,1602,2285
2250,6035,45-49,681,1486,2167
2251,6035,50-54,727,1198,1925
2252,6035,55-59,827,1037,1864
2253,6035,60-64,891,1002,1893
2254,6035,65+,2700,2585,5285
2255,6037,15-19,300081,311005,611086
2256,6037,20-24,314205,316977,631182
2257,6037,25-29,376515,381169,757684
2258,6037,30-34,392955,409297,802252
2259,6037,35-39,349701,366975,716676
2260,6037,40-44,326839,333601,660440
2261,6037,45-49,320097,317779,637876
2262,6037,50-54,328041,329808,657849
2263,6037,55-59,319105,313738,632843
2264,6037,60-64,298265,283292,581557
2265,6037,65+,802905,633613,1436518
2266,6039,15-19,5832,5904,11736
2267,6039,20-24,5377,5091,10468
2268,6039,25-29,5813,5055,10868
2269,6039,30-34,5823,5323,11146
2270,6039,35-39,5694,5110,10804
2271,6039,40-44,5493,4719,10212
2272,6039,45-49,4986,4207,9193
2273,6039,50-54,4511,4312,8823
2274,6039,55-59,4345,4324,8669
2275,6039,60-64,4389,4205,8594
2276,6039,65+,11954,10786,22740
2277,6041,15-19,7869,8209,16078
2278,6041,20-24,5924,6146,12070
2279,6041,25-29,4996,5668,10664
2280,6041,30-34,5683,6317,12000
2281,6041,35-39,7090,7598,14688
2282,6041,40-44,7920,8174,16094
2283,6041,45-49,8753,8923,17676
2284,6041,50-54,10425,10536,20961
2285,6041,55-59,10079,9912,19991
2286,6041,60-64,10073,9268,19341
2287,6041,65+,33595,27416,61011
2288,6043,15-19,396,390,786
2289,6043,20-24,313,376,689
2290,6043,25-29,434,459,893
2291,6043,30-34,480,541,1021
2292,6043,35-39,438,525,963
2293,6043,40-44,408,444,852
2294,6043,45-49,405,430,835
2295,6043,50-54,460,476,936
2296,6043,55-59,607,631,1238
2297,6043,60-64,810,775,1585
2298,6043,65+,2491,2446,4937
2299,6045,15-19,2600,2681,5281
2300,6045,20-24,2174,2312,4486
2301,6045,25-29,2334,2529,4863
2302,6045,30-34,2570,2631,5201
2303,6045,35-39,2745,2855,5600
2304,6045,40-44,2751,2981,5732
2305,6045,45-49,2540,2691,5231
2306,6045,50-54,2667,2663,5330
2307,6045,55-59,2801,2750,5551
2308,6045,60-64,3331,3201,6532
2309,6045,65+,11486,10113,21599
2310,6047,15-19,12709,13212,25921
2311,6047,20-24,10097,10719,20816
2312,6047,25-29,9960,10937,20897
2313,6047,30-34,9815,10884,20699
2314,6047,35-39,9259,10028,19287
2315,6047,40-44,8489,8834,17323
2316,6047,45-49,7963,7928,15891
2317,6047,50-54,7587,7855,15442
2318,6047,55-59,7354,7599,14953
2319,6047,60-64,6927,6975,13902
2320,6047,65+,17689,15291,32980
2321,6049,15-19,190,241,431
2322,6049,20-24,170,178,348
2323,6049,25-29,215,240,455
2324,6049,30-34,242,232,474
2325,6049,35-39,231,244,475
2326,6049,40-44,205,220,425
2327,6049,45-49,204,214,418
2328,6049,50-54,242,251,493
2329,6049,55-59,333,284,617
2330,6049,60-64,378,343,721
2331,6049,65+,1236,1227,2463
2332,6051,15-19,336,359,695
2333,6051,20-24,377,465,842
2334,6051,25-29,412,561,973
2335,6051,30-34,512,526,1038
2336,6051,35-39,460,484,944
2337,6051,40-44,389,430,819
2338,6051,45-49,385,436,821
2339,6051,50-54,374,500,874
2340,6051,55-59,444,531,975
2341,6051,60-64,459,593,1052
2342,6051,65+,1079,1261,2340
2343,6053,15-19,16078,16533,32611
2344,6053,20-24,14144,15107,29251
2345,6053,25-29,14241,15246,29487
2346,6053,30-34,14184,16349,30533
2347,6053,35-39,14031,16177,30208
2348,6053,40-44,13188,15412,28600
2349,6053,45-49,12009,13802,25811
2350,6053,50-54,11988,13465,25453
2351,6053,55-59,11856,12437,24293
2352,6053,60-64,12228,11777,24005
2353,6053,65+,33992,29345,63337
2354,6055,15-19,4240,4537,8777
2355,6055,20-24,3851,4147,7998
2356,6055,25-29,4084,4187,8271
2357,6055,30-34,4151,4219,8370
2358,6055,35-39,4263,4574,8837
2359,6055,40-44,4284,4577,8861
2360,6055,45-49,4100,4385,8485
2361,6055,50-54,4490,4562,9052
2362,6055,55-59,4586,4729,9315
2363,6055,60-64,4654,4521,9175
2364,6055,65+,14704,12825,27529
2365,6057,15-19,2374,2512,4886
2366,6057,20-24,2062,2169,4231
2367,6057,25-29,2226,2417,4643
2368,6057,30-34,2827,2780,5607
2369,6057,35-39,3061,3090,6151
2370,6057,40-44,3099,3271,6370
2371,6057,45-49,2633,2893,5526
2372,6057,50-54,3032,3035,6067
2373,6057,55-59,3831,3446,7277
2374,6057,60-64,4821,4121,8942
2375,6057,65+,15438,14031,29469
2376,6059,15-19,99616,103137,202753
2377,6059,20-24,98280,99324,197604
2378,6059,25-29,110594,114663,225257
2379,6059,30-34,110718,115970,226688
2380,6059,35-39,104795,108755,213550
2381,6059,40-44,101531,100819,202350
2382,6059,45-49,104846,100623,205469
2383,6059,50-54,112306,111142,223448
2384,6059,55-59,108710,108633,217343
2385,6059,60-64,100374,98806,199180
2386,6059,65+,274128,224625,498753
2387,6061,15-19,12452,13396,25848
2388,6061,20-24,10133,10559,20692
2389,6061,25-29,10380,10701,21081
2390,6061,30-34,11859,11902,23761
2391,6061,35-39,14134,13722,27856
2392,6061,40-44,14142,14448,28590
2393,6061,45-49,13041,13015,26056
2394,6061,50-54,13832,13615,27447
2395,6061,55-59,13896,13422,27318
2396,6061,60-64,14239,13241,27480
2397,6061,65+,45567,36985,82552
2398,6063,15-19,494,519,1013
2399,6063,20-24,342,395,737
2400,6063,25-29,460,412,872
2401,6063,30-34,517,538,1055
2402,6063,35-39,546,531,1077
2403,6063,40-44,533,516,1049
2404,6063,45-49,430,462,892
2405,6063,50-54,498,515,1013
2406,6063,55-59,754,692,1446
2407,6063,60-64,992,916,1908
2408,6063,65+,2981,3048,6029
2409,6065,15-19,87249,90741,177990
2410,6065,20-24,80152,82460,162612
2411,6065,25-29,82370,86629,168999
2412,6065,30-34,84292,88390,172682
2413,6065,35-39,82532,87384,169916
2414,6065,40-44,79365,81326,160691
2415,6065,45-49,74202,74313,148515
2416,6065,50-54,74247,76589,150836
2417,6065,55-59,73113,74992,148105
2418,6065,60-64,69217,69740,138957
2419,6065,65+,195673,169171,364844
2420,6067,15-19,48901,50942,99843
2421,6067,20-24,46658,47443,94101
2422,6067,25-29,58347,58528,116875
2423,6067,30-34,64120,64526,128646
2424,6067,35-39,59319,60374,119693
2425,6067,40-44,53075,52990,106065
2426,6067,45-49,48465,47235,95700
2427,6067,50-54,49263,47998,97261
2428,6067,55-59,49864,47324,97188
2429,6067,60-64,48908,44901,93809
2430,6067,65+,130977,103140,234117
2431,6069,15-19,2359,2431,4790
2432,6069,20-24,2034,2169,4203
2433,6069,25-29,2106,2199,4305
2434,6069,30-34,2295,2477,4772
2435,6069,35-39,2370,2646,5016
2436,6069,40-44,2203,2402,4605
2437,6069,45-49,1920,2134,4054
2438,6069,50-54,2063,2065,4128
2439,6069,55-59,2083,2095,4178
2440,6069,60-64,1890,1896,3786
2441,6069,65+,4700,4118,8818
2442,6071,15-19,77257,83126,160383
2443,6071,20-24,74640,80821,155461
2444,6071,25-29,81905,85396,167301
2445,6071,30-34,83166,86011,169177
2446,6071,35-39,75662,78962,154624
2447,6071,40-44,70440,71479,141919
2448,6071,45-49,66285,65398,131683
2449,6071,50-54,65861,65705,131566
2450,6071,55-59,64967,62961,127928
2451,6071,60-64,61074,58061,119135
2452,6071,65+,145340,120179,265519
2453,6073,15-19,98554,107561,206115
2454,6073,20-24,103915,128970,232885
2455,6073,25-29,121699,135266,256965
2456,6073,30-34,130214,140563,270777
2457,6073,35-39,117877,128847,246724
2458,6073,40-44,105804,111994,217798
2459,6073,45-49,97519,99587,197106
2460,6073,50-54,99404,100566,199970
2461,6073,55-59,99273,98749,198022
2462,6073,60-64,96180,93635,189815
2463,6073,65+,267741,221360,489101
2464,6075,15-19,16551,15461,32012
2465,6075,20-24,19459,18273,37732
2466,6075,25-29,36735,38491,75226
2467,6075,30-34,42733,47791,90524
2468,6075,35-39,34618,39985,74603
2469,6075,40-44,27374,30788,58162
2470,6075,45-49,25086,28267,53353
2471,6075,50-54,25034,29799,54833
2472,6075,55-59,23729,28004,51733
2473,6075,60-64,22791,24793,47584
2474,6075,65+,77110,65700,142810
2475,6077,15-19,28663,30639,59302
2476,6077,20-24,25403,27096,52499
2477,6077,25-29,26431,27678,54109
2478,6077,30-34,27549,28481,56030
2479,6077,35-39,27178,28351,55529
2480,6077,40-44,25941,26799,52740
2481,6077,45-49,23401,23942,47343
2482,6077,50-54,23312,23930,47242
2483,6077,55-59,22700,23107,45807
2484,6077,60-64,21523,20824,42347
2485,6077,65+,56999,46227,103226
2486,6079,15-19,10721,11427,22148
2487,6079,20-24,13081,15639,28720
2488,6079,25-29,7432,8319,15751
2489,6079,30-34,7424,8608,16032
2490,6079,35-39,8004,8898,16902
2491,6079,40-44,7592,8816,16408
2492,6079,45-49,6640,7594,14234
2493,6079,50-54,7338,8082,15420
2494,6079,55-59,8616,8379,16995
2495,6079,60-64,10294,9210,19504
2496,6079,65+,32398,28220,60618
2497,6081,15-19,19779,21033,40812
2498,6081,20-24,18161,19387,37548
2499,6081,25-29,22990,24814,47804
2500,6081,30-34,27028,29660,56688
2501,6081,35-39,27323,28674,55997
2502,6081,40-44,25794,25960,51754
2503,6081,45-49,24390,24964,49354
2504,6081,50-54,25486,25473,50959
2505,6081,55-59,25477,24803,50280
2506,6081,60-64,23980,23211,47191
2507,6081,65+,71462,57449,128911
2508,6083,15-19,19009,18219,37228
2509,6083,20-24,23605,24019,47624
2510,6083,25-29,14934,16445,31379
2511,6083,30-34,13308,14968,28276
2512,6083,35-39,12802,14356,27158
2513,6083,40-44,11904,13005,24909
2514,6083,45-49,11030,11676,22706
2515,6083,50-54,11532,12100,23632
2516,6083,55-59,12390,12250,24640
2517,6083,60-64,12691,12230,24921
2518,6083,65+,38694,32703,71397
2519,6085,15-19,57186,60241,117427
2520,6085,20-24,53073,56747,109820
2521,6085,25-29,65294,76114,141408
2522,6085,30-34,71756,84115,155871
2523,6085,35-39,68100,76922,145022
2524,6085,40-44,63085,66550,129635
2525,6085,45-49,62787,64810,127597
2526,6085,50-54,62668,65082,127750
2527,6085,55-59,59279,62762,122041
2528,6085,60-64,53806,55285,109091
2529,6085,65+,149022,123891,272913
2530,6087,15-19,11368,10848,22216
2531,6087,20-24,13125,12994,26119
2532,6087,25-29,7899,8353,16252
2533,6087,30-34,7613,8112,15725
2534,6087,35-39,7926,8133,16059
2535,6087,40-44,7975,7963,15938
2536,6087,45-49,7476,7678,15154
2537,6087,50-54,8153,8484,16637
2538,6087,55-59,8487,8219,16706
2539,6087,60-64,8944,8534,17478
2540,6087,65+,26063,22872,48935
2541,6089,15-19,5207,5501,10708
2542,6089,20-24,4617,5067,9684
2543,6089,25-29,5329,5561,10890
2544,6089,30-34,6100,6084,12184
2545,6089,35-39,5944,5996,11940
2546,6089,40-44,5248,5434,10682
2547,6089,45-49,4603,4600,9203
2548,6089,50-54,5416,5120,10536
2549,6089,55-59,6287,5822,12109
2550,6089,60-64,6805,6273,13078
2551,6089,65+,20662,17655,38317
2552,6091,15-19,61,85,146
2553,6091,20-24,48,51,99
2554,6091,25-29,54,78,132
2555,6091,30-34,64,73,137
2556,6091,35-39,83,89,172
2557,6091,40-44,99,98,197
2558,6091,45-49,94,85,179
2559,6091,50-54,95,103,198
2560,6091,55-59,125,117,242
2561,6091,60-64,164,163,327
2562,6091,65+,500,499,999
2563,6093,15-19,1151,1324,2475
2564,6093,20-24,924,1071,1995
2565,6093,25-29,1006,1093,2099
2566,6093,30-34,1143,1196,2339
2567,6093,35-39,1273,1289,2562
2568,6093,40-44,1129,1177,2306
2569,6093,45-49,1022,1113,2135
2570,6093,50-54,1298,1215,2513
2571,6093,55-59,1464,1342,2806
2572,6093,60-64,1976,1707,3683
2573,6093,65+,6114,5758,11872
2574,6095,15-19,12945,14058,27003
2575,6095,20-24,12860,14644,27504
2576,6095,25-29,14675,15952,30627
2577,6095,30-34,16205,17281,33486
2578,6095,35-39,15718,16830,32548
2579,6095,40-44,14109,14879,28988
2580,6095,45-49,12674,13484,26158
2581,6095,50-54,13689,14195,27884
2582,6095,55-59,14980,14712,29692
2583,6095,60-64,15170,14144,29314
2584,6095,65+,42090,34224,76314
2585,6097,15-19,14574,14870,29444
2586,6097,20-24,13005,13244,26249
2587,6097,25-29,14090,14687,28777
2588,6097,30-34,15402,16141,31543
2589,6097,35-39,16029,16492,32521
2590,6097,40-44,15572,15912,31484
2591,6097,45-49,14064,14484,28548
2592,6097,50-54,15606,15712,31318
2593,6097,55-59,17234,16207,33441
2594,6097,60-64,18196,16550,34746
2595,6097,65+,56495,46123,102618
2596,6099,15-19,20179,21305,41484
2597,6099,20-24,17871,18637,36508
2598,6099,25-29,18877,19692,38569
2599,6099,30-34,19904,20445,40349
2600,6099,35-39,18558,19379,37937
2601,6099,40-44,17363,17997,35360
2602,6099,45-49,15786,16051,31837
2603,6099,50-54,15978,16212,32190
2604,6099,55-59,15995,15616,31611
2605,6099,60-64,15297,14710,30007
2606,6099,65+,41071,33286,74357
2607,6101,15-19,3416,3662,7078
2608,6101,20-24,2967,3049,6016
2609,6101,25-29,3226,3436,6662
2610,6101,30-34,3406,3514,6920
2611,6101,35-39,3230,3313,6543
2612,6101,40-44,3035,3101,6136
2613,6101,45-49,2785,2746,5531
2614,6101,50-54,2843,2829,5672
2615,6101,55-59,2969,3046,6015
2616,6101,60-64,2990,2849,5839
2617,6101,65+,8610,7286,15896
2618,6103,15-19,1990,2224,4214
2619,6103,20-24,1719,1713,3432
2620,6103,25-29,1874,1958,3832
2621,6103,30-34,1964,2007,3971
2622,6103,35-39,1922,2039,3961
2623,6103,40-44,1845,1863,3708
2624,6103,45-49,1654,1777,3431
2625,6103,50-54,1830,1868,3698
2626,6103,55-59,2321,2147,4468
2627,6103,60-64,2382,2278,4660
2628,6103,65+,7012,6204,13216
2629,6105,15-19,337,432,769
2630,6105,20-24,294,305,599
2631,6105,25-29,344,377,721
2632,6105,30-34,374,361,735
2633,6105,35-39,391,461,852
2634,6105,40-44,440,460,900
2635,6105,45-49,428,447,875
2636,6105,50-54,419,521,940
2637,6105,55-59,580,617,1197
2638,6105,60-64,765,718,1483
2639,6105,65+,2261,2413,4674
2640,6107,15-19,19382,20292,39674
2641,6107,20-24,16696,17009,33705
2642,6107,25-29,16807,17016,33823
2643,6107,30-34,16394,17147,33541
2644,6107,35-39,15979,16417,32396
2645,6107,40-44,14857,15444,30301
2646,6107,45-49,13027,13351,26378
2647,6107,50-54,12582,12975,25557
2648,6107,55-59,12308,12266,24574
2649,6107,60-64,11542,11236,22778
2650,6107,65+,30155,25417,55572
2651,6109,15-19,1282,1342,2624
2652,6109,20-24,1107,1484,2591
2653,6109,25-29,1269,1910,3179
2654,6109,30-34,1478,2060,3538
2655,6109,35-39,1451,1959,3410
2656,6109,40-44,1391,1936,3327
2657,6109,45-49,1186,1659,2845
2658,6109,50-54,1455,1671,3126
2659,6109,55-59,1805,1807,3612
2660,6109,60-64,2329,2241,4570
2661,6109,65+,7860,7340,15200
2662,6111,15-19,27561,28486,56047
2663,6111,20-24,26333,27027,53360
2664,6111,25-29,27498,28767,56265
2665,6111,30-34,27273,28774,56047
2666,6111,35-39,26669,28216,54885
2667,6111,40-44,26134,26662,52796
2668,6111,45-49,25723,25281,51004
2669,6111,50-54,27823,28014,55837
2670,6111,55-59,28367,28187,56554
2671,6111,60-64,27966,27122,55088
2672,6111,65+,76090,64142,140232
2673,6113,15-19,11481,10218,21699
2674,6113,20-24,15640,13970,29610
2675,6113,25-29,7690,7674,15364
2676,6113,30-34,6783,7092,13875
2677,6113,35-39,6731,6800,13531
2678,6113,40-44,6550,6485,13035
2679,6113,45-49,5658,5713,11371
2680,6113,50-54,5838,5713,11551
2681,6113,55-59,5692,5511,11203
2682,6113,60-64,5642,5233,10875
2683,6113,65+,15870,12820,28690
2684,6115,15-19,2628,2956,5584
2685,6115,20-24,2453,3026,5479
2686,6115,25-29,3000,3277,6277
2687,6115,30-34,3337,3336,6673
2688,6115,35-39,2937,3133,6070
2689,6115,40-44,2643,2677,5320
2690,6115,45-49,2114,2088,4202
2691,6115,50-54,2136,2187,4323
2692,6115,55-59,2264,2374,4638
2693,6115,60-64,2297,2208,4505
2694,6115,65+,5758,5251,11009
2695,8001,15-19,17772,19109,36881
2696,8001,20-24,16414,17211,33625
2697,8001,25-29,19646,20654,40300
2698,8001,30-34,21188,22800,43988
2699,8001,35-39,20381,22236,42617
2700,8001,40-44,18258,19730,37988
2701,8001,45-49,15943,17285,33228
2702,8001,50-54,15304,15980,31284
2703,8001,55-59,14317,14824,29141
2704,8001,60-64,13541,13616,27157
2705,8001,65+,31383,26284,57667
2706,8003,15-19,712,788,1500
2707,8003,20-24,907,820,1727
2708,8003,25-29,525,559,1084
2709,8003,30-34,558,570,1128
2710,8003,35-39,526,508,1034
2711,8003,40-44,469,492,961
2712,8003,45-49,382,406,788
2713,8003,50-54,394,383,777
2714,8003,55-59,443,423,866
2715,8003,60-64,477,413,890
2716,8003,65+,1282,1153,2435
2717,8005,15-19,19931,21540,41471
2718,8005,20-24,18854,19477,38331
2719,8005,25-29,24019,25448,49467
2720,8005,30-34,25361,27171,52532
2721,8005,35-39,25067,26221,51288
2722,8005,40-44,23057,23717,46774
2723,8005,45-49,20962,21412,42374
2724,8005,50-54,20484,20908,41392
2725,8005,55-59,19682,19346,39028
2726,8005,60-64,19692,18318,38010
2727,8005,65+,50685,41245,91930
2728,8007,15-19,318,327,645
2729,8007,20-24,237,249,486
2730,8007,25-29,275,302,577
2731,8007,30-34,360,356,716
2732,8007,35-39,392,409,801
2733,8007,40-44,390,440,830
2734,8007,45-49,339,359,698
2735,8007,50-54,406,397,803
2736,8007,55-59,570,472,1042
2737,8007,60-64,736,708,1444
2738,8007,65+,1871,1897,3768
2739,8009,15-19,95,83,178
2740,8009,20-24,95,92,187
2741,8009,25-29,85,102,187
2742,8009,30-34,78,99,177
2743,8009,35-39,106,100,206
2744,8009,40-44,99,103,202
2745,8009,45-49,67,85,152
2746,8009,50-54,99,84,183
2747,8009,55-59,108,108,216
2748,8009,60-64,144,130,274
2749,8009,65+,468,410,878
2750,8011,15-19,134,131,265
2751,8011,20-24,99,299,398
2752,8011,25-29,103,395,498
2753,8011,30-34,91,325,416
2754,8011,35-39,94,348,442
2755,8011,40-44,104,320,424
2756,8011,45-49,95,311,406
2757,8011,50-54,107,252,359
2758,8011,55-59,135,210,345
2759,8011,60-64,162,192,354
2760,8011,65+,546,560,1106
2761,8013,15-19,13130,13398,26528
2762,8013,20-24,15503,17117,32620
2763,8013,25-29,10649,12418,23067
2764,8013,30-34,10425,11849,22274
2765,8013,35-39,10025,11172,21197
2766,8013,40-44,10488,10577,21065
2767,8013,45-49,10205,10242,20447
2768,8013,50-54,10520,10934,21454
2769,8013,55-59,10220,10000,20220
2770,8013,60-64,10372,10169,20541
2771,8013,65+,28202,24286,52488
2772,8014,15-19,2312,2487,4799
2773,8014,20-24,2184,2179,4363
2774,8014,25-29,2802,3128,5930
2775,8014,30-34,2743,3290,6033
2776,8014,35-39,2626,2907,5533
2777,8014,40-44,2766,2782,5548
2778,8014,45-49,2551,2704,5255
2779,8014,50-54,2477,2650,5127
2780,8014,55-59,2190,2241,4431
2781,8014,60-64,2193,2098,4291
2782,8014,65+,6318,5000,11318
2783,8015,15-19,395,463,858
2784,8015,20-24,336,526,862
2785,8015,25-29,437,736,1173
2786,8015,30-34,600,795,1395
2787,8015,35-39,629,796,1425
2788,8015,40-44,568,718,1286
2789,8015,45-49,511,644,1155
2790,8015,50-54,526,656,1182
2791,8015,55-59,720,681,1401
2792,8015,60-64,875,810,1685
2793,8015,65+,2689,2544,5233
2794,8017,15-19,44,60,104
2795,8017,20-24,35,40,75
2796,8017,25-29,36,37,73
2797,8017,30-34,38,39,77
2798,8017,35-39,58,61,119
2799,8017,40-44,57,65,122
2800,8017,45-49,38,39,77
2801,8017,50-54,45,49,94
2802,8017,55-59,56,62,118
2803,8017,60-64,55,66,121
2804,8017,65+,204,179,383
2805,8019,15-19,180,226,406
2806,8019,20-24,170,183,353
2807,8019,25-29,192,273,465
2808,8019,30-34,342,389,731
2809,8019,35-39,309,357,666
2810,8019,40-44,298,330,628
2811,8019,45-49,281,336,617
2812,8019,50-54,391,380,771
2813,8019,55-59,391,390,781
2814,8019,60-64,426,475,901
2815,8019,65+,981,1096,2077
2816,8021,15-19,261,262,523
2817,8021,20-24,214,214,428
2818,8021,25-29,216,209,425
2819,8021,30-34,207,218,425
2820,8021,35-39,209,216,425
2821,8021,40-44,216,227,443
2822,8021,45-49,168,198,366
2823,8021,50-54,217,215,432
2824,8021,55-59,236,245,481
2825,8021,60-64,276,274,550
2826,8021,65+,770,753,1523
2827,8023,15-19,100,119,219
2828,8023,20-24,70,77,147
2829,8023,25-29,81,100,181
2830,8023,30-34,95,98,193
2831,8023,35-39,92,82,174
2832,8023,40-44,83,115,198
2833,8023,45-49,84,77,161
2834,8023,50-54,96,125,221
2835,8023,55-59,122,136,258
2836,8023,60-64,182,173,355
2837,8023,65+,455,500,955
2838,8025,15-19,110,113,223
2839,8025,20-24,65,424,489
2840,8025,25-29,67,581,648
2841,8025,30-34,91,512,603
2842,8025,35-39,63,491,554
2843,8025,40-44,90,449,539
2844,8025,45-49,77,448,525
2845,8025,50-54,90,316,406
2846,8025,55-59,101,234,335
2847,8025,60-64,144,185,329
2848,8025,65+,396,402,798
2849,8027,15-19,97,104,201
2850,8027,20-24,95,102,197
2851,8027,25-29,77,112,189
2852,8027,30-34,85,106,191
2853,8027,35-39,105,118,223
2854,8027,40-44,96,132,228
2855,8027,45-49,113,127,240
2856,8027,50-54,131,133,264
2857,8027,55-59,224,178,402
2858,8027,60-64,336,321,657
2859,8027,65+,805,870,1675
2860,8029,15-19,888,920,1808
2861,8029,20-24,639,780,1419
2862,8029,25-29,717,812,1529
2863,8029,30-34,752,815,1567
2864,8029,35-39,853,913,1766
2865,8029,40-44,861,954,1815
2866,8029,45-49,777,821,1598
2867,8029,50-54,880,875,1755
2868,8029,55-59,1061,1075,2136
2869,8029,60-64,1352,1308,2660
2870,8029,65+,4536,4092,8628
2871,8031,15-19,17704,17823,35527
2872,8031,20-24,21962,20637,42599
2873,8031,25-29,40807,40434,81241
2874,8031,30-34,40116,43336,83452
2875,8031,35-39,32118,35710,67828
2876,8031,40-44,25070,27522,52592
2877,8031,45-49,20496,22913,43409
2878,8031,50-54,18657,20996,39653
2879,8031,55-59,16445,17812,34257
2880,8031,60-64,16919,16022,32941
2881,8031,65+,47951,38529,86480
2882,8033,15-19,49,71,120
2883,8033,20-24,47,58,105
2884,8033,25-29,50,60,110
2885,8033,30-34,62,56,118
2886,8033,35-39,65,81,146
2887,8033,40-44,67,68,135
2888,8033,45-49,54,76,130
2889,8033,50-54,82,69,151
2890,8033,55-59,90,76,166
2891,8033,60-64,100,137,237
2892,8033,65+,290,337,627
2893,8035,15-19,13032,13890,26922
2894,8035,20-24,9817,10229,20046
2895,8035,25-29,9950,10643,20593
2896,8035,30-34,11509,11625,23134
2897,8035,35-39,13322,13868,27190
2898,8035,40-44,13712,14048,27760
2899,8035,45-49,13735,13980,27715
2900,8035,50-54,14160,14661,28821
2901,8035,55-59,12664,12726,25390
2902,8035,60-64,11145,11012,22157
2903,8035,65+,25997,22768,48765
2904,8037,15-19,1654,1833,3487
2905,8037,20-24,1327,1423,2750
2906,8037,25-29,1772,2077,3849
2907,8037,30-34,1918,2418,4336
2908,8037,35-39,2009,2322,4331
2909,8037,40-44,2084,2281,4365
2910,8037,45-49,1910,2227,4137
2911,8037,50-54,1944,2271,4215
2912,8037,55-59,1771,1941,3712
2913,8037,60-64,1682,1867,3549
2914,8037,65+,3638,4053,7691
2915,8039,15-19,880,892,1772
2916,8039,20-24,588,686,1274
2917,8039,25-29,594,644,1238
2918,8039,30-34,690,673,1363
2919,8039,35-39,791,857,1648
2920,8039,40-44,829,836,1665
2921,8039,45-49,897,929,1826
2922,8039,50-54,977,1077,2054
2923,8039,55-59,1163,1218,2381
2924,8039,60-64,1198,1255,2453
2925,8039,65+,2431,2468,4899
2926,8041,15-19,23354,26222,49576
2927,8041,20-24,25281,32536,57817
2928,8041,25-29,28357,32417,60774
2929,8041,30-34,27888,30225,58113
2930,8041,35-39,26242,28138,54380
2931,8041,40-44,22899,23751,46650
2932,8041,45-49,20107,20798,40905
2933,8041,50-54,20577,20548,41125
2934,8041,55-59,22272,20992,43264
2935,8041,60-64,21575,20424,41999
2936,8041,65+,54508,45316,99824
2937,8043,15-19,1081,1204,2285
2938,8043,20-24,903,1599,2502
2939,8043,25-29,981,2463,3444
2940,8043,30-34,1124,2483,3607
2941,8043,35-39,1156,2442,3598
2942,8043,40-44,1095,2237,3332
2943,8043,45-49,996,1994,2990
2944,8043,50-54,1250,1899,3149
2945,8043,55-59,1598,1775,3373
2946,8043,60-64,1875,1873,3748
2947,8043,65+,5726,5422,11148
2948,8045,15-19,1927,2194,4121
2949,8045,20-24,1637,1789,3426
2950,8045,25-29,1943,2134,4077
2951,8045,30-34,2075,2269,4344
2952,8045,35-39,2139,2374,4513
2953,8045,40-44,2099,2275,4374
2954,8045,45-49,1836,2010,3846
2955,8045,50-54,1904,2049,3953
2956,8045,55-59,1826,1966,3792
2957,8045,60-64,2052,2052,4104
2958,8045,65+,4572,4408,8980
2959,8047,15-19,138,131,269
2960,8047,20-24,87,117,204
2961,8047,25-29,104,130,234
2962,8047,30-34,186,204,390
2963,8047,35-39,185,202,387
2964,8047,40-44,203,224,427
2965,8047,45-49,239,289,528
2966,8047,50-54,199,246,445
2967,8047,55-59,266,311,577
2968,8047,60-64,301,320,621
2969,8047,65+,536,608,1144
2970,8049,15-19,399,420,819
2971,8049,20-24,338,370,708
2972,8049,25-29,441,573,1014
2973,8049,30-34,500,620,1120
2974,8049,35-39,516,656,1172
2975,8049,40-44,517,561,1078
2976,8049,45-49,456,528,984
2977,8049,50-54,476,574,1050
2978,8049,55-59,589,582,1171
2979,8049,60-64,730,774,1504
2980,8049,65+,1436,1765,3201
2981,8051,15-19,626,736,1362
2982,8051,20-24,885,1154,2039
2983,8051,25-29,564,721,1285
2984,8051,30-34,562,657,1219
2985,8051,35-39,591,643,1234
2986,8051,40-44,549,646,1195
2987,8051,45-49,463,607,1070
2988,8051,50-54,516,595,1111
2989,8051,55-59,517,472,989
2990,8051,60-64,506,523,1029
2991,8051,65+,1132,1338,2470
2992,8053,15-19,12,22,34
2993,8053,20-24,27,25,52
2994,8053,25-29,19,12,31
2995,8053,30-34,16,19,35
2996,8053,35-39,12,21,33
2997,8053,40-44,21,24,45
2998,8053,45-49,23,22,45
2999,8053,50-54,13,15,28
3000,8053,55-59,38,24,62
3001,8053,60-64,43,30,73
3002,8053,65+,108,135,243
3003,8055,15-19,156,194,350
3004,8055,20-24,119,143,262
3005,8055,25-29,144,149,293
3006,8055,30-34,167,149,316
3007,8055,35-39,148,166,314
3008,8055,40-44,170,175,345
3009,8055,45-49,139,205,344
3010,8055,50-54,178,195,373
3011,8055,55-59,275,235,510
3012,8055,60-64,397,322,719
3013,8055,65+,1084,1132,2216
3014,8057,15-19,26,29,55
3015,8057,20-24,29,19,48
3016,8057,25-29,24,24,48
3017,8057,30-34,37,43,80
3018,8057,35-39,29,55,84
3019,8057,40-44,40,51,91
3020,8057,45-49,45,52,97
3021,8057,50-54,42,51,93
3022,8057,55-59,57,49,106
3023,8057,60-64,56,60,116
3024,8057,65+,165,183,348
3025,8059,15-19,15495,17007,32502
3026,8059,20-24,14484,15752,30236
3027,8059,25-29,19368,21241,40609
3028,8059,30-34,22814,25005,47819
3029,8059,35-39,21934,23893,45827
3030,8059,40-44,19743,20828,40571
3031,8059,45-49,17170,18250,35420
3032,8059,50-54,18222,18791,37013
3033,8059,55-59,19963,18999,38962
3034,8059,60-64,20771,19763,40534
3035,8059,65+,54406,46207,100613
3036,8061,15-19,37,45,82
3037,8061,20-24,28,36,64
3038,8061,25-29,48,36,84
3039,8061,30-34,38,30,68
3040,8061,35-39,37,46,83
3041,8061,40-44,34,33,67
3042,8061,45-49,37,30,67
3043,8061,50-54,35,27,62
3044,8061,55-59,52,50,102
3045,8061,60-64,62,66,128
3046,8061,65+,185,171,356
3047,8063,15-19,212,240,452
3048,8063,20-24,171,182,353
3049,8063,25-29,186,177,363
3050,8063,30-34,198,216,414
3051,8063,35-39,190,258,448
3052,8063,40-44,207,204,411
3053,8063,45-49,164,166,330
3054,8063,50-54,176,159,335
3055,8063,55-59,230,195,425
3056,8063,60-64,258,270,528
3057,8063,65+,720,709,1429
3058,8065,15-19,200,220,420
3059,8065,20-24,207,263,470
3060,8065,25-29,282,310,592
3061,8065,30-34,288,349,637
3062,8065,35-39,258,327,585
3063,8065,40-44,229,297,526
3064,8065,45-49,194,271,465
3065,8065,50-54,212,244,456
3066,8065,55-59,209,224,433
3067,8065,60-64,203,253,456
3068,8065,65+,513,564,1077
3069,8067,15-19,1748,1906,3654
3070,8067,20-24,1549,1611,3160
3071,8067,25-29,1637,1808,3445
3072,8067,30-34,1844,1905,3749
3073,8067,35-39,1946,2083,4029
3074,8067,40-44,1845,1907,3752
3075,8067,45-49,1674,1800,3474
3076,8067,50-54,1702,1749,3451
3077,8067,55-59,1948,1757,3705
3078,8067,60-64,2277,2161,4438
3079,8067,65+,5628,5551,11179
3080,8069,15-19,13223,12870,26093
3081,8069,20-24,18075,18539,36614
3082,8069,25-29,13496,14730,28226
3083,8069,30-34,12119,13369,25488
3084,8069,35-39,11499,12435,23934
3085,8069,40-44,11221,11804,23025
3086,8069,45-49,9687,10444,20131
3087,8069,50-54,9662,9964,19626
3088,8069,55-59,10601,9745,20346
3089,8069,60-64,11576,10880,22456
3090,8069,65+,32933,28446,61379
3091,8071,15-19,399,476,875
3092,8071,20-24,342,542,884
3093,8071,25-29,364,494,858
3094,8071,30-34,345,457,802
3095,8071,35-39,374,480,854
3096,8071,40-44,354,435,789
3097,8071,45-49,357,411,768
3098,8071,50-54,413,409,822
3099,8071,55-59,466,497,963
3100,8071,60-64,574,619,1193
3101,8071,65+,1875,1845,3720
3102,8073,15-19,139,148,287
3103,8073,20-24,108,218,326
3104,8073,25-29,139,341,480
3105,8073,30-34,145,324,469
3106,8073,35-39,123,299,422
3107,8073,40-44,140,237,377
3108,8073,45-49,112,208,320
3109,8073,50-54,141,222,363
3110,8073,55-59,167,195,362
3111,8073,60-64,159,219,378
3112,8073,65+,509,468,977
3113,8075,15-19,536,824,1360
3114,8075,20-24,538,940,1478
3115,8075,25-29,568,1175,1743
3116,8075,30-34,580,1087,1667
3117,8075,35-39,573,1011,1584
3118,8075,40-44,505,864,1369
3119,8075,45-49,467,762,1229
3120,8075,50-54,482,753,1235
3121,8075,55-59,609,705,1314
3122,8075,60-64,647,747,1394
3123,8075,65+,2098,1800,3898
3124,8077,15-19,5045,5440,10485
3125,8077,20-24,4464,4598,9062
3126,8077,25-29,4828,5074,9902
3127,8077,30-34,5201,5196,10397
3128,8077,35-39,5047,5448,10495
3129,8077,40-44,4877,5020,9897
3130,8077,45-49,4125,4282,8407
3131,8077,50-54,4211,4284,8495
3132,8077,55-59,5098,4655,9753
3133,8077,60-64,5915,5409,11324
3134,8077,65+,17229,15007,32236
3135,8079,15-19,13,29,42
3136,8079,20-24,19,15,34
3137,8079,25-29,11,18,29
3138,8079,30-34,23,34,57
3139,8079,35-39,43,29,72
3140,8079,40-44,20,23,43
3141,8079,45-49,27,31,58
3142,8079,50-54,34,37,71
3143,8079,55-59,40,29,69
3144,8079,60-64,49,35,84
3145,8079,65+,131,136,267
3146,8081,15-19,398,470,868
3147,8081,20-24,361,388,749
3148,8081,25-29,376,386,762
3149,8081,30-34,431,422,853
3150,8081,35-39,411,507,918
3151,8081,40-44,367,452,819
3152,8081,45-49,372,356,728
3153,8081,50-54,379,408,787
3154,8081,55-59,412,475,887
3155,8081,60-64,436,472,908
3156,8081,65+,1107,1105,2212
3157,8083,15-19,721,765,1486
3158,8083,20-24,575,652,1227
3159,8083,25-29,667,714,1381
3160,8083,30-34,770,736,1506
3161,8083,35-39,777,788,1565
3162,8083,40-44,729,745,1474
3163,8083,45-49,683,683,1366
3164,8083,50-54,781,712,1493
3165,8083,55-59,881,807,1688
3166,8083,60-64,1119,1023,2142
3167,8083,65+,3237,3033,6270
3168,8085,15-19,1199,1243,2442
3169,8085,20-24,989,1089,2078
3170,8085,25-29,993,1136,2129
3171,8085,30-34,1130,1071,2201
3172,8085,35-39,1283,1356,2639
3173,8085,40-44,1264,1219,2483
3174,8085,45-49,1106,1117,2223
3175,8085,50-54,1233,1255,2488
3176,8085,55-59,1491,1369,2860
3177,8085,60-64,1807,1663,3470
3178,8085,65+,5690,5138,10828
3179,8087,15-19,912,978,1890
3180,8087,20-24,804,891,1695
3181,8087,25-29,967,1021,1988
3182,8087,30-34,962,1131,2093
3183,8087,35-39,869,1081,1950
3184,8087,40-44,818,906,1724
3185,8087,45-49,731,791,1522
3186,8087,50-54,779,901,1680
3187,8087,55-59,818,872,1690
3188,8087,60-64,863,932,1795
3189,8087,65+,2479,2175,4654
3190,8089,15-19,684,783,1467
3191,8089,20-24,474,570,1044
3192,8089,25-29,509,528,1037
3193,8089,30-34,509,538,1047
3194,8089,35-39,595,549,1144
3195,8089,40-44,553,555,1108
3196,8089,45-49,507,494,1001
3197,8089,50-54,509,443,952
3198,8089,55-59,600,584,1184
3199,8089,60-64,650,599,1249
3200,8089,65+,2031,1782,3813
3201,8091,15-19,102,115,217
3202,8091,20-24,74,72,146
3203,8091,25-29,93,85,178
3204,8091,30-34,128,129,257
3205,8091,35-39,148,150,298
3206,8091,40-44,129,149,278
3207,8091,45-49,158,164,322
3208,8091,50-54,139,167,306
3209,8091,55-59,226,195,421
3210,8091,60-64,288,250,538
3211,8091,65+,724,797,1521
3212,8093,15-19,381,395,776
3213,8093,20-24,240,300,540
3214,8093,25-29,324,397,721
3215,8093,30-34,502,521,1023
3216,8093,35-39,493,583,1076
3217,8093,40-44,535,638,1173
3218,8093,45-49,510,611,1121
3219,8093,50-54,635,734,1369
3220,8093,55-59,819,869,1688
3221,8093,60-64,964,1076,2040
3222,8093,65+,1895,2209,4104
3223,8095,15-19,150,219,369
3224,8095,20-24,85,109,194
3225,8095,25-29,112,107,219
3226,8095,30-34,107,130,237
3227,8095,35-39,145,132,277
3228,8095,40-44,125,123,248
3229,8095,45-49,124,104,228
3230,8095,50-54,131,131,262
3231,8095,55-59,116,144,260
3232,8095,60-64,170,149,319
3233,8095,65+,553,443,996
3234,8097,15-19,372,407,779
3235,8097,20-24,383,373,756
3236,8097,25-29,544,679,1223
3237,8097,30-34,605,646,1251
3238,8097,35-39,585,672,1257
3239,8097,40-44,543,563,1106
3240,8097,45-49,561,607,1168
3241,8097,50-54,624,742,1366
3242,8097,55-59,618,640,1258
3243,8097,60-64,643,650,1293
3244,8097,65+,1784,2009,3793
3245,8099,15-19,470,489,959
3246,8099,20-24,353,416,769
3247,8099,25-29,315,357,672
3248,8099,30-34,318,332,650
3249,8099,35-39,346,366,712
3250,8099,40-44,362,337,699
3251,8099,45-49,313,329,642
3252,8099,50-54,287,324,611
3253,8099,55-59,350,350,700
3254,8099,60-64,420,388,808
3255,8099,65+,1189,1012,2201
3256,8101,15-19,5312,5771,11083
3257,8101,20-24,4953,5353,10306
3258,8101,25-29,5411,5687,11098
3259,8101,30-34,5557,5653,11210
3260,8101,35-39,5456,5542,10998
3261,8101,40-44,5202,5280,10482
3262,8101,45-49,4705,4764,9469
3263,8101,50-54,4959,4969,9928
3264,8101,55-59,5361,5187,10548
3265,8101,60-64,5891,5354,11245
3266,8101,65+,17674,14710,32384
3267,8103,15-19,238,261,499
3268,8103,20-24,157,221,378
3269,8103,25-29,160,170,330
3270,8103,30-34,207,194,401
3271,8103,35-39,230,228,458
3272,8103,40-44,184,226,410
3273,8103,45-49,153,160,313
3274,8103,50-54,167,174,341
3275,8103,55-59,210,227,437
3276,8103,60-64,253,240,493
3277,8103,65+,566,617,1183
3278,8105,15-19,350,378,728
3279,8105,20-24,308,335,643
3280,8105,25-29,315,321,636
3281,8105,30-34,331,341,672
3282,8105,35-39,352,398,750
3283,8105,40-44,338,338,676
3284,8105,45-49,304,331,635
3285,8105,50-54,342,282,624
3286,8105,55-59,361,348,709
3287,8105,60-64,402,418,820
3288,8105,65+,1281,1241,2522
3289,8107,15-19,629,737,1366
3290,8107,20-24,515,630,1145
3291,8107,25-29,775,827,1602
3292,8107,30-34,851,1022,1873
3293,8107,35-39,906,1051,1957
3294,8107,40-44,904,969,1873
3295,8107,45-49,789,928,1717
3296,8107,50-54,871,971,1842
3297,8107,55-59,836,857,1693
3298,8107,60-64,991,1008,1999
3299,8107,65+,2139,2353,4492
3300,8109,15-19,177,227,404
3301,8109,20-24,133,140,273
3302,8109,25-29,133,149,282
3303,8109,30-34,131,133,264
3304,8109,35-39,179,188,367
3305,8109,40-44,204,149,353
3306,8109,45-49,199,200,399
3307,8109,50-54,173,177,350
3308,8109,55-59,310,231,541
3309,8109,60-64,326,292,618
3310,8109,65+,774,873,1647
3311,8111,15-19,8,18,26
3312,8111,20-24,8,13,21
3313,8111,25-29,25,24,49
3314,8111,30-34,24,23,47
3315,8111,35-39,27,26,53
3316,8111,40-44,30,34,64
3317,8111,45-49,19,27,46
3318,8111,50-54,17,34,51
3319,8111,55-59,26,31,57
3320,8111,60-64,19,46,65
3321,8111,65+,93,89,182
3322,8113,15-19,173,206,379
3323,8113,20-24,174,169,343
3324,8113,25-29,281,294,575
3325,8113,30-34,295,372,667
3326,8113,35-39,270,324,594
3327,8113,40-44,280,287,567
3328,8113,45-49,289,296,585
3329,8113,50-54,320,369,689
3330,8113,55-59,286,301,587
3331,8113,60-64,248,352,600
3332,8113,65+,601,774,1375
3333,8115,15-19,70,72,142
3334,8115,20-24,43,53,96
3335,8115,25-29,42,31,73
3336,8115,30-34,55,56,111
3337,8115,35-39,78,61,139
3338,8115,40-44,71,68,139
3339,8115,45-49,63,69,132
3340,8115,50-54,45,50,95
3341,8115,55-59,74,79,153
3342,8115,60-64,93,116,209
3343,8115,65+,371,322,693
3344,8117,15-19,558,711,1269
3345,8117,20-24,604,752,1356
3346,8117,25-29,1252,1631,2883
3347,8117,30-34,1287,1738,3025
3348,8117,35-39,1143,1462,2605
3349,8117,40-44,1009,1229,2238
3350,8117,45-49,946,1215,2161
3351,8117,50-54,1005,1256,2261
3352,8117,55-59,986,1165,2151
3353,8117,60-64,1035,1175,2210
3354,8117,65+,2213,2518,4731
3355,8119,15-19,570,609,1179
3356,8119,20-24,444,484,928
3357,8119,25-29,537,598,1135
3358,8119,30-34,621,669,1290
3359,8119,35-39,688,793,1481
3360,8119,40-44,727,675,1402
3361,8119,45-49,689,734,1423
3362,8119,50-54,831,893,1724
3363,8119,55-59,1162,1130,2292
3364,8119,60-64,1331,1273,2604
3365,8119,65+,3035,3117,6152
3366,8121,15-19,144,150,294
3367,8121,20-24,99,138,237
3368,8121,25-29,133,145,278
3369,8121,30-34,131,162,293
3370,8121,35-39,141,169,310
3371,8121,40-44,134,160,294
3372,8121,45-49,119,154,273
3373,8121,50-54,121,156,277
3374,8121,55-59,134,161,295
3375,8121,60-64,192,171,363
3376,8121,65+,516,525,1041
3377,8123,15-19,12265,12323,24588
3378,8123,20-24,10276,10446,20722
3379,8123,25-29,11699,12199,23898
3380,8123,30-34,13275,14199,27474
3381,8123,35-39,12605,14108,26713
3382,8123,40-44,10986,12161,23147
3383,8123,45-49,9803,10844,20647
3384,8123,50-54,9706,10326,20032
3385,8123,55-59,9261,9560,18821
3386,8123,60-64,9242,9306,18548
3387,8123,65+,22783,20203,42986
3388,8125,15-19,338,364,702
3389,8125,20-24,228,279,507
3390,8125,25-29,265,280,545
3391,8125,30-34,293,297,590
3392,8125,35-39,323,341,664
3393,8125,40-44,252,287,539
3394,8125,45-49,249,267,516
3395,8125,50-54,262,304,566
3396,8125,55-59,275,301,576
3397,8125,60-64,308,312,620
3398,8125,65+,982,862,1844
3399,9001,15-19,32918,33679,66597
3400,9001,20-24,29582,30449,60031
3401,9001,25-29,26930,28038,54968
3402,9001,30-34,28536,27966,56502
3403,9001,35-39,30553,30844,61397
3404,9001,40-44,31462,30674,62136
3405,9001,45-49,31376,30220,61596
3406,9001,50-54,35484,34340,69824
3407,9001,55-59,37015,35305,72320
3408,9001,60-64,33745,31980,65725
3409,9001,65+,88068,70535,158603
3410,9003,15-19,28058,29230,57288
3411,9003,20-24,27635,28934,56569
3412,9003,25-29,28756,30555,59311
3413,9003,30-34,29323,30630,59953
3414,9003,35-39,30303,30410,60713
3415,9003,40-44,28814,28026,56840
3416,9003,45-49,26781,25667,52448
3417,9003,50-54,30349,28768,59117
3418,9003,55-59,32791,30852,63643
3419,9003,60-64,31250,29298,60548
3420,9003,65+,89747,68765,158512
3421,9005,15-19,4946,5363,10309
3422,9005,20-24,4656,4948,9604
3423,9005,25-29,4851,5233,10084
3424,9005,30-34,4902,5208,10110
3425,9005,35-39,5173,5411,10584
3426,9005,40-44,5096,5232,10328
3427,9005,45-49,5200,5126,10326
3428,9005,50-54,6944,6808,13752
3429,9005,55-59,7966,7848,15814
3430,9005,60-64,8010,7965,15975
3431,9005,65+,22406,19763,42169
3432,9007,15-19,4806,5146,9952
3433,9007,20-24,4916,5055,9971
3434,9007,25-29,4589,4904,9493
3435,9007,30-34,4914,4887,9801
3436,9007,35-39,5094,4993,10087
3437,9007,40-44,4563,4585,9148
3438,9007,45-49,4713,4586,9299
3439,9007,50-54,6183,5961,12144
3440,9007,55-59,6943,6670,13613
3441,9007,60-64,6844,6702,13546
3442,9007,65+,19592,16103,35695
3443,9009,15-19,28946,29140,58086
3444,9009,20-24,28829,29111,57940
3445,9009,25-29,28775,28888,57663
3446,9009,30-34,29112,28354,57466
3447,9009,35-39,28516,27448,55964
3448,9009,40-44,26656,24976,51632
3449,9009,45-49,25767,23931,49698
3450,9009,50-54,29694,27950,57644
3451,9009,55-59,31668,29721,61389
3452,9009,60-64,30998,29029,60027
3453,9009,65+,87810,68391,156201
3454,9011,15-19,8008,8673,16681
3455,9011,20-24,8112,10932,19044
3456,9011,25-29,8174,9861,18035
3457,9011,30-34,8296,9199,17495
3458,9011,35-39,8363,8277,16640
3459,9011,40-44,7551,7546,15097
3460,9011,45-49,7383,7110,14493
3461,9011,50-54,8921,8644,17565
3462,9011,55-59,10195,9890,20085
3463,9011,60-64,10164,9893,20057
3464,9011,65+,27909,23934,51843
3465,9013,15-19,6906,6825,13731
3466,9013,20-24,9484,9364,18848
3467,9013,25-29,4229,4673,8902
3468,9013,30-34,3949,4461,8410
3469,9013,35-39,4051,4613,8664
3470,9013,40-44,3886,4185,8071
3471,9013,45-49,3737,3908,7645
3472,9013,50-54,4741,4735,9476
3473,9013,55-59,5161,5213,10374
3474,9013,60-64,5072,5129,10201
3475,9013,65+,13497,11901,25398
3476,9015,15-19,3841,4045,7886
3477,9015,20-24,3607,3827,7434
3478,9015,25-29,3443,3858,7301
3479,9015,30-34,3630,3823,7453
3480,9015,35-39,3666,3769,7435
3481,9015,40-44,3540,3644,7184
3482,9015,45-49,3459,3474,6933
3483,9015,50-54,4011,4070,8081
3484,9015,55-59,4453,4426,8879
3485,9015,60-64,4428,4368,8796
3486,9015,65+,11279,9535,20814
3487,10001,15-19,6382,6242,12624
3488,10001,20-24,6191,6254,12445
3489,10001,25-29,5898,6006,11904
3490,10001,30-34,6308,6127,12435
3491,10001,35-39,6077,5651,11728
3492,10001,40-44,5678,5120,10798
3493,10001,45-49,5219,4555,9774
3494,10001,50-54,5557,5136,10693
3495,10001,55-59,6377,5688,12065
3496,10001,60-64,6305,5549,11854
3497,10001,65+,18266,14767,33033
3498,10003,15-19,19312,19165,38477
3499,10003,20-24,17206,17612,34818
3500,10003,25-29,18875,18883,37758
3501,10003,30-34,21441,21016,42457
3502,10003,35-39,19130,19302,38432
3503,10003,40-44,18445,17657,36102
3504,10003,45-49,16816,16194,33010
3505,10003,50-54,19687,18210,37897
3506,10003,55-59,20574,19220,39794
3507,10003,60-64,19930,18314,38244
3508,10003,65+,52937,42034,94971
3509,10005,15-19,5716,6001,11717
3510,10005,20-24,5112,5532,10644
3511,10005,25-29,5730,5981,11711
3512,10005,30-34,6146,5947,12093
3513,10005,35-39,6115,6116,12231
3514,10005,40-44,5835,5776,11611
3515,10005,45-49,5858,5583,11441
3516,10005,50-54,7179,6813,13992
3517,10005,55-59,9842,8631,18473
3518,10005,60-64,12573,10515,23088
3519,10005,65+,39260,34382,73642
3520,11001,15-19,18829,16834,35663
3521,11001,20-24,25320,20310,45630
3522,11001,25-29,38446,31554,70000
3523,11001,30-34,39132,36594,75726
3524,11001,35-39,32130,30750,62880
3525,11001,40-44,23881,23480,47361
3526,11001,45-49,18145,18128,36273
3527,11001,50-54,17078,17538,34616
3528,11001,55-59,17147,16955,34102
3529,11001,60-64,16720,15194,31914
3530,11001,65+,50262,35576,85838
3531,12001,15-19,11848,10701,22549
3532,12001,20-24,21471,19981,41452
3533,12001,25-29,10807,10837,21644
3534,12001,30-34,10039,9796,19835
3535,12001,35-39,8619,8527,17146
3536,12001,40-44,7916,7690,15606
3537,12001,45-49,6827,6720,13547
3538,12001,50-54,6870,6660,13530
3539,12001,55-59,7408,6728,14136
3540,12001,60-64,8047,6878,14925
3541,12001,65+,23593,18900,42493
3542,12003,15-19,848,923,1771
3543,12003,20-24,748,1025,1773
3544,12003,25-29,797,1186,1983
3545,12003,30-34,936,1248,2184
3546,12003,35-39,907,1089,1996
3547,12003,40-44,846,1022,1868
3548,12003,45-49,809,1067,1876
3549,12003,50-54,888,1020,1908
3550,12003,55-59,835,943,1778
3551,12003,60-64,865,891,1756
3552,12003,65+,2251,1928,4179
3553,12005,15-19,4775,4961,9736
3554,12005,20-24,4737,5176,9913
3555,12005,25-29,5436,5871,11307
3556,12005,30-34,6044,6241,12285
3557,12005,35-39,5819,5978,11797
3558,12005,40-44,5386,5599,10985
3559,12005,45-49,5306,5149,10455
3560,12005,50-54,6021,5920,11941
3561,12005,55-59,6724,6743,13467
3562,12005,60-64,6851,6491,13342
3563,12005,65+,17758,15340,33098
3564,12007,15-19,713,722,1435
3565,12007,20-24,654,1115,1769
3566,12007,25-29,751,1441,2192
3567,12007,30-34,799,1377,2176
3568,12007,35-39,718,1278,1996
3569,12007,40-44,717,1212,1929
3570,12007,45-49,696,1130,1826
3571,12007,50-54,744,1047,1791
3572,12007,55-59,835,973,1808
3573,12007,60-64,928,889,1817
3574,12007,65+,2834,2318,5152
3575,12009,15-19,15597,16971,32568
3576,12009,20-24,14540,16382,30922
3577,12009,25-29,16467,17902,34369
3578,12009,30-34,17639,18393,36032
3579,12009,35-39,17838,17509,35347
3580,12009,40-44,16948,16669,33617
3581,12009,45-49,17038,16040,33078
3582,12009,50-54,20088,19135,39223
3583,12009,55-59,25022,23414,48436
3584,12009,60-64,26992,25333,52325
3585,12009,65+,80107,69236,149343
3586,12011,15-19,54307,55701,110008
3587,12011,20-24,52608,52755,105363
3588,12011,25-29,59282,59271,118553
3589,12011,30-34,66048,65480,131528
3590,12011,35-39,66829,65733,132562
3591,12011,40-44,66361,64747,131108
3592,12011,45-49,64868,62383,127251
3593,12011,50-54,67747,66255,134002
3594,12011,55-59,70379,70020,140399
3595,12011,60-64,65012,63273,128285
3596,12011,65+,186547,151833,338380
3597,12013,15-19,344,399,743
3598,12013,20-24,327,453,780
3599,12013,25-29,315,596,911
3600,12013,30-34,388,600,988
3601,12013,35-39,344,522,866
3602,12013,40-44,363,514,877
3603,12013,45-49,377,566,943
3604,12013,50-54,383,545,928
3605,12013,55-59,439,475,914
3606,12013,60-64,449,440,889
3607,12013,65+,1375,1211,2586
3608,12015,15-19,3227,3581,6808
3609,12015,20-24,3195,3736,6931
3610,12015,25-29,3525,3932,7457
3611,12015,30-34,3668,4054,7722
3612,12015,35-39,3733,3883,7616
3613,12015,40-44,3698,3849,7547
3614,12015,45-49,4113,3902,8015
3615,12015,50-54,5895,5109,11004
3616,12015,55-59,8003,6926,14929
3617,12015,60-64,10192,8932,19124
3618,12015,65+,40903,38090,78993
3619,12017,15-19,3277,3477,6754
3620,12017,20-24,2734,3014,5748
3621,12017,25-29,3210,3512,6722
3622,12017,30-34,3481,3598,7079
3623,12017,35-39,3331,3382,6713
3624,12017,40-44,3340,3183,6523
3625,12017,45-49,3608,3466,7074
3626,12017,50-54,4887,4152,9039
3627,12017,55-59,6226,5461,11687
3628,12017,60-64,7615,6605,14220
3629,12017,65+,29918,27446,57364
3630,12019,15-19,7116,7622,14738
3631,12019,20-24,5871,6250,12121
3632,12019,25-29,6174,6411,12585
3633,12019,30-34,7284,7145,14429
3634,12019,35-39,7813,7492,15305
3635,12019,40-44,7518,7175,14693
3636,12019,45-49,7289,6849,14138
3637,12019,50-54,7526,7359,14885
3638,12019,55-59,7961,7889,15850
3639,12019,60-64,7738,7505,15243
3640,12019,65+,19899,17062,36961
3641,12021,15-19,9019,9784,18803
3642,12021,20-24,8253,9026,17279
3643,12021,25-29,8398,9100,17498
3644,12021,30-34,8622,9634,18256
3645,12021,35-39,9000,9856,18856
3646,12021,40-44,9362,9672,19034
3647,12021,45-49,9843,9525,19368
3648,12021,50-54,11572,11185,22757
3649,12021,55-59,13566,12561,26127
3650,12021,60-64,14817,13460,28277
3651,12021,65+,66700,60981,127681
3652,12023,15-19,1888,2275,4163
3653,12023,20-24,1679,2857,4536
3654,12023,25-29,1866,2327,4193
3655,12023,30-34,2112,2508,4620
3656,12023,35-39,2059,2394,4453
3657,12023,40-44,1924,2286,4210
3658,12023,45-49,1788,2181,3969
3659,12023,50-54,2022,2184,4206
3660,12023,55-59,2308,2373,4681
3661,12023,60-64,2471,2372,4843
3662,12023,65+,7389,6461,13850
3663,12027,15-19,834,1118,1952
3664,12027,20-24,773,1430,2203
3665,12027,25-29,828,1399,2227
3666,12027,30-34,876,1449,2325
3667,12027,35-39,854,1487,2341
3668,12027,40-44,813,1370,2183
3669,12027,45-49,772,1155,1927
3670,12027,50-54,848,1205,2053
3671,12027,55-59,964,1152,2116
3672,12027,60-64,1034,1097,2131
3673,12027,65+,3960,3819,7779
3674,12029,15-19,396,441,837
3675,12029,20-24,315,575,890
3676,12029,25-29,326,585,911
3677,12029,30-34,408,605,1013
3678,12029,35-39,445,633,1078
3679,12029,40-44,391,668,1059
3680,12029,45-49,356,584,940
3681,12029,50-54,465,623,1088
3682,12029,55-59,578,618,1196
3683,12029,60-64,673,706,1379
3684,12029,65+,2034,2070,4104
3685,12031,15-19,28009,29525,57534
3686,12031,20-24,31214,32326,63540
3687,12031,25-29,39510,39093,78603
3688,12031,30-34,41700,40725,82425
3689,12031,35-39,36329,35147,71476
3690,12031,40-44,31615,30395,62010
3691,12031,45-49,29445,27594,57039
3692,12031,50-54,31208,29705,60913
3693,12031,55-59,33696,30841,64537
3694,12031,60-64,33095,29529,62624
3695,12031,65+,84273,64768,149041
3696,12033,15-19,10042,12205,22247
3697,12033,20-24,11475,13126,24601
3698,12033,25-29,11576,12334,23910
3699,12033,30-34,11439,11681,23120
3700,12033,35-39,9943,10166,20109
3701,12033,40-44,8872,8820,17692
3702,12033,45-49,8383,8350,16733
3703,12033,50-54,9524,8856,18380
3704,12033,55-59,11004,10061,21065
3705,12033,60-64,11545,10416,21961
3706,12033,65+,31311,24689,56000
3707,12035,15-19,2834,3180,6014
3708,12035,20-24,2554,2618,5172
3709,12035,25-29,2587,2628,5215
3710,12035,30-34,2760,2685,5445
3711,12035,35-39,3046,2815,5861
3712,12035,40-44,3119,2910,6029
3713,12035,45-49,3387,3056,6443
3714,12035,50-54,4032,3619,7651
3715,12035,55-59,4783,4194,8977
3716,12035,60-64,5776,4781,10557
3717,12035,65+,19688,17954,37642
3718,12037,15-19,231,275,506
3719,12037,20-24,206,444,650
3720,12037,25-29,248,680,928
3721,12037,30-34,278,626,904
3722,12037,35-39,269,513,782
3723,12037,40-44,288,454,742
3724,12037,45-49,277,467,744
3725,12037,50-54,365,413,778
3726,12037,55-59,430,465,895
3727,12037,60-64,533,487,1020
3728,12037,65+,1545,1543,3088
3729,12039,15-19,1224,1275,2499
3730,12039,20-24,1407,1187,2594
3731,12039,25-29,1363,1305,2668
3732,12039,30-34,1306,1197,2503
3733,12039,35-39,1416,1167,2583
3734,12039,40-44,1481,1290,2771
3735,12039,45-49,1467,1291,2758
3736,12039,50-54,1498,1511,3009
3737,12039,55-59,1574,1485,3059
3738,12039,60-64,1664,1434,3098
3739,12039,65+,4670,3786,8456
3740,12041,15-19,496,758,1254
3741,12041,20-24,406,1054,1460
3742,12041,25-29,449,439,888
3743,12041,30-34,504,543,1047
3744,12041,35-39,533,505,1038
3745,12041,40-44,467,476,943
3746,12041,45-49,483,461,944
3747,12041,50-54,569,576,1145
3748,12041,55-59,621,681,1302
3749,12041,60-64,725,654,1379
3750,12041,65+,2124,1744,3868
3751,12043,15-19,253,320,573
3752,12043,20-24,256,345,601
3753,12043,25-29,261,464,725
3754,12043,30-34,295,495,790
3755,12043,35-39,290,502,792
3756,12043,40-44,278,496,774
3757,12043,45-49,269,466,735
3758,12043,50-54,358,435,793
3759,12043,55-59,349,460,809
3760,12043,60-64,390,432,822
3761,12043,65+,1679,1760,3439
3762,12045,15-19,347,340,687
3763,12045,20-24,321,377,698
3764,12045,25-29,297,392,689
3765,12045,30-34,386,412,798
3766,12045,35-39,303,378,681
3767,12045,40-44,368,355,723
3768,12045,45-49,377,407,784
3769,12045,50-54,495,467,962
3770,12045,55-59,571,591,1162
3771,12045,60-64,654,601,1255
3772,12045,65+,1958,1771,3729
3773,12047,15-19,300,474,774
3774,12047,20-24,256,988,1244
3775,12047,25-29,301,680,981
3776,12047,30-34,319,595,914
3777,12047,35-39,287,513,800
3778,12047,40-44,317,534,851
3779,12047,45-49,332,513,845
3780,12047,50-54,368,515,883
3781,12047,55-59,401,522,923
3782,12047,60-64,424,519,943
3783,12047,65+,1415,1194,2609
3784,12049,15-19,861,970,1831
3785,12049,20-24,784,988,1772
3786,12049,25-29,735,1053,1788
3787,12049,30-34,735,860,1595
3788,12049,35-39,629,888,1517
3789,12049,40-44,650,782,1432
3790,12049,45-49,758,731,1489
3791,12049,50-54,636,857,1493
3792,12049,55-59,704,756,1460
3793,12049,60-64,660,674,1334
3794,12049,65+,2161,2125,4286
3795,12051,15-19,1426,1460,2886
3796,12051,20-24,1144,1459,2603
3797,12051,25-29,1178,1541,2719
3798,12051,30-34,1255,1500,2755
3799,12051,35-39,1154,1496,2650
3800,12051,40-44,1182,1342,2524
3801,12051,45-49,1163,1278,2441
3802,12051,50-54,1179,1333,2512
3803,12051,55-59,1245,1385,2630
3804,12051,60-64,1041,1102,2143
3805,12051,65+,2764,2766,5530
3806,12053,15-19,5265,5272,10537
3807,12053,20-24,4672,4803,9475
3808,12053,25-29,5143,5267,10410
3809,12053,30-34,5683,5588,11271
3810,12053,35-39,5543,5274,10817
3811,12053,40-44,5626,5419,11045
3812,12053,45-49,5611,5341,10952
3813,12053,50-54,6701,6295,12996
3814,12053,55-59,7466,6689,14155
3815,12053,60-64,8113,7079,15192
3816,12053,65+,28495,24939,53434
3817,12055,15-19,2299,2470,4769
3818,12055,20-24,2133,2199,4332
3819,12055,25-29,2321,2542,4863
3820,12055,30-34,2460,2624,5084
3821,12055,35-39,2446,2426,4872
3822,12055,40-44,2279,2306,4585
3823,12055,45-49,2256,2211,4467
3824,12055,50-54,2649,2645,5294
3825,12055,55-59,3298,2987,6285
3826,12055,60-64,3978,3483,7461
3827,12055,65+,19339,17544,36883
3828,12057,15-19,44717,46883,91600
3829,12057,20-24,46166,45514,91680
3830,12057,25-29,53707,52684,106391
3831,12057,30-34,57536,56772,114308
3832,12057,35-39,54446,54073,108519
3833,12057,40-44,51206,50625,101831
3834,12057,45-49,48682,47519,96201
3835,12057,50-54,48604,48519,97123
3836,12057,55-59,48271,46787,95058
3837,12057,60-64,44562,41738,86300
3838,12057,65+,121273,97904,219177
3839,12059,15-19,527,638,1165
3840,12059,20-24,417,775,1192
3841,12059,25-29,478,778,1256
3842,12059,30-34,531,728,1259
3843,12059,35-39,528,681,1209
3844,12059,40-44,509,651,1160
3845,12059,45-49,543,752,1295
3846,12059,50-54,579,695,1274
3847,12059,55-59,640,674,1314
3848,12059,60-64,701,699,1400
3849,12059,65+,2093,1858,3951
3850,12061,15-19,3480,4170,7650
3851,12061,20-24,3275,3442,6717
3852,12061,25-29,3598,3840,7438
3853,12061,30-34,3927,3913,7840
3854,12061,35-39,3747,3724,7471
3855,12061,40-44,3773,3545,7318
3856,12061,45-49,3902,3771,7673
3857,12061,50-54,4923,4471,9394
3858,12061,55-59,6117,5464,11581
3859,12061,60-64,7802,6392,14194
3860,12061,65+,30080,26054,56134
3861,12063,15-19,1212,1460,2672
3862,12063,20-24,1136,1745,2881
3863,12063,25-29,1184,1788,2972
3864,12063,30-34,1303,1942,3245
3865,12063,35-39,1235,2115,3350
3866,12063,40-44,1254,1951,3205
3867,12063,45-49,1273,1855,3128
3868,12063,50-54,1281,1632,2913
3869,12063,55-59,1422,1669,3091
3870,12063,60-64,1552,1632,3184
3871,12063,65+,5283,4345,9628
3872,12065,15-19,294,360,654
3873,12065,20-24,271,383,654
3874,12065,25-29,304,450,754
3875,12065,30-34,381,524,905
3876,12065,35-39,318,528,846
3877,12065,40-44,340,537,877
3878,12065,45-49,397,528,925
3879,12065,50-54,522,566,1088
3880,12065,55-59,534,564,1098
3881,12065,60-64,618,556,1174
3882,12065,65+,1917,1645,3562
3883,12067,15-19,249,323,572
3884,12067,20-24,198,454,652
3885,12067,25-29,209,374,583
3886,12067,30-34,194,350,544
3887,12067,35-39,185,367,552
3888,12067,40-44,241,352,593
3889,12067,45-49,233,393,626
3890,12067,50-54,211,302,513
3891,12067,55-59,253,283,536
3892,12067,60-64,231,273,504
3893,12067,65+,754,688,1442
3894,12069,15-19,10075,10680,20755
3895,12069,20-24,9084,9394,18478
3896,12069,25-29,10521,10227,20748
3897,12069,30-34,11624,11250,22874
3898,12069,35-39,11483,11279,22762
3899,12069,40-44,11447,10942,22389
3900,12069,45-49,11295,10694,21989
3901,12069,50-54,12339,11920,24259
3902,12069,55-59,13517,12728,26245
3903,12069,60-64,14787,13370,28157
3904,12069,65+,56223,48643,104866
3905,12071,15-19,19125,20259,39384
3906,12071,20-24,19099,19060,38159
3907,12071,25-29,20212,20540,40752
3908,12071,30-34,21687,21712,43399
3909,12071,35-39,21082,21548,42630
3910,12071,40-44,20358,20653,41011
3911,12071,45-49,20964,20537,41501
3912,12071,50-54,24153,23176,47329
3913,12071,55-59,28141,25568,53709
3914,12071,60-64,31383,27997,59380
3915,12071,65+,119470,109460,228930
3916,12073,15-19,13998,11929,25927
3917,12073,20-24,23982,20701,44683
3918,12073,25-29,11184,10664,21848
3919,12073,30-34,9819,9083,18902
3920,12073,35-39,9070,8439,17509
3921,12073,40-44,8423,7650,16073
3922,12073,45-49,7667,6843,14510
3923,12073,50-54,7634,7304,14938
3924,12073,55-59,7956,7062,15018
3925,12073,60-64,8406,7130,15536
3926,12073,65+,23698,18740,42438
3927,12075,15-19,1036,1156,2192
3928,12075,20-24,987,1010,1997
3929,12075,25-29,1200,1182,2382
3930,12075,30-34,1321,1219,2540
3931,12075,35-39,1200,1096,2296
3932,12075,40-44,1212,1097,2309
3933,12075,45-49,1175,1133,2308
3934,12075,50-54,1391,1342,2733
3935,12075,55-59,1756,1602,3358
3936,12075,60-64,1960,1697,3657
3937,12075,65+,5720,5470,11190
3938,12077,15-19,193,223,416
3939,12077,20-24,141,361,502
3940,12077,25-29,175,514,689
3941,12077,30-34,165,449,614
3942,12077,35-39,190,448,638
3943,12077,40-44,196,423,619
3944,12077,45-49,166,435,601
3945,12077,50-54,196,323,519
3946,12077,55-59,207,287,494
3947,12077,60-64,226,250,476
3948,12077,65+,628,632,1260
3949,12079,15-19,414,514,928
3950,12079,20-24,394,586,980
3951,12079,25-29,457,701,1158
3952,12079,30-34,572,718,1290
3953,12079,35-39,499,684,1183
3954,12079,40-44,474,655,1129
3955,12079,45-49,491,684,1175
3956,12079,50-54,538,611,1149
3957,12079,55-59,632,625,1257
3958,12079,60-64,682,657,1339
3959,12079,65+,2044,1831,3875
3960,12081,15-19,9897,10624,20521
3961,12081,20-24,9389,9885,19274
3962,12081,25-29,10355,10172,20527
3963,12081,30-34,11067,10640,21707
3964,12081,35-39,10935,10889,21824
3965,12081,40-44,11172,10598,21770
3966,12081,45-49,11279,10808,22087
3967,12081,50-54,13465,12638,26103
3968,12081,55-59,15507,13987,29494
3969,12081,60-64,17342,15303,32645
3970,12081,65+,62498,54721,117219
3971,12083,15-19,9526,10094,19620
3972,12083,20-24,9072,9326,18398
3973,12083,25-29,10363,10194,20557
3974,12083,30-34,11280,10729,22009
3975,12083,35-39,10523,9920,20443
3976,12083,40-44,10140,9371,19511
3977,12083,45-49,10132,9336,19468
3978,12083,50-54,11560,10598,22158
3979,12083,55-59,13270,11770,25040
3980,12083,60-64,15215,13063,28278
3981,12083,65+,59672,51215,110887
3982,12085,15-19,3568,3884,7452
3983,12085,20-24,3225,3670,6895
3984,12085,25-29,3055,3767,6822
3985,12085,30-34,3527,3974,7501
3986,12085,35-39,3715,4202,7917
3987,12085,40-44,3629,4171,7800
3988,12085,45-49,3931,4194,8125
3989,12085,50-54,5063,4902,9965
3990,12085,55-59,6156,5965,12121
3991,12085,60-64,6949,6404,13353
3992,12085,65+,27315,23806,51121
3993,12086,15-19,75547,77904,153451
3994,12086,20-24,75894,78097,153991
3995,12086,25-29,83123,85614,168737
3996,12086,30-34,92738,97820,190558
3997,12086,35-39,90376,95646,186022
3998,12086,40-44,89651,90718,180369
3999,12086,45-49,94524,95318,189842
4000,12086,50-54,94917,96313,191230
4001,12086,55-59,98812,96358,195170
4002,12086,60-64,84592,75812,160404
4003,12086,65+,259903,189048,448951
4004,12087,15-19,1578,1726,3304
4005,12087,20-24,1690,1983,3673
4006,12087,25-29,2159,2401,4560
4007,12087,30-34,2344,2562,4906
4008,12087,35-39,2449,2830,5279
4009,12087,40-44,2380,2683,5063
4010,12087,45-49,2439,2804,5243
4011,12087,50-54,2990,3152,6142
4012,12087,55-59,3304,3662,6966
4013,12087,60-64,3220,3568,6788
4014,12087,65+,9422,10083,19505
4015,12089,15-19,2371,2570,4941
4016,12089,20-24,2106,2219,4325
4017,12089,25-29,2405,2372,4777
4018,12089,30-34,2844,2845,5689
4019,12089,35-39,2820,2784,5604
4020,12089,40-44,2748,2738,5486
4021,12089,45-49,2725,2733,5458
4022,12089,50-54,3126,3052,6178
4023,12089,55-59,3755,3334,7089
4024,12089,60-64,3983,3662,7645
4025,12089,65+,11382,10403,21785
4026,12091,15-19,5525,6462,11987
4027,12091,20-24,6166,8350,14516
4028,12091,25-29,7294,8893,16187
4029,12091,30-34,7840,8775,16615
4030,12091,35-39,7162,7841,15003
4031,12091,40-44,6268,6733,13001
4032,12091,45-49,5476,5447,10923
4033,12091,50-54,5866,5608,11474
4034,12091,55-59,6994,6942,13936
4035,12091,60-64,7406,7175,14581
4036,12091,65+,18683,16190,34873
4037,12093,15-19,1018,1338,2356
4038,12093,20-24,970,1196,2166
4039,12093,25-29,1075,1455,2530
4040,12093,30-34,1205,1449,2654
4041,12093,35-39,1033,1438,2471
4042,12093,40-44,1082,1465,2547
4043,12093,45-49,1167,1438,2605
4044,12093,50-54,1038,1498,2536
4045,12093,55-59,1217,1414,2631
4046,12093,60-64,1276,1264,2540
4047,12093,65+,4103,3963,8066
4048,12095,15-19,45813,46300,92113
4049,12095,20-24,52791,49517,102308
4050,12095,25-29,56988,56821,113809
4051,12095,30-34,57696,58679,116375
4052,12095,35-39,53394,54389,107783
4053,12095,40-44,51456,50983,102439
4054,12095,45-49,47432,46471,93903
4055,12095,50-54,45792,46042,91834
4056,12095,55-59,44538,43757,88295
4057,12095,60-64,39963,37754,77717
4058,12095,65+,101530,80663,182193
4059,12097,15-19,13601,14328,27929
4060,12097,20-24,13084,13007,26091
4061,12097,25-29,13914,13889,27803
4062,12097,30-34,14322,14872,29194
4063,12097,35-39,14739,15128,29867
4064,12097,40-44,15017,15148,30165
4065,12097,45-49,14255,13762,28017
4066,12097,50-54,13213,12553,25766
4067,12097,55-59,12249,11956,24205
4068,12097,60-64,10752,9943,20695
4069,12097,65+,29782,24153,53935
4070,12099,15-19,40257,41924,82181
4071,12099,20-24,38323,39045,77368
4072,12099,25-29,40618,41678,82296
4073,12099,30-34,44705,46072,90777
4074,12099,35-39,43882,45149,89031
4075,12099,40-44,44338,43289,87627
4076,12099,45-49,44328,43438,87766
4077,12099,50-54,48719,47462,96181
4078,12099,55-59,52825,49648,102473
4079,12099,60-64,52470,49010,101480
4080,12099,65+,202736,164878,367614
4081,12101,15-19,15951,16942,32893
4082,12101,20-24,14426,14526,28952
4083,12101,25-29,15428,15443,30871
4084,12101,30-34,18148,17351,35499
4085,12101,35-39,19131,18057,37188
4086,12101,40-44,18776,18190,36966
4087,12101,45-49,18403,18262,36665
4088,12101,50-54,19545,19347,38892
4089,12101,55-59,20287,19748,40035
4090,12101,60-64,20510,18695,39205
4091,12101,65+,69899,59055,128954
4092,12103,15-19,20737,22040,42777
4093,12103,20-24,22422,22142,44564
4094,12103,25-29,27997,27723,55720
4095,12103,30-34,30146,29495,59641
4096,12103,35-39,28068,27803,55871
4097,12103,40-44,27133,26240,53373
4098,12103,45-49,27566,26287,53853
4099,12103,50-54,33040,31717,64757
4100,12103,55-59,39268,36543,75811
4101,12103,60-64,41875,38047,79922
4102,12103,65+,136007,111349,247356
4103,12105,15-19,23110,24378,47488
4104,12105,20-24,22224,22141,44365
4105,12105,25-29,24024,24057,48081
4106,12105,30-34,25937,26032,51969
4107,12105,35-39,24294,24508,48802
4108,12105,40-44,23351,22963,46314
4109,12105,45-49,22239,21739,43978
4110,12105,50-54,22234,22317,44551
4111,12105,55-59,23200,22359,45559
4112,12105,60-64,23743,21809,45552
4113,12105,65+,80688,68855,149543
4114,12107,15-19,1984,2138,4122
4115,12107,20-24,1804,1982,3786
4116,12107,25-29,1994,2162,4156
4117,12107,30-34,2088,2113,4201
4118,12107,35-39,1984,1907,3891
4119,12107,40-44,1916,1838,3754
4120,12107,45-49,1908,1832,3740
4121,12107,50-54,2201,2119,4320
4122,12107,55-59,2792,2647,5439
4123,12107,60-64,3144,2876,6020
4124,12107,65+,9132,8449,17581
4125,12109,15-19,8997,9496,18493
4126,12109,20-24,6718,6771,13489
4127,12109,25-29,5903,6068,11971
4128,12109,30-34,7839,7214,15053
4129,12109,35-39,9954,9232,19186
4130,12109,40-44,10543,10256,20799
4131,12109,45-49,9751,10080,19831
4132,12109,50-54,10273,10287,20560
4133,12109,55-59,10597,10057,20654
4134,12109,60-64,11005,10069,21074
4135,12109,65+,32128,27962,60090
4136,12111,15-19,8912,10014,18926
4137,12111,20-24,8513,8945,17458
4138,12111,25-29,9283,9423,18706
4139,12111,30-34,10364,10300,20664
4140,12111,35-39,10009,9772,19781
4141,12111,40-44,9736,9780,19516
4142,12111,45-49,9962,9301,19263
4143,12111,50-54,10773,10292,21065
4144,12111,55-59,12381,11435,23816
4145,12111,60-64,13115,11831,24946
4146,12111,65+,44550,39430,83980
4147,12113,15-19,5509,6154,11663
4148,12113,20-24,4665,6005,10670
4149,12113,25-29,5457,6991,12448
4150,12113,30-34,6339,7322,13661
4151,12113,35-39,6514,7209,13723
4152,12113,40-44,6215,6737,12952
4153,12113,45-49,5822,6210,12032
4154,12113,50-54,6275,6459,12734
4155,12113,55-59,7025,6930,13955
4156,12113,60-64,6902,6678,13580
4157,12113,65+,16867,14957,31824
4158,12115,15-19,9362,9832,19194
4159,12115,20-24,8883,9013,17896
4160,12115,25-29,8906,9328,18234
4161,12115,30-34,9425,9673,19098
4162,12115,35-39,9738,9244,18982
4163,12115,40-44,9958,9639,19597
4164,12115,45-49,10826,9873,20699
4165,12115,50-54,13656,12370,26026
4166,12115,55-59,16948,14950,31898
4167,12115,60-64,20787,17710,38497
4168,12115,65+,89437,76956,166393
4169,12117,15-19,13637,14075,27712
4170,12117,20-24,13842,13834,27676
4171,12117,25-29,16118,16198,32316
4172,12117,30-34,17137,17243,34380
4173,12117,35-39,17448,17212,34660
4174,12117,40-44,16887,16494,33381
4175,12117,45-49,15972,14845,30817
4176,12117,50-54,16267,15425,31692
4177,12117,55-59,16260,15320,31580
4178,12117,60-64,15340,13896,29236
4179,12117,65+,43333,33704,77037
4180,12119,15-19,1233,1325,2558
4181,12119,20-24,1213,1690,2903
4182,12119,25-29,1389,2200,3589
4183,12119,30-34,1514,2718,4232
4184,12119,35-39,1427,2852,4279
4185,12119,40-44,1533,2418,3951
4186,12119,45-49,1685,2283,3968
4187,12119,50-54,2200,2491,4691
4188,12119,55-59,3851,3337,7188
4189,12119,60-64,6583,4914,11497
4190,12119,65+,41571,37331,78902
4191,12121,15-19,1228,1334,2562
4192,12121,20-24,1030,1395,2425
4193,12121,25-29,1025,1576,2601
4194,12121,30-34,1181,1528,2709
4195,12121,35-39,1241,1471,2712
4196,12121,40-44,1178,1332,2510
4197,12121,45-49,1142,1283,2425
4198,12121,50-54,1330,1369,2699
4199,12121,55-59,1553,1545,3098
4200,12121,60-64,1657,1613,3270
4201,12121,65+,5150,4533,9683
4202,12123,15-19,520,559,1079
4203,12123,20-24,477,725,1202
4204,12123,25-29,543,996,1539
4205,12123,30-34,579,940,1519
4206,12123,35-39,532,864,1396
4207,12123,40-44,489,796,1285
4208,12123,45-49,546,813,1359
4209,12123,50-54,598,759,1357
4210,12123,55-59,659,729,1388
4211,12123,60-64,719,779,1498
4212,12123,65+,2406,2178,4584
4213,12125,15-19,375,564,939
4214,12125,20-24,317,728,1045
4215,12125,25-29,323,924,1247
4216,12125,30-34,360,875,1235
4217,12125,35-39,337,786,1123
4218,12125,40-44,293,788,1081
4219,12125,45-49,298,776,1074
4220,12125,50-54,281,830,1111
4221,12125,55-59,321,971,1292
4222,12125,60-64,286,694,980
4223,12125,65+,1190,1246,2436
4224,12127,15-19,14418,15878,30296
4225,12127,20-24,15032,15981,31013
4226,12127,25-29,15476,16223,31699
4227,12127,30-34,16919,17195,34114
4228,12127,35-39,15451,15924,31375
4229,12127,40-44,15196,15154,30350
4230,12127,45-49,15496,14945,30441
4231,12127,50-54,18088,17378,35466
4232,12127,55-59,21656,19702,41358
4233,12127,60-64,23901,21323,45224
4234,12127,65+,76020,65285,141305
4235,12129,15-19,947,1075,2022
4236,12129,20-24,752,999,1751
4237,12129,25-29,883,1345,2228
4238,12129,30-34,1028,1475,2503
4239,12129,35-39,1043,1438,2481
4240,12129,40-44,1036,1442,2478
4241,12129,45-49,1055,1474,2529
4242,12129,50-54,1037,1412,2449
4243,12129,55-59,1207,1256,2463
4244,12129,60-64,1207,1180,2387
4245,12129,65+,2856,2730,5586
4246,12131,15-19,2002,2105,4107
4247,12131,20-24,1702,1868,3570
4248,12131,25-29,1923,2333,4256
4249,12131,30-34,2377,2588,4965
4250,12131,35-39,2577,2644,5221
4251,12131,40-44,2419,2684,5103
4252,12131,45-49,2306,2489,4795
4253,12131,50-54,2616,2734,5350
4254,12131,55-59,3243,3022,6265
4255,12131,60-64,3377,3234,6611
4256,12131,65+,8335,7761,16096
4257,12133,15-19,647,759,1406
4258,12133,20-24,609,943,1552
4259,12133,25-29,665,1061,1726
4260,12133,30-34,751,1096,1847
4261,12133,35-39,673,1007,1680
4262,12133,40-44,685,996,1681
4263,12133,45-49,698,956,1654
4264,12133,50-54,794,961,1755
4265,12133,55-59,851,996,1847
4266,12133,60-64,869,822,1691
4267,12133,65+,2332,2134,4466
4268,13001,15-19,576,602,1178
4269,13001,20-24,499,622,1121
4270,13001,25-29,509,591,1100
4271,13001,30-34,498,546,1044
4272,13001,35-39,530,565,1095
4273,13001,40-44,564,549,1113
4274,13001,45-49,555,530,1085
4275,13001,50-54,543,581,1124
4276,13001,55-59,594,595,1189
4277,13001,60-64,623,621,1244
4278,13001,65+,1871,1560,3431
4279,13003,15-19,292,307,599
4280,13003,20-24,302,263,565
4281,13003,25-29,285,289,574
4282,13003,30-34,240,315,555
4283,13003,35-39,250,272,522
4284,13003,40-44,257,256,513
4285,13003,45-49,244,273,517
4286,13003,50-54,281,284,565
4287,13003,55-59,261,275,536
4288,13003,60-64,268,237,505
4289,13003,65+,583,577,1160
4290,13005,15-19,362,399,761
4291,13005,20-24,316,362,678
4292,13005,25-29,327,344,671
4293,13005,30-34,354,328,682
4294,13005,35-39,326,286,612
4295,13005,40-44,385,359,744
4296,13005,45-49,344,399,743
4297,13005,50-54,344,350,694
4298,13005,55-59,332,294,626
4299,13005,60-64,345,304,649
4300,13005,65+,1069,836,1905
4301,13007,15-19,83,69,152
4302,13007,20-24,76,72,148
4303,13007,25-29,75,85,160
4304,13007,30-34,74,76,150
4305,13007,35-39,82,75,157
4306,13007,40-44,66,66,132
4307,13007,45-49,76,77,153
4308,13007,50-54,84,94,178
4309,13007,55-59,104,102,206
4310,13007,60-64,117,121,238
4311,13007,65+,355,347,702
4312,13009,15-19,2267,2083,4350
4313,13009,20-24,2682,2645,5327
4314,13009,25-29,1192,1376,2568
4315,13009,30-34,1136,1278,2414
4316,13009,35-39,1089,1233,2322
4317,13009,40-44,1077,1328,2405
4318,13009,45-49,1008,1261,2269
4319,13009,50-54,1157,1347,2504
4320,13009,55-59,1305,1440,2745
4321,13009,60-64,1396,1457,2853
4322,13009,65+,3885,3583,7468
4323,13011,15-19,499,641,1140
4324,13011,20-24,544,621,1165
4325,13011,25-29,534,562,1096
4326,13011,30-34,555,573,1128
4327,13011,35-39,545,577,1122
4328,13011,40-44,617,554,1171
4329,13011,45-49,607,621,1228
4330,13011,50-54,616,694,1310
4331,13011,55-59,648,716,1364
4332,13011,60-64,596,653,1249
4333,13011,65+,1763,1613,3376
4334,13013,15-19,2892,3074,5966
4335,13013,20-24,2490,2584,5074
4336,13013,25-29,3161,2998,6159
4337,13013,30-34,3292,3260,6552
4338,13013,35-39,3186,3178,6364
4339,13013,40-44,2981,3007,5988
4340,13013,45-49,2799,2757,5556
4341,13013,50-54,2860,2744,5604
4342,13013,55-59,2744,2652,5396
4343,13013,60-64,2453,2269,4722
4344,13013,65+,6210,4918,11128
4345,13015,15-19,3521,3692,7213
4346,13015,20-24,3334,3308,6642
4347,13015,25-29,3864,3818,7682
4348,13015,30-34,3958,3865,7823
4349,13015,35-39,3549,3513,7062
4350,13015,40-44,3549,3404,6953
4351,13015,45-49,3501,3607,7108
4352,13015,50-54,3943,3967,7910
4353,13015,55-59,3942,3862,7804
4354,13015,60-64,3512,3600,7112
4355,13015,65+,8818,7416,16234
4356,13017,15-19,591,554,1145
4357,13017,20-24,472,504,976
4358,13017,25-29,496,463,959
4359,13017,30-34,554,506,1060
4360,13017,35-39,584,441,1025
4361,13017,40-44,524,501,1025
4362,13017,45-49,484,477,961
4363,13017,50-54,529,540,1069
4364,13017,55-59,586,546,1132
4365,13017,60-64,634,537,1171
4366,13017,65+,1852,1277,3129
4367,13019,15-19,588,634,1222
4368,13019,20-24,480,505,985
4369,13019,25-29,548,570,1118
4370,13019,30-34,566,541,1107
4371,13019,35-39,561,556,1117
4372,13019,40-44,535,535,1070
4373,13019,45-49,536,553,1089
4374,13019,50-54,614,619,1233
4375,13019,55-59,615,638,1253
4376,13019,60-64,666,616,1282
4377,13019,65+,1761,1395,3156
4378,13021,15-19,5730,5545,11275
4379,13021,20-24,6016,5355,11371
4380,13021,25-29,5789,5222,11011
4381,13021,30-34,5723,4981,10704
4382,13021,35-39,5032,4429,9461
4383,13021,40-44,4824,4305,9129
4384,13021,45-49,4618,4119,8737
4385,13021,50-54,4733,4207,8940
4386,13021,55-59,5191,4462,9653
4387,13021,60-64,5274,4437,9711
4388,13021,65+,14813,10597,25410
4389,13023,15-19,683,650,1333
4390,13023,20-24,537,494,1031
4391,13023,25-29,391,355,746
4392,13023,30-34,398,361,759
4393,13023,35-39,367,303,670
4394,13023,40-44,367,346,713
4395,13023,45-49,355,340,695
4396,13023,50-54,369,392,761
4397,13023,55-59,460,427,887
4398,13023,60-64,412,386,798
4399,13023,65+,1229,954,2183
4400,13025,15-19,564,595,1159
4401,13025,20-24,469,550,1019
4402,13025,25-29,549,542,1091
4403,13025,30-34,581,555,1136
4404,13025,35-39,520,510,1030
4405,13025,40-44,553,525,1078
4406,13025,45-49,571,562,1133
4407,13025,50-54,681,600,1281
4408,13025,55-59,673,692,1365
4409,13025,60-64,621,594,1215
4410,13025,65+,1679,1464,3143
4411,13027,15-19,449,471,920
4412,13027,20-24,404,423,827
4413,13027,25-29,501,452,953
4414,13027,30-34,491,461,952
4415,13027,35-39,481,452,933
4416,13027,40-44,422,444,866
4417,13027,45-49,499,487,986
4418,13027,50-54,562,505,1067
4419,13027,55-59,691,599,1290
4420,13027,60-64,662,595,1257
4421,13027,65+,1820,1501,3321
4422,13029,15-19,1733,1788,3521
4423,13029,20-24,1174,1316,2490
4424,13029,25-29,1434,1430,2864
4425,13029,30-34,1824,1641,3465
4426,13029,35-39,2110,2014,4124
4427,13029,40-44,1882,1842,3724
4428,13029,45-49,1516,1559,3075
4429,13029,50-54,1322,1284,2606
4430,13029,55-59,1247,1191,2438
4431,13029,60-64,1196,1062,2258
4432,13029,65+,2774,2250,5024
4433,13031,15-19,4663,4992,9655
4434,13031,20-24,6257,6320,12577
4435,13031,25-29,2756,2763,5519
4436,13031,30-34,2689,2535,5224
4437,13031,35-39,2456,2321,4777
4438,13031,40-44,2259,2125,4384
4439,13031,45-49,2120,1958,4078
4440,13031,50-54,2154,2085,4239
4441,13031,55-59,2199,2101,4300
4442,13031,60-64,2168,1952,4120
4443,13031,65+,5467,4526,9993
4444,13033,15-19,796,880,1676
4445,13033,20-24,688,704,1392
4446,13033,25-29,763,707,1470
4447,13033,30-34,774,674,1448
4448,13033,35-39,729,691,1420
4449,13033,40-44,763,679,1442
4450,13033,45-49,686,667,1353
4451,13033,50-54,819,730,1549
4452,13033,55-59,903,768,1671
4453,13033,60-64,922,812,1734
4454,13033,65+,2337,1833,4170
4455,13035,15-19,685,798,1483
4456,13035,20-24,702,1155,1857
4457,13035,25-29,780,1190,1970
4458,13035,30-34,756,1099,1855
4459,13035,35-39,711,1061,1772
4460,13035,40-44,720,914,1634
4461,13035,45-49,735,950,1685
4462,13035,50-54,765,915,1680
4463,13035,55-59,877,926,1803
4464,13035,60-64,828,818,1646
4465,13035,65+,2305,1718,4023
4466,13037,15-19,144,147,291
4467,13037,20-24,113,282,395
4468,13037,25-29,97,313,410
4469,13037,30-34,105,334,439
4470,13037,35-39,113,301,414
4471,13037,40-44,129,316,445
4472,13037,45-49,129,285,414
4473,13037,50-54,129,249,378
4474,13037,55-59,152,206,358
4475,13037,60-64,154,175,329
4476,13037,65+,507,410,917
4477,13039,15-19,1521,1857,3378
4478,13039,20-24,1715,3043,4758
4479,13039,25-29,2039,2499,4538
4480,13039,30-34,2159,2235,4394
4481,13039,35-39,1906,1988,3894
4482,13039,40-44,1444,1531,2975
4483,13039,45-49,1342,1258,2600
4484,13039,50-54,1519,1437,2956
4485,13039,55-59,1687,1556,3243
4486,13039,60-64,1711,1581,3292
4487,13039,65+,4320,3875,8195
4488,13043,15-19,364,402,766
4489,13043,20-24,316,317,633
4490,13043,25-29,322,284,606
4491,13043,30-34,365,315,680
4492,13043,35-39,305,306,611
4493,13043,40-44,303,294,597
4494,13043,45-49,346,315,661
4495,13043,50-54,341,357,698
4496,13043,55-59,395,322,717
4497,13043,60-64,350,347,697
4498,13043,65+,1093,956,2049
4499,13045,15-19,5061,4824,9885
4500,13045,20-24,5403,5135,10538
4501,13045,25-29,4232,4094,8326
4502,13045,30-34,4217,3906,8123
4503,13045,35-39,3921,3741,7662
4504,13045,40-44,3697,3622,7319
4505,13045,45-49,3639,3583,7222
4506,13045,50-54,3991,3726,7717
4507,13045,55-59,3819,3656,7475
4508,13045,60-64,3584,3399,6983
4509,13045,65+,9449,7537,16986
4510,13047,15-19,2104,2396,4500
4511,13047,20-24,1789,1950,3739
4512,13047,25-29,2001,2016,4017
4513,13047,30-34,2289,2043,4332
4514,13047,35-39,2156,2032,4188
4515,13047,40-44,2263,2122,4385
4516,13047,45-49,2297,2183,4480
4517,13047,50-54,2404,2374,4778
4518,13047,55-59,2367,2233,4600
4519,13047,60-64,2348,2049,4397
4520,13047,65+,7120,5547,12667
4521,13049,15-19,265,324,589
4522,13049,20-24,241,605,846
4523,13049,25-29,369,740,1109
4524,13049,30-34,344,767,1111
4525,13049,35-39,289,657,946
4526,13049,40-44,246,594,840
4527,13049,45-49,312,533,845
4528,13049,50-54,338,517,855
4529,13049,55-59,388,429,817
4530,13049,60-64,404,413,817
4531,13049,65+,1056,986,2042
4532,13051,15-19,10103,9489,19592
4533,13051,20-24,11354,11035,22389
4534,13051,25-29,11847,11741,23588
4535,13051,30-34,11557,11222,22779
4536,13051,35-39,10289,10047,20336
4537,13051,40-44,9464,8649,18113
4538,13051,45-49,8427,7832,16259
4539,13051,50-54,8865,8283,17148
4540,13051,55-59,9599,8497,18096
4541,13051,60-64,9709,8283,17992
4542,13051,65+,27583,21409,48992
4543,13053,15-19,120,594,714
4544,13053,20-24,319,1602,1921
4545,13053,25-29,428,963,1391
4546,13053,30-34,353,557,910
4547,13053,35-39,259,373,632
4548,13053,40-44,172,212,384
4549,13053,45-49,103,119,222
4550,13053,50-54,87,97,184
4551,13053,55-59,97,108,205
4552,13053,60-64,90,84,174
4553,13053,65+,257,202,459
4554,13055,15-19,684,784,1468
4555,13055,20-24,656,833,1489
4556,13055,25-29,703,918,1621
4557,13055,30-34,697,871,1568
4558,13055,35-39,699,774,1473
4559,13055,40-44,710,829,1539
4560,13055,45-49,700,834,1534
4561,13055,50-54,806,864,1670
4562,13055,55-59,840,809,1649
4563,13055,60-64,905,837,1742
4564,13055,65+,2534,2066,4600
4565,13057,15-19,9127,9935,19062
4566,13057,20-24,7865,8073,15938
4567,13057,25-29,7847,7868,15715
4568,13057,30-34,8639,8284,16923
4569,13057,35-39,9169,9202,18371
4570,13057,40-44,9603,9340,18943
4571,13057,45-49,9750,9696,19446
4572,13057,50-54,10143,10280,20423
4573,13057,55-59,9643,9445,19088
4574,13057,60-64,8904,8449,17353
4575,13057,65+,23213,19137,42350
4576,13059,15-19,7148,5804,12952
4577,13059,20-24,12088,11366,23454
4578,13059,25-29,5724,5319,11043
4579,13059,30-34,4871,4503,9374
4580,13059,35-39,3886,3760,7646
4581,13059,40-44,3551,3433,6984
4582,13059,45-49,3165,2915,6080
4583,13059,50-54,3110,2834,5944
4584,13059,55-59,2947,2692,5639
4585,13059,60-64,3138,2690,5828
4586,13059,65+,8991,6521,15512
4587,13061,15-19,77,95,172
4588,13061,20-24,70,59,129
4589,13061,25-29,72,57,129
4590,13061,30-34,89,70,159
4591,13061,35-39,87,68,155
4592,13061,40-44,89,88,177
4593,13061,45-49,61,60,121
4594,13061,50-54,73,67,140
4595,13061,55-59,102,79,181
4596,13061,60-64,120,102,222
4597,13061,65+,435,391,826
4598,13063,15-19,11162,10981,22143
4599,13063,20-24,10637,9959,20596
4600,13063,25-29,12138,10811,22949
4601,13063,30-34,12698,10560,23258
4602,13063,35-39,10885,8840,19725
4603,13063,40-44,10523,8253,18776
4604,13063,45-49,10322,8144,18466
4605,13063,50-54,10338,8602,18940
4606,13063,55-59,9895,8353,18248
4607,13063,60-64,8699,7305,16004
4608,13063,65+,17812,13156,30968
4609,13065,15-19,229,225,454
4610,13065,20-24,205,203,408
4611,13065,25-29,210,213,423
4612,13065,30-34,227,204,431
4613,13065,35-39,213,180,393
4614,13065,40-44,194,188,382
4615,13065,45-49,219,227,446
4616,13065,50-54,202,211,413
4617,13065,55-59,219,225,444
4618,13065,60-64,210,199,409
4619,13065,65+,631,492,1123
4620,13067,15-19,25846,26078,51924
4621,13067,20-24,24366,24704,49070
4622,13067,25-29,27431,27478,54909
4623,13067,30-34,28664,27823,56487
4624,13067,35-39,28134,26997,55131
4625,13067,40-44,27884,25984,53868
4626,13067,45-49,27298,25183,52481
4627,13067,50-54,27275,26451,53726
4628,13067,55-59,26194,24356,50550
4629,13067,60-64,23347,21635,44982
4630,13067,65+,57067,44970,102037
4631,13069,15-19,1393,1495,2888
4632,13069,20-24,1286,1750,3036
4633,13069,25-29,1409,1730,3139
4634,13069,30-34,1410,1736,3146
4635,13069,35-39,1260,1592,2852
4636,13069,40-44,1293,1504,2797
4637,13069,45-49,1263,1434,2697
4638,13069,50-54,1320,1430,2750
4639,13069,55-59,1336,1390,2726
4640,13069,60-64,1229,1205,2434
4641,13069,65+,3466,2660,6126
4642,13071,15-19,1472,1709,3181
4643,13071,20-24,1347,1495,2842
4644,13071,25-29,1399,1495,2894
4645,13071,30-34,1489,1422,2911
4646,13071,35-39,1486,1445,2931
4647,13071,40-44,1485,1509,2994
4648,13071,45-49,1368,1437,2805
4649,13071,50-54,1375,1456,2831
4650,13071,55-59,1469,1433,2902
4651,13071,60-64,1288,1226,2514
4652,13071,65+,4193,3196,7389
4653,13073,15-19,5352,5465,10817
4654,13073,20-24,4302,4512,8814
4655,13073,25-29,5009,5124,10133
4656,13073,30-34,5778,5634,11412
4657,13073,35-39,6276,5877,12153
4658,13073,40-44,5803,5611,11414
4659,13073,45-49,5182,4936,10118
4660,13073,50-54,5004,4970,9974
4661,13073,55-59,5127,4769,9896
4662,13073,60-64,4828,4327,9155
4663,13073,65+,12495,10543,23038
4664,13075,15-19,590,586,1176
4665,13075,20-24,479,538,1017
4666,13075,25-29,561,506,1067
4667,13075,30-34,568,488,1056
4668,13075,35-39,541,460,1001
4669,13075,40-44,571,515,1086
4670,13075,45-49,545,526,1071
4671,13075,50-54,604,539,1143
4672,13075,55-59,605,531,1136
4673,13075,60-64,530,506,1036
4674,13075,65+,1558,1301,2859
4675,13077,15-19,5061,5128,10189
4676,13077,20-24,4422,4322,8744
4677,13077,25-29,4690,4545,9235
4678,13077,30-34,4939,4517,9456
4679,13077,35-39,5134,4760,9894
4680,13077,40-44,5259,4797,10056
4681,13077,45-49,5236,4871,10107
4682,13077,50-54,5790,5531,11321
4683,13077,55-59,5431,5406,10837
4684,13077,60-64,4823,4681,9504
4685,13077,65+,12203,10109,22312
4686,13079,15-19,347,369,716
4687,13079,20-24,274,331,605
4688,13079,25-29,285,343,628
4689,13079,30-34,357,400,757
4690,13079,35-39,330,361,691
4691,13079,40-44,342,344,686
4692,13079,45-49,380,344,724
4693,13079,50-54,406,450,856
4694,13079,55-59,518,535,1053
4695,13079,60-64,517,517,1034
4696,13079,65+,1289,1134,2423
4697,13081,15-19,659,669,1328
4698,13081,20-24,534,548,1082
4699,13081,25-29,607,532,1139
4700,13081,30-34,632,522,1154
4701,13081,35-39,588,611,1199
4702,13081,40-44,632,513,1145
4703,13081,45-49,631,490,1121
4704,13081,50-54,643,585,1228
4705,13081,55-59,680,654,1334
4706,13081,60-64,706,626,1332
4707,13081,65+,2197,1762,3959
4708,13083,15-19,616,593,1209
4709,13083,20-24,609,607,1216
4710,13083,25-29,451,504,955
4711,13083,30-34,478,463,941
4712,13083,35-39,479,454,933
4713,13083,40-44,462,477,939
4714,13083,45-49,450,494,944
4715,13083,50-54,503,502,1005
4716,13083,55-59,568,494,1062
4717,13083,60-64,639,581,1220
4718,13083,65+,1774,1557,3331
4719,13085,15-19,765,824,1589
4720,13085,20-24,763,825,1588
4721,13085,25-29,887,900,1787
4722,13085,30-34,942,925,1867
4723,13085,35-39,830,828,1658
4724,13085,40-44,788,803,1591
4725,13085,45-49,814,898,1712
4726,13085,50-54,976,1007,1983
4727,13085,55-59,1094,1044,2138
4728,13085,60-64,1099,979,2078
4729,13085,65+,3035,2752,5787
4730,13087,15-19,937,1014,1951
4731,13087,20-24,824,1030,1854
4732,13087,25-29,922,934,1856
4733,13087,30-34,960,871,1831
4734,13087,35-39,876,813,1689
4735,13087,40-44,870,882,1752
4736,13087,45-49,916,847,1763
4737,13087,50-54,922,903,1825
4738,13087,55-59,1005,930,1935
4739,13087,60-64,917,925,1842
4740,13087,65+,2827,2072,4899
4741,13089,15-19,21986,22238,44224
4742,13089,20-24,23917,21509,45426
4743,13089,25-29,31692,28067,59759
4744,13089,30-34,33970,31302,65272
4745,13089,35-39,29593,27691,57284
4746,13089,40-44,27412,24763,52175
4747,13089,45-49,25066,22721,47787
4748,13089,50-54,25325,23108,48433
4749,13089,55-59,24865,22166,47031
4750,13089,60-64,23819,19525,43344
4751,13089,65+,60169,42724,102893
4752,13091,15-19,479,679,1158
4753,13091,20-24,475,641,1116
4754,13091,25-29,519,697,1216
4755,13091,30-34,569,788,1357
4756,13091,35-39,500,707,1207
4757,13091,40-44,600,716,1316
4758,13091,45-49,602,720,1322
4759,13091,50-54,699,787,1486
4760,13091,55-59,675,720,1395
4761,13091,60-64,664,659,1323
4762,13091,65+,2093,1684,3777
4763,13093,15-19,298,263,561
4764,13093,20-24,250,395,645
4765,13093,25-29,213,450,663
4766,13093,30-34,203,437,640
4767,13093,35-39,254,408,662
4768,13093,40-44,321,458,779
4769,13093,45-49,281,486,767
4770,13093,50-54,317,410,727
4771,13093,55-59,365,413,778
4772,13093,60-64,425,467,892
4773,13093,65+,1272,1108,2380
4774,13095,15-19,3456,3169,6625
4775,13095,20-24,3561,3131,6692
4776,13095,25-29,3039,2545,5584
4777,13095,30-34,3096,2583,5679
4778,13095,35-39,2649,2124,4773
4779,13095,40-44,2650,2215,4865
4780,13095,45-49,2474,2118,4592
4781,13095,50-54,2530,2100,4630
4782,13095,55-59,2905,2273,5178
4783,13095,60-64,2851,2295,5146
4784,13095,65+,8272,5991,14263
4785,13097,15-19,5381,5703,11084
4786,13097,20-24,4790,4718,9508
4787,13097,25-29,5037,4617,9654
4788,13097,30-34,4889,4343,9232
4789,13097,35-39,5056,4269,9325
4790,13097,40-44,5534,4622,10156
4791,13097,45-49,5633,4600,10233
4792,13097,50-54,5667,5083,10750
4793,13097,55-59,5213,4732,9945
4794,13097,60-64,4199,4007,8206
4795,13097,65+,10085,7729,17814
4796,13099,15-19,343,383,726
4797,13099,20-24,317,307,624
4798,13099,25-29,289,266,555
4799,13099,30-34,323,273,596
4800,13099,35-39,300,250,550
4801,13099,40-44,338,269,607
4802,13099,45-49,341,298,639
4803,13099,50-54,368,310,678
4804,13099,55-59,373,358,731
4805,13099,60-64,387,309,696
4806,13099,65+,1218,865,2083
4807,13101,15-19,137,116,253
4808,13101,20-24,112,113,225
4809,13101,25-29,89,107,196
4810,13101,30-34,115,117,232
4811,13101,35-39,126,151,277
4812,13101,40-44,120,139,259
4813,13101,45-49,129,139,268
4814,13101,50-54,97,117,214
4815,13101,55-59,120,127,247
4816,13101,60-64,92,122,214
4817,13101,65+,273,223,496
4818,13103,15-19,2223,2406,4629
4819,13103,20-24,1772,1898,3670
4820,13103,25-29,2078,2074,4152
4821,13103,30-34,2479,2397,4876
4822,13103,35-39,2555,2557,5112
4823,13103,40-44,2428,2335,4763
4824,13103,45-49,2099,2188,4287
4825,13103,50-54,2156,2151,4307
4826,13103,55-59,2180,2134,4314
4827,13103,60-64,1995,1936,3931
4828,13103,65+,4391,3756,8147
4829,13105,15-19,553,555,1108
4830,13105,20-24,553,499,1052
4831,13105,25-29,576,601,1177
4832,13105,30-34,593,626,1219
4833,13105,35-39,577,537,1114
4834,13105,40-44,577,538,1115
4835,13105,45-49,528,514,1042
4836,13105,50-54,656,594,1250
4837,13105,55-59,746,642,1388
4838,13105,60-64,723,648,1371
4839,13105,65+,2312,1829,4141
4840,13107,15-19,789,800,1589
4841,13107,20-24,637,783,1420
4842,13107,25-29,670,753,1423
4843,13107,30-34,742,739,1481
4844,13107,35-39,690,782,1472
4845,13107,40-44,665,758,1423
4846,13107,45-49,651,617,1268
4847,13107,50-54,647,633,1280
4848,13107,55-59,736,705,1441
4849,13107,60-64,759,671,1430
4850,13107,65+,2109,1629,3738
4851,13109,15-19,398,422,820
4852,13109,20-24,318,326,644
4853,13109,25-29,311,323,634
4854,13109,30-34,339,325,664
4855,13109,35-39,349,321,670
4856,13109,40-44,357,293,650
4857,13109,45-49,331,296,627
4858,13109,50-54,327,357,684
4859,13109,55-59,341,304,645
4860,13109,60-64,355,359,714
4861,13109,65+,946,784,1730
4862,13111,15-19,595,621,1216
4863,13111,20-24,559,564,1123
4864,13111,25-29,549,553,1102
4865,13111,30-34,607,533,1140
4866,13111,35-39,599,539,1138
4867,13111,40-44,665,639,1304
4868,13111,45-49,641,674,1315
4869,13111,50-54,870,798,1668
4870,13111,55-59,1102,968,2070
4871,13111,60-64,1267,1253,2520
4872,13111,65+,4077,3871,7948
4873,13113,15-19,4482,4703,9185
4874,13113,20-24,3415,3567,6982
4875,13113,25-29,2744,2780,5524
4876,13113,30-34,2759,2567,5326
4877,13113,35-39,3618,3229,6847
4878,13113,40-44,3885,3557,7442
4879,13113,45-49,4106,3753,7859
4880,13113,50-54,4451,4208,8659
4881,13113,55-59,4733,4453,9186
4882,13113,60-64,4467,4158,8625
4883,13113,65+,12869,10638,23507
4884,13115,15-19,3785,3592,7377
4885,13115,20-24,3485,3194,6679
4886,13115,25-29,3128,3137,6265
4887,13115,30-34,3262,3331,6593
4888,13115,35-39,3092,2920,6012
4889,13115,40-44,2956,2957,5913
4890,13115,45-49,2904,3020,5924
4891,13115,50-54,3179,3112,6291
4892,13115,55-59,3278,3054,6332
4893,13115,60-64,3142,3002,6144
4894,13115,65+,9422,7413,16835
4895,13117,15-19,9703,10346,20049
4896,13117,20-24,6706,7042,13748
4897,13117,25-29,5497,5564,11061
4898,13117,30-34,7062,6321,13383
4899,13117,35-39,10359,9607,19966
4900,13117,40-44,11146,11021,22167
4901,13117,45-49,10315,11356,21671
4902,13117,50-54,9961,10793,20754
4903,13117,55-59,8274,8926,17200
4904,13117,60-64,6645,6699,13344
4905,13117,65+,17616,14539,32155
4906,13119,15-19,817,844,1661
4907,13119,20-24,779,806,1585
4908,13119,25-29,740,725,1465
4909,13119,30-34,742,753,1495
4910,13119,35-39,649,657,1306
4911,13119,40-44,641,632,1273
4912,13119,45-49,696,659,1355
4913,13119,50-54,780,829,1609
4914,13119,55-59,826,769,1595
4915,13119,60-64,778,806,1584
4916,13119,65+,2533,2006,4539
4917,13121,15-19,35411,35924,71335
4918,13121,20-24,37858,37368,75226
4919,13121,25-29,46979,44103,91082
4920,13121,30-34,46257,44668,90925
4921,13121,35-39,40651,38891,79542
4922,13121,40-44,38487,35502,73989
4923,13121,45-49,37300,34338,71638
4924,13121,50-54,36442,36296,72738
4925,13121,55-59,33554,32572,66126
4926,13121,60-64,29682,27364,57046
4927,13121,65+,75714,56214,131928
4928,13123,15-19,782,776,1558
4929,13123,20-24,761,776,1537
4930,13123,25-29,728,763,1491
4931,13123,30-34,728,781,1509
4932,13123,35-39,759,787,1546
4933,13123,40-44,781,945,1726
4934,13123,45-49,951,953,1904
4935,13123,50-54,1020,1084,2104
4936,13123,55-59,1232,1219,2451
4937,13123,60-64,1453,1415,2868
4938,13123,65+,4295,4135,8430
4939,13125,15-19,82,112,194
4940,13125,20-24,98,95,193
4941,13125,25-29,72,77,149
4942,13125,30-34,73,61,134
4943,13125,35-39,88,82,170
4944,13125,40-44,93,94,187
4945,13125,45-49,101,95,196
4946,13125,50-54,114,110,224
4947,13125,55-59,103,123,226
4948,13125,60-64,110,105,215
4949,13125,65+,312,232,544
4950,13127,15-19,2586,2630,5216
4951,13127,20-24,2370,2444,4814
4952,13127,25-29,2552,2311,4863
4953,13127,30-34,2645,2316,4961
4954,13127,35-39,2669,2239,4908
4955,13127,40-44,2780,2259,5039
4956,13127,45-49,2570,2343,4913
4957,13127,50-54,2770,2553,5323
4958,13127,55-59,3142,2728,5870
4959,13127,60-64,3389,2729,6118
4960,13127,65+,10116,8028,18144
4961,13129,15-19,1951,2084,4035
4962,13129,20-24,1803,1954,3757
4963,13129,25-29,1860,1859,3719
4964,13129,30-34,1903,1834,3737
4965,13129,35-39,1768,1863,3631
4966,13129,40-44,1973,1769,3742
4967,13129,45-49,1965,1987,3952
4968,13129,50-54,2095,2096,4191
4969,13129,55-59,1961,2038,3999
4970,13129,60-64,1828,1658,3486
4971,13129,65+,4889,4066,8955
4972,13131,15-19,855,895,1750
4973,13131,20-24,690,674,1364
4974,13131,25-29,760,640,1400
4975,13131,30-34,768,713,1481
4976,13131,35-39,860,714,1574
4977,13131,40-44,762,750,1512
4978,13131,45-49,757,731,1488
4979,13131,50-54,808,812,1620
4980,13131,55-59,937,893,1830
4981,13131,60-64,888,844,1732
4982,13131,65+,2739,2252,4991
4983,13133,15-19,435,473,908
4984,13133,20-24,430,481,911
4985,13133,25-29,431,471,902
4986,13133,30-34,450,422,872
4987,13133,35-39,508,480,988
4988,13133,40-44,506,439,945
4989,13133,45-49,467,448,915
4990,13133,50-54,577,569,1146
4991,13133,55-59,798,715,1513
4992,13133,60-64,901,814,1715
4993,13133,65+,3044,2787,5831
4994,13135,15-19,36697,37817,74514
4995,13135,20-24,31117,31812,62929
4996,13135,25-29,31488,30750,62238
4997,13135,30-34,32240,30424,62664
4998,13135,35-39,34414,32682,67096
4999,13135,40-44,36227,33533,69760
5000,13135,45-49,35709,33182,68891
5001,13135,50-54,35047,34025,69072
5002,13135,55-59,32098,30957,63055
5003,13135,60-64,27187,25945,53132
5004,13135,65+,58601,47629,106230
5005,13137,15-19,1587,1557,3144
5006,13137,20-24,1698,1535,3233
5007,13137,25-29,1565,1440,3005
5008,13137,30-34,1542,1356,2898
5009,13137,35-39,1500,1330,2830
5010,13137,40-44,1501,1272,2773
5011,13137,45-49,1478,1251,2729
5012,13137,50-54,1525,1439,2964
5013,13137,55-59,1573,1483,3056
5014,13137,60-64,1583,1468,3051
5015,13137,65+,4586,4005,8591
5016,13139,15-19,7150,7694,14844
5017,13139,20-24,6884,6939,13823
5018,13139,25-29,6637,6791,13428
5019,13139,30-34,6439,6785,13224
5020,13139,35-39,6306,6551,12857
5021,13139,40-44,6453,6471,12924
5022,13139,45-49,6462,6587,13049
5023,13139,50-54,6932,7184,14116
5024,13139,55-59,6687,6937,13624
5025,13139,60-64,6117,5823,11940
5026,13139,65+,17862,15011,32873
5027,13141,15-19,170,235,405
5028,13141,20-24,157,326,483
5029,13141,25-29,191,424,615
5030,13141,30-34,172,444,616
5031,13141,35-39,165,331,496
5032,13141,40-44,190,322,512
5033,13141,45-49,182,277,459
5034,13141,50-54,223,314,537
5035,13141,55-59,345,328,673
5036,13141,60-64,325,342,667
5037,13141,65+,1134,1002,2136
5038,13143,15-19,973,978,1951
5039,13143,20-24,900,887,1787
5040,13143,25-29,955,952,1907
5041,13143,30-34,1021,1028,2049
5042,13143,35-39,981,978,1959
5043,13143,40-44,952,929,1881
5044,13143,45-49,1005,946,1951
5045,13143,50-54,1078,1107,2185
5046,13143,55-59,1004,1054,2058
5047,13143,60-64,905,943,1848
5048,13143,65+,2715,2143,4858
5049,13145,15-19,1010,1233,2243
5050,13145,20-24,843,993,1836
5051,13145,25-29,843,916,1759
5052,13145,30-34,1004,1006,2010
5053,13145,35-39,1076,1112,2188
5054,13145,40-44,1121,1138,2259
5055,13145,45-49,1187,1173,2360
5056,13145,50-54,1279,1280,2559
5057,13145,55-59,1395,1413,2808
5058,13145,60-64,1270,1265,2535
5059,13145,65+,3579,3203,6782
5060,13147,15-19,727,801,1528
5061,13147,20-24,670,728,1398
5062,13147,25-29,736,779,1515
5063,13147,30-34,735,804,1539
5064,13147,35-39,695,678,1373
5065,13147,40-44,707,733,1440
5066,13147,45-49,763,798,1561
5067,13147,50-54,915,880,1795
5068,13147,55-59,1010,926,1936
5069,13147,60-64,1023,941,1964
5070,13147,65+,3242,2719,5961
5071,13149,15-19,342,385,727
5072,13149,20-24,327,344,671
5073,13149,25-29,342,363,705
5074,13149,30-34,387,334,721
5075,13149,35-39,331,331,662
5076,13149,40-44,349,321,670
5077,13149,45-49,362,395,757
5078,13149,50-54,397,416,813
5079,13149,55-59,415,431,846
5080,13149,60-64,432,406,838
5081,13149,65+,1066,958,2024
5082,13151,15-19,9553,9793,19346
5083,13151,20-24,8237,8151,16388
5084,13151,25-29,7939,7551,15490
5085,13151,30-34,8305,7149,15454
5086,13151,35-39,8610,6985,15595
5087,13151,40-44,9466,7402,16868
5088,13151,45-49,9647,7836,17483
5089,13151,50-54,9741,8810,18551
5090,13151,55-59,8807,8225,17032
5091,13151,60-64,7293,6714,14007
5092,13151,65+,16806,13244,30050
5093,13153,15-19,5482,5804,11286
5094,13153,20-24,5154,5387,10541
5095,13153,25-29,5853,5743,11596
5096,13153,30-34,6346,5815,12161
5097,13153,35-39,6546,5698,12244
5098,13153,40-44,5881,5274,11155
5099,13153,45-49,5173,4619,9792
5100,13153,50-54,5055,4698,9753
5101,13153,55-59,5611,5248,10859
5102,13153,60-64,5022,4821,9843
5103,13153,65+,12374,9817,22191
5104,13155,15-19,276,295,571
5105,13155,20-24,262,408,670
5106,13155,25-29,256,421,677
5107,13155,30-34,281,413,694
5108,13155,35-39,287,335,622
5109,13155,40-44,286,387,673
5110,13155,45-49,275,343,618
5111,13155,50-54,291,324,615
5112,13155,55-59,316,301,617
5113,13155,60-64,260,277,537
5114,13155,65+,973,755,1728
5115,13157,15-19,2601,2749,5350
5116,13157,20-24,2120,2102,4222
5117,13157,25-29,2488,2473,4961
5118,13157,30-34,2808,2820,5628
5119,13157,35-39,2896,2839,5735
5120,13157,40-44,2833,2892,5725
5121,13157,45-49,2559,2657,5216
5122,13157,50-54,2677,2790,5467
5123,13157,55-59,2535,2615,5150
5124,13157,60-64,2318,2262,4580
5125,13157,65+,6339,5184,11523
5126,13159,15-19,461,533,994
5127,13159,20-24,398,429,827
5128,13159,25-29,435,453,888
5129,13159,30-34,506,444,950
5130,13159,35-39,479,440,919
5131,13159,40-44,447,438,885
5132,13159,45-49,468,469,937
5133,13159,50-54,552,562,1114
5134,13159,55-59,536,569,1105
5135,13159,60-64,577,539,1116
5136,13159,65+,1477,1186,2663
5137,13161,15-19,529,545,1074
5138,13161,20-24,459,453,912
5139,13161,25-29,444,418,862
5140,13161,30-34,486,401,887
5141,13161,35-39,440,474,914
5142,13161,40-44,474,420,894
5143,13161,45-49,472,466,938
5144,13161,50-54,470,471,941
5145,13161,55-59,465,500,965
5146,13161,60-64,449,471,920
5147,13161,65+,1292,1117,2409
5148,13163,15-19,460,508,968
5149,13163,20-24,443,475,918
5150,13163,25-29,484,476,960
5151,13163,30-34,473,521,994
5152,13163,35-39,458,483,941
5153,13163,40-44,447,468,915
5154,13163,45-49,447,432,879
5155,13163,50-54,482,469,951
5156,13163,55-59,573,520,1093
5157,13163,60-64,528,464,992
5158,13163,65+,1693,1218,2911
5159,13165,15-19,245,261,506
5160,13165,20-24,247,399,646
5161,13165,25-29,230,406,636
5162,13165,30-34,300,366,666
5163,13165,35-39,221,311,532
5164,13165,40-44,255,317,572
5165,13165,45-49,224,312,536
5166,13165,50-54,233,292,525
5167,13165,55-59,240,308,548
5168,13165,60-64,308,261,569
5169,13165,65+,830,649,1479
5170,13167,15-19,229,253,482
5171,13167,20-24,224,304,528
5172,13167,25-29,209,407,616
5173,13167,30-34,195,385,580
5174,13167,35-39,194,386,580
5175,13167,40-44,209,431,640
5176,13167,45-49,225,447,672
5177,13167,50-54,229,387,616
5178,13167,55-59,252,354,606
5179,13167,60-64,298,336,634
5180,13167,65+,965,857,1822
5181,13169,15-19,935,1053,1988
5182,13169,20-24,765,804,1569
5183,13169,25-29,840,810,1650
5184,13169,30-34,839,816,1655
5185,13169,35-39,912,785,1697
5186,13169,40-44,941,899,1840
5187,13169,45-49,921,840,1761
5188,13169,50-54,1009,961,1970
5189,13169,55-59,996,1008,2004
5190,13169,60-64,1004,921,1925
5191,13169,65+,2883,2284,5167
5192,13171,15-19,925,826,1751
5193,13171,20-24,795,647,1442
5194,13171,25-29,607,566,1173
5195,13171,30-34,631,668,1299
5196,13171,35-39,549,492,1041
5197,13171,40-44,563,483,1046
5198,13171,45-49,562,536,1098
5199,13171,50-54,570,623,1193
5200,13171,55-59,695,589,1284
5201,13171,60-64,640,607,1247
5202,13171,65+,1752,1439,3191
5203,13173,15-19,315,318,633
5204,13173,20-24,286,348,634
5205,13173,25-29,330,387,717
5206,13173,30-34,358,344,702
5207,13173,35-39,351,344,695
5208,13173,40-44,339,327,666
5209,13173,45-49,277,275,552
5210,13173,50-54,301,282,583
5211,13173,55-59,317,354,671
5212,13173,60-64,322,331,653
5213,13173,65+,756,699,1455
5214,13175,15-19,1628,1651,3279
5215,13175,20-24,1397,1442,2839
5216,13175,25-29,1489,1491,2980
5217,13175,30-34,1668,1461,3129
5218,13175,35-39,1641,1289,2930
5219,13175,40-44,1598,1422,3020
5220,13175,45-49,1505,1363,2868
5221,13175,50-54,1611,1565,3176
5222,13175,55-59,1628,1536,3164
5223,13175,60-64,1646,1479,3125
5224,13175,65+,5175,3809,8984
5225,13177,15-19,1136,1374,2510
5226,13177,20-24,877,967,1844
5227,13177,25-29,945,963,1908
5228,13177,30-34,1210,1160,2370
5229,13177,35-39,1235,1266,2501
5230,13177,40-44,1246,1192,2438
5231,13177,45-49,1139,1183,2322
5232,13177,50-54,1079,1120,2199
5233,13177,55-59,971,913,1884
5234,13177,60-64,988,918,1906
5235,13177,65+,2428,2102,4530
5236,13179,15-19,1828,2154,3982
5237,13179,20-24,2983,3922,6905
5238,13179,25-29,3279,3762,7041
5239,13179,30-34,2705,2903,5608
5240,13179,35-39,2141,2192,4333
5241,13179,40-44,1658,1685,3343
5242,13179,45-49,1438,1292,2730
5243,13179,50-54,1451,1278,2729
5244,13179,55-59,1647,1334,2981
5245,13179,60-64,1569,1356,2925
5246,13179,65+,3676,3036,6712
5247,13181,15-19,185,175,360
5248,13181,20-24,162,180,342
5249,13181,25-29,225,234,459
5250,13181,30-34,212,195,407
5251,13181,35-39,223,214,437
5252,13181,40-44,193,178,371
5253,13181,45-49,237,230,467
5254,13181,50-54,240,215,455
5255,13181,55-59,310,295,605
5256,13181,60-64,354,330,684
5257,13181,65+,1015,919,1934
5258,13183,15-19,584,544,1128
5259,13183,20-24,477,537,1014
5260,13183,25-29,636,644,1280
5261,13183,30-34,722,703,1425
5262,13183,35-39,682,664,1346
5263,13183,40-44,610,666,1276
5264,13183,45-49,501,536,1037
5265,13183,50-54,519,489,1008
5266,13183,55-59,468,516,984
5267,13183,60-64,438,441,879
5268,13183,65+,965,814,1779
5269,13185,15-19,5014,4684,9698
5270,13185,20-24,7256,6971,14227
5271,13185,25-29,4419,4721,9140
5272,13185,30-34,4196,4013,8209
5273,13185,35-39,3824,3741,7565
5274,13185,40-44,3418,3127,6545
5275,13185,45-49,3112,2797,5909
5276,13185,50-54,3121,2849,5970
5277,13185,55-59,3226,3005,6231
5278,13185,60-64,3138,2775,5913
5279,13185,65+,8840,6480,15320
5280,13187,15-19,1742,1659,3401
5281,13187,20-24,1933,2196,4129
5282,13187,25-29,993,1002,1995
5283,13187,30-34,898,928,1826
5284,13187,35-39,858,881,1739
5285,13187,40-44,898,857,1755
5286,13187,45-49,895,907,1802
5287,13187,50-54,1008,972,1980
5288,13187,55-59,1054,1080,2134
5289,13187,60-64,1266,1118,2384
5290,13187,65+,3373,2991,6364
5291,13189,15-19,699,709,1408
5292,13189,20-24,655,614,1269
5293,13189,25-29,628,617,1245
5294,13189,30-34,708,588,1296
5295,13189,35-39,653,565,1218
5296,13189,40-44,669,546,1215
5297,13189,45-49,643,583,1226
5298,13189,50-54,697,642,1339
5299,13189,55-59,767,719,1486
5300,13189,60-64,768,675,1443
5301,13189,65+,2326,1689,4015
5302,13191,15-19,238,256,494
5303,13191,20-24,257,255,512
5304,13191,25-29,307,336,643
5305,13191,30-34,305,251,556
5306,13191,35-39,250,261,511
5307,13191,40-44,276,246,522
5308,13191,45-49,329,300,629
5309,13191,50-54,426,377,803
5310,13191,55-59,450,413,863
5311,13191,60-64,508,497,1005
5312,13191,65+,1708,1502,3210
5313,13193,15-19,296,333,629
5314,13193,20-24,302,540,842
5315,13193,25-29,316,602,918
5316,13193,30-34,293,583,876
5317,13193,35-39,285,500,785
5318,13193,40-44,275,477,752
5319,13193,45-49,289,437,726
5320,13193,50-54,311,396,707
5321,13193,55-59,425,432,857
5322,13193,60-64,454,393,847
5323,13193,65+,1176,1038,2214
5324,13195,15-19,860,1043,1903
5325,13195,20-24,801,842,1643
5326,13195,25-29,999,1010,2009
5327,13195,30-34,994,944,1938
5328,13195,35-39,989,904,1893
5329,13195,40-44,1021,898,1919
5330,13195,45-49,989,922,1911
5331,13195,50-54,972,1008,1980
5332,13195,55-59,1112,1111,2223
5333,13195,60-64,1069,985,2054
5334,13195,65+,2894,2570,5464
5335,13197,15-19,200,206,406
5336,13197,20-24,223,194,417
5337,13197,25-29,177,213,390
5338,13197,30-34,204,199,403
5339,13197,35-39,205,199,404
5340,13197,40-44,186,191,377
5341,13197,45-49,240,220,460
5342,13197,50-54,254,246,500
5343,13197,55-59,329,299,628
5344,13197,60-64,284,331,615
5345,13197,65+,848,752,1600
5346,13199,15-19,597,587,1184
5347,13199,20-24,598,619,1217
5348,13199,25-29,604,645,1249
5349,13199,30-34,639,615,1254
5350,13199,35-39,565,524,1089
5351,13199,40-44,640,536,1176
5352,13199,45-49,602,554,1156
5353,13199,50-54,725,624,1349
5354,13199,55-59,814,742,1556
5355,13199,60-64,789,792,1581
5356,13199,65+,2478,1908,4386
5357,13201,15-19,177,177,354
5358,13201,20-24,148,165,313
5359,13201,25-29,167,143,310
5360,13201,30-34,145,161,306
5361,13201,35-39,192,143,335
5362,13201,40-44,174,172,346
5363,13201,45-49,152,145,297
5364,13201,50-54,207,177,384
5365,13201,55-59,230,210,440
5366,13201,60-64,207,193,400
5367,13201,65+,737,576,1313
5368,13205,15-19,595,722,1317
5369,13205,20-24,546,761,1307
5370,13205,25-29,587,849,1436
5371,13205,30-34,614,862,1476
5372,13205,35-39,599,745,1344
5373,13205,40-44,612,780,1392
5374,13205,45-49,613,750,1363
5375,13205,50-54,645,732,1377
5376,13205,55-59,704,733,1437
5377,13205,60-64,715,711,1426
5378,13205,65+,2184,1553,3737
5379,13207,15-19,790,939,1729
5380,13207,20-24,690,941,1631
5381,13207,25-29,771,887,1658
5382,13207,30-34,872,881,1753
5383,13207,35-39,913,873,1786
5384,13207,40-44,900,908,1808
5385,13207,45-49,939,908,1847
5386,13207,50-54,974,945,1919
5387,13207,55-59,1031,963,1994
5388,13207,60-64,1076,1059,2135
5389,13207,65+,3026,2536,5562
5390,13209,15-19,324,330,654
5391,13209,20-24,301,373,674
5392,13209,25-29,256,292,548
5393,13209,30-34,222,296,518
5394,13209,35-39,254,283,537
5395,13209,40-44,219,257,476
5396,13209,45-49,249,292,541
5397,13209,50-54,265,301,566
5398,13209,55-59,282,289,571
5399,13209,60-64,288,295,583
5400,13209,65+,852,670,1522
5401,13211,15-19,635,683,1318
5402,13211,20-24,533,551,1084
5403,13211,25-29,567,518,1085
5404,13211,30-34,613,540,1153
5405,13211,35-39,632,601,1233
5406,13211,40-44,606,580,1186
5407,13211,45-49,670,588,1258
5408,13211,50-54,724,647,1371
5409,13211,55-59,713,774,1487
5410,13211,60-64,752,696,1448
5411,13211,65+,2345,1894,4239
5412,13213,15-19,1374,1427,2801
5413,13213,20-24,1239,1217,2456
5414,13213,25-29,1227,1314,2541
5415,13213,30-34,1300,1317,2617
5416,13213,35-39,1230,1159,2389
5417,13213,40-44,1265,1233,2498
5418,13213,45-49,1361,1249,2610
5419,13213,50-54,1407,1437,2844
5420,13213,55-59,1417,1415,2832
5421,13213,60-64,1209,1306,2515
5422,13213,65+,3404,2764,6168
5423,13215,15-19,6398,7079,13477
5424,13215,20-24,6713,7543,14256
5425,13215,25-29,8052,8401,16453
5426,13215,30-34,8217,8045,16262
5427,13215,35-39,7407,7020,14427
5428,13215,40-44,6634,6006,12640
5429,13215,45-49,5981,5338,11319
5430,13215,50-54,5791,5351,11142
5431,13215,55-59,6292,5441,11733
5432,13215,60-64,6149,5514,11663
5433,13215,65+,17007,12146,29153
5434,13217,15-19,4530,4702,9232
5435,13217,20-24,3820,3761,7581
5436,13217,25-29,3775,3538,7313
5437,13217,30-34,3952,3420,7372
5438,13217,35-39,3917,3243,7160
5439,13217,40-44,4149,3320,7469
5440,13217,45-49,4340,3509,7849
5441,13217,50-54,4377,3813,8190
5442,13217,55-59,4019,3651,7670
5443,13217,60-64,3410,2967,6377
5444,13217,65+,8761,6525,15286
5445,13219,15-19,1679,1704,3383
5446,13219,20-24,1111,1247,2358
5447,13219,25-29,789,796,1585
5448,13219,30-34,1121,963,2084
5449,13219,35-39,1550,1309,2859
5450,13219,40-44,1662,1635,3297
5451,13219,45-49,1571,1479,3050
5452,13219,50-54,1513,1515,3028
5453,13219,55-59,1371,1314,2685
5454,13219,60-64,1333,1295,2628
5455,13219,65+,3708,3338,7046
5456,13221,15-19,435,443,878
5457,13221,20-24,358,420,778
5458,13221,25-29,459,476,935
5459,13221,30-34,462,486,948
5460,13221,35-39,495,465,960
5461,13221,40-44,436,464,900
5462,13221,45-49,465,465,930
5463,13221,50-54,546,513,1059
5464,13221,55-59,534,571,1105
5465,13221,60-64,559,597,1156
5466,13221,65+,1578,1333,2911
5467,13223,15-19,6155,6440,12595
5468,13223,20-24,5198,5103,10301
5469,13223,25-29,5656,5556,11212
5470,13223,30-34,6338,6007,12345
5471,13223,35-39,6422,5940,12362
5472,13223,40-44,6372,6128,12500
5473,13223,45-49,6498,6056,12554
5474,13223,50-54,6639,6481,13120
5475,13223,55-59,5774,5784,11558
5476,13223,60-64,4882,4638,9520
5477,13223,65+,11008,8537,19545
5478,13225,15-19,1268,1160,2428
5479,13225,20-24,1218,1258,2476
5480,13225,25-29,846,831,1677
5481,13225,30-34,871,862,1733
5482,13225,35-39,855,814,1669
5483,13225,40-44,803,749,1552
5484,13225,45-49,793,743,1536
5485,13225,50-54,874,776,1650
5486,13225,55-59,1039,987,2026
5487,13225,60-64,953,988,1941
5488,13225,65+,2728,2060,4788
5489,13227,15-19,943,1008,1951
5490,13227,20-24,849,876,1725
5491,13227,25-29,919,977,1896
5492,13227,30-34,1010,969,1979
5493,13227,35-39,912,896,1808
5494,13227,40-44,963,869,1832
5495,13227,45-49,996,982,1978
5496,13227,50-54,1190,1247,2437
5497,13227,55-59,1374,1299,2673
5498,13227,60-64,1460,1385,2845
5499,13227,65+,4055,3650,7705
5500,13229,15-19,639,707,1346
5501,13229,20-24,585,604,1189
5502,13229,25-29,550,578,1128
5503,13229,30-34,608,579,1187
5504,13229,35-39,626,576,1202
5505,13229,40-44,647,625,1272
5506,13229,45-49,623,620,1243
5507,13229,50-54,669,685,1354
5508,13229,55-59,641,657,1298
5509,13229,60-64,616,618,1234
5510,13229,65+,1896,1612,3508
5511,13231,15-19,655,715,1370
5512,13231,20-24,570,551,1121
5513,13231,25-29,559,492,1051
5514,13231,30-34,606,541,1147
5515,13231,35-39,686,612,1298
5516,13231,40-44,640,620,1260
5517,13231,45-49,694,651,1345
5518,13231,50-54,725,731,1456
5519,13231,55-59,709,739,1448
5520,13231,60-64,594,597,1191
5521,13231,65+,1702,1425,3127
5522,13233,15-19,1422,1569,2991
5523,13233,20-24,1312,1362,2674
5524,13233,25-29,1376,1385,2761
5525,13233,30-34,1519,1444,2963
5526,13233,35-39,1383,1434,2817
5527,13233,40-44,1271,1299,2570
5528,13233,45-49,1319,1234,2553
5529,13233,50-54,1352,1384,2736
5530,13233,55-59,1426,1402,2828
5531,13233,60-64,1415,1277,2692
5532,13233,65+,3790,2986,6776
5533,13235,15-19,267,271,538
5534,13235,20-24,325,239,564
5535,13235,25-29,384,222,606
5536,13235,30-34,418,205,623
5537,13235,35-39,370,227,597
5538,13235,40-44,380,214,594
5539,13235,45-49,389,236,625
5540,13235,50-54,385,279,664
5541,13235,55-59,378,328,706
5542,13235,60-64,406,290,696
5543,13235,65+,1264,1012,2276
5544,13237,15-19,599,631,1230
5545,13237,20-24,562,567,1129
5546,13237,25-29,575,536,1111
5547,13237,30-34,631,577,1208
5548,13237,35-39,621,611,1232
5549,13237,40-44,593,537,1130
5550,13237,45-49,611,543,1154
5551,13237,50-54,836,731,1567
5552,13237,55-59,947,866,1813
5553,13237,60-64,952,910,1862
5554,13237,65+,2944,2660,5604
5555,13239,15-19,51,50,101
5556,13239,20-24,54,39,93
5557,13239,25-29,50,51,101
5558,13239,30-34,48,52,100
5559,13239,35-39,55,43,98
5560,13239,40-44,58,31,89
5561,13239,45-49,52,49,101
5562,13239,50-54,61,67,128
5563,13239,55-59,100,72,172
5564,13239,60-64,111,88,199
5565,13239,65+,367,355,722
5566,13241,15-19,435,429,864
5567,13241,20-24,379,386,765
5568,13241,25-29,445,443,888
5569,13241,30-34,472,462,934
5570,13241,35-39,435,465,900
5571,13241,40-44,431,395,826
5572,13241,45-49,551,470,1021
5573,13241,50-54,544,582,1126
5574,13241,55-59,603,584,1187
5575,13241,60-64,758,749,1507
5576,13241,65+,2567,2337,4904
5577,13243,15-19,190,211,401
5578,13243,20-24,197,162,359
5579,13243,25-29,167,147,314
5580,13243,30-34,154,150,304
5581,13243,35-39,185,152,337
5582,13243,40-44,168,150,318
5583,13243,45-49,153,140,293
5584,13243,50-54,184,144,328
5585,13243,55-59,238,213,451
5586,13243,60-64,286,224,510
5587,13243,65+,920,697,1617
5588,13245,15-19,6370,7829,14199
5589,13245,20-24,7578,8697,16275
5590,13245,25-29,8352,8660,17012
5591,13245,30-34,8240,7791,16031
5592,13245,35-39,6984,6477,13461
5593,13245,40-44,6181,5524,11705
5594,13245,45-49,5557,4982,10539
5595,13245,50-54,5994,5111,11105
5596,13245,55-59,6686,5786,12472
5597,13245,60-64,6988,5902,12890
5598,13245,65+,17635,13129,30764
5599,13247,15-19,3452,3482,6934
5600,13247,20-24,3005,3000,6005
5601,13247,25-29,2965,2922,5887
5602,13247,30-34,3011,2578,5589
5603,13247,35-39,2977,2374,5351
5604,13247,40-44,3167,2444,5611
5605,13247,45-49,3437,2741,6178
5606,13247,50-54,3581,3142,6723
5607,13247,55-59,3791,3282,7073
5608,13247,60-64,3288,2957,6245
5609,13247,65+,8086,6361,14447
5610,13249,15-19,171,182,353
5611,13249,20-24,138,112,250
5612,13249,25-29,105,91,196
5613,13249,30-34,131,110,241
5614,13249,35-39,139,118,257
5615,13249,40-44,132,135,267
5616,13249,45-49,194,140,334
5617,13249,50-54,197,186,383
5618,13249,55-59,131,152,283
5619,13249,60-64,158,138,296
5620,13249,65+,430,365,795
5621,13251,15-19,329,478,807
5622,13251,20-24,355,373,728
5623,13251,25-29,421,477,898
5624,13251,30-34,499,439,938
5625,13251,35-39,413,385,798
5626,13251,40-44,437,421,858
5627,13251,45-49,398,399,797
5628,13251,50-54,479,467,946
5629,13251,55-59,521,501,1022
5630,13251,60-64,568,506,1074
5631,13251,65+,1573,1277,2850
5632,13253,15-19,275,264,539
5633,13253,20-24,242,252,494
5634,13253,25-29,268,227,495
5635,13253,30-34,250,237,487
5636,13253,35-39,243,212,455
5637,13253,40-44,257,235,492
5638,13253,45-49,290,232,522
5639,13253,50-54,292,314,606
5640,13253,55-59,365,295,660
5641,13253,60-64,397,344,741
5642,13253,65+,1166,1026,2192
5643,13255,15-19,2069,2145,4214
5644,13255,20-24,2003,2037,4040
5645,13255,25-29,2324,2272,4596
5646,13255,30-34,2386,2241,4627
5647,13255,35-39,2087,1948,4035
5648,13255,40-44,2051,1859,3910
5649,13255,45-49,2055,1755,3810
5650,13255,50-54,2180,1998,4178
5651,13255,55-59,2275,2055,4330
5652,13255,60-64,2258,2057,4315
5653,13255,65+,7246,5485,12731
5654,13257,15-19,892,875,1767
5655,13257,20-24,939,867,1806
5656,13257,25-29,785,766,1551
5657,13257,30-34,806,762,1568
5658,13257,35-39,751,719,1470
5659,13257,40-44,765,737,1502
5660,13257,45-49,771,667,1438
5661,13257,50-54,872,837,1709
5662,13257,55-59,895,905,1800
5663,13257,60-64,989,892,1881
5664,13257,65+,2942,2498,5440
5665,13259,15-19,69,115,184
5666,13259,20-24,81,456,537
5667,13259,25-29,103,676,779
5668,13259,30-34,107,590,697
5669,13259,35-39,87,398,485
5670,13259,40-44,83,285,368
5671,13259,45-49,100,181,281
5672,13259,50-54,105,148,253
5673,13259,55-59,123,160,283
5674,13259,60-64,123,124,247
5675,13259,65+,436,318,754
5676,13261,15-19,1157,1108,2265
5677,13261,20-24,1517,1326,2843
5678,13261,25-29,923,982,1905
5679,13261,30-34,816,856,1672
5680,13261,35-39,815,741,1556
5681,13261,40-44,852,712,1564
5682,13261,45-49,831,709,1540
5683,13261,50-54,911,795,1706
5684,13261,55-59,998,842,1840
5685,13261,60-64,945,812,1757
5686,13261,65+,2912,2212,5124
5687,13263,15-19,140,128,268
5688,13263,20-24,157,139,296
5689,13263,25-29,156,135,291
5690,13263,30-34,149,141,290
5691,13263,35-39,129,136,265
5692,13263,40-44,136,148,284
5693,13263,45-49,157,166,323
5694,13263,50-54,213,169,382
5695,13263,55-59,258,242,500
5696,13263,60-64,283,247,530
5697,13263,65+,839,700,1539
5698,13265,15-19,30,34,64
5699,13265,20-24,32,35,67
5700,13265,25-29,25,44,69
5701,13265,30-34,49,38,87
5702,13265,35-39,39,50,89
5703,13265,40-44,27,47,74
5704,13265,45-49,46,43,89
5705,13265,50-54,37,47,84
5706,13265,55-59,71,67,138
5707,13265,60-64,62,70,132
5708,13265,65+,244,204,448
5709,13267,15-19,586,752,1338
5710,13267,20-24,555,1145,1700
5711,13267,25-29,541,1234,1775
5712,13267,30-34,641,1211,1852
5713,13267,35-39,591,1074,1665
5714,13267,40-44,606,955,1561
5715,13267,45-49,590,983,1573
5716,13267,50-54,585,892,1477
5717,13267,55-59,674,785,1459
5718,13267,60-64,626,713,1339
5719,13267,65+,1930,1529,3459
5720,13269,15-19,218,233,451
5721,13269,20-24,208,195,403
5722,13269,25-29,237,225,462
5723,13269,30-34,233,240,473
5724,13269,35-39,192,183,375
5725,13269,40-44,232,210,442
5726,13269,45-49,256,244,500
5727,13269,50-54,281,259,540
5728,13269,55-59,298,290,588
5729,13269,60-64,319,278,597
5730,13269,65+,969,734,1703
5731,13271,15-19,274,323,597
5732,13271,20-24,245,455,700
5733,13271,25-29,268,636,904
5734,13271,30-34,268,684,952
5735,13271,35-39,277,744,1021
5736,13271,40-44,306,690,996
5737,13271,45-49,318,564,882
5738,13271,50-54,302,517,819
5739,13271,55-59,338,450,788
5740,13271,60-64,381,400,781
5741,13271,65+,1231,1104,2335
5742,13273,15-19,260,277,537
5743,13273,20-24,254,279,533
5744,13273,25-29,266,280,546
5745,13273,30-34,283,298,581
5746,13273,35-39,241,271,512
5747,13273,40-44,265,228,493
5748,13273,45-49,211,227,438
5749,13273,50-54,282,229,511
5750,13273,55-59,344,318,662
5751,13273,60-64,355,296,651
5752,13273,65+,1049,810,1859
5753,13275,15-19,1422,1478,2900
5754,13275,20-24,1361,1283,2644
5755,13275,25-29,1423,1269,2692
5756,13275,30-34,1423,1248,2671
5757,13275,35-39,1517,1326,2843
5758,13275,40-44,1411,1295,2706
5759,13275,45-49,1367,1141,2508
5760,13275,50-54,1478,1402,2880
5761,13275,55-59,1658,1518,3176
5762,13275,60-64,1678,1437,3115
5763,13275,65+,4888,3794,8682
5764,13277,15-19,1655,1665,3320
5765,13277,20-24,1443,1424,2867
5766,13277,25-29,1369,1281,2650
5767,13277,30-34,1404,1318,2722
5768,13277,35-39,1274,1253,2527
5769,13277,40-44,1337,1253,2590
5770,13277,45-49,1194,1143,2337
5771,13277,50-54,1227,1215,2442
5772,13277,55-59,1228,1181,2409
5773,13277,60-64,1301,1128,2429
5774,13277,65+,3758,2749,6507
5775,13279,15-19,888,985,1873
5776,13279,20-24,865,820,1685
5777,13279,25-29,865,772,1637
5778,13279,30-34,898,817,1715
5779,13279,35-39,878,784,1662
5780,13279,40-44,850,785,1635
5781,13279,45-49,810,686,1496
5782,13279,50-54,845,711,1556
5783,13279,55-59,893,766,1659
5784,13279,60-64,832,802,1634
5785,13279,65+,2632,1854,4486
5786,13281,15-19,606,527,1133
5787,13281,20-24,390,435,825
5788,13281,25-29,219,274,493
5789,13281,30-34,257,233,490
5790,13281,35-39,227,209,436
5791,13281,40-44,234,219,453
5792,13281,45-49,294,256,550
5793,13281,50-54,338,331,669
5794,13281,55-59,457,428,885
5795,13281,60-64,640,503,1143
5796,13281,65+,2426,2051,4477
5797,13283,15-19,210,211,421
5798,13283,20-24,172,278,450
5799,13283,25-29,160,241,401
5800,13283,30-34,175,224,399
5801,13283,35-39,196,170,366
5802,13283,40-44,216,191,407
5803,13283,45-49,155,170,325
5804,13283,50-54,170,199,369
5805,13283,55-59,193,209,402
5806,13283,60-64,217,220,437
5807,13283,65+,653,503,1156
5808,13285,15-19,2308,2525,4833
5809,13285,20-24,2318,2370,4688
5810,13285,25-29,2529,2253,4782
5811,13285,30-34,2605,2270,4875
5812,13285,35-39,2342,2053,4395
5813,13285,40-44,2184,1962,4146
5814,13285,45-49,2209,1897,4106
5815,13285,50-54,2261,2126,4387
5816,13285,55-59,2372,2242,4614
5817,13285,60-64,2212,1997,4209
5818,13285,65+,6104,4644,10748
5819,13287,15-19,298,297,595
5820,13287,20-24,282,318,600
5821,13287,25-29,254,311,565
5822,13287,30-34,256,286,542
5823,13287,35-39,264,264,528
5824,13287,40-44,251,279,530
5825,13287,45-49,217,235,452
5826,13287,50-54,299,238,537
5827,13287,55-59,297,264,561
5828,13287,60-64,298,227,525
5829,13287,65+,989,696,1685
5830,13289,15-19,189,202,391
5831,13289,20-24,178,170,348
5832,13289,25-29,195,208,403
5833,13289,30-34,233,206,439
5834,13289,35-39,194,197,391
5835,13289,40-44,203,263,466
5836,13289,45-49,220,218,438
5837,13289,50-54,254,265,519
5838,13289,55-59,330,350,680
5839,13289,60-64,353,321,674
5840,13289,65+,1016,853,1869
5841,13291,15-19,543,621,1164
5842,13291,20-24,478,559,1037
5843,13291,25-29,536,505,1041
5844,13291,30-34,540,530,1070
5845,13291,35-39,524,536,1060
5846,13291,40-44,580,559,1139
5847,13291,45-49,624,564,1188
5848,13291,50-54,809,679,1488
5849,13291,55-59,1032,929,1961
5850,13291,60-64,1298,1208,2506
5851,13291,65+,4545,4143,8688
5852,13293,15-19,820,813,1633
5853,13293,20-24,832,799,1631
5854,13293,25-29,908,874,1782
5855,13293,30-34,892,822,1714
5856,13293,35-39,796,699,1495
5857,13293,40-44,833,799,1632
5858,13293,45-49,872,776,1648
5859,13293,50-54,945,888,1833
5860,13293,55-59,1020,978,1998
5861,13293,60-64,1046,936,1982
5862,13293,65+,2925,2232,5157
5863,13295,15-19,1875,2068,3943
5864,13295,20-24,1800,2025,3825
5865,13295,25-29,2119,2203,4322
5866,13295,30-34,2138,2127,4265
5867,13295,35-39,2106,2090,4196
5868,13295,40-44,2262,2228,4490
5869,13295,45-49,2133,2187,4320
5870,13295,50-54,2207,2277,4484
5871,13295,55-59,2342,2413,4755
5872,13295,60-64,2364,2276,4640
5873,13295,65+,7303,5765,13068
5874,13297,15-19,3338,3566,6904
5875,13297,20-24,2870,3048,5918
5876,13297,25-29,3074,2997,6071
5877,13297,30-34,3302,3028,6330
5878,13297,35-39,3293,2914,6207
5879,13297,40-44,3362,3027,6389
5880,13297,45-49,3355,3168,6523
5881,13297,50-54,3622,3475,7097
5882,13297,55-59,3477,3501,6978
5883,13297,60-64,3067,2935,6002
5884,13297,65+,8785,7193,15978
5885,13299,15-19,1082,1213,2295
5886,13299,20-24,970,1184,2154
5887,13299,25-29,1060,1327,2387
5888,13299,30-34,1125,1298,2423
5889,13299,35-39,1027,1162,2189
5890,13299,40-44,1048,1079,2127
5891,13299,45-49,1005,1105,2110
5892,13299,50-54,1065,1125,2190
5893,13299,55-59,1080,1082,2162
5894,13299,60-64,1176,1060,2236
5895,13299,65+,3663,2668,6331
5896,13301,15-19,152,143,295
5897,13301,20-24,130,135,265
5898,13301,25-29,147,152,299
5899,13301,30-34,160,159,319
5900,13301,35-39,131,130,261
5901,13301,40-44,140,123,263
5902,13301,45-49,134,138,272
5903,13301,50-54,191,150,341
5904,13301,55-59,213,198,411
5905,13301,60-64,214,194,408
5906,13301,65+,692,524,1216
5907,13303,15-19,544,627,1171
5908,13303,20-24,485,689,1174
5909,13303,25-29,562,790,1352
5910,13303,30-34,549,775,1324
5911,13303,35-39,579,664,1243
5912,13303,40-44,529,663,1192
5913,13303,45-49,538,620,1158
5914,13303,50-54,564,651,1215
5915,13303,55-59,751,725,1476
5916,13303,60-64,744,682,1426
5917,13303,65+,2072,1466,3538
5918,13305,15-19,905,1003,1908
5919,13305,20-24,805,895,1700
5920,13305,25-29,879,1062,1941
5921,13305,30-34,994,1197,2191
5922,13305,35-39,964,1126,2090
5923,13305,40-44,878,1067,1945
5924,13305,45-49,859,994,1853
5925,13305,50-54,938,1032,1970
5926,13305,55-59,1019,975,1994
5927,13305,60-64,915,921,1836
5928,13305,65+,2669,2249,4918
5929,13307,15-19,71,68,139
5930,13307,20-24,74,66,140
5931,13307,25-29,66,60,126
5932,13307,30-34,54,58,112
5933,13307,35-39,60,58,118
5934,13307,40-44,56,51,107
5935,13307,45-49,67,71,138
5936,13307,50-54,84,82,166
5937,13307,55-59,97,113,210
5938,13307,60-64,105,86,191
5939,13307,65+,290,287,577
5940,13309,15-19,168,220,388
5941,13309,20-24,143,472,615
5942,13309,25-29,126,513,639
5943,13309,30-34,132,504,636
5944,13309,35-39,133,413,546
5945,13309,40-44,156,436,592
5946,13309,45-49,124,457,581
5947,13309,50-54,147,336,483
5948,13309,55-59,180,278,458
5949,13309,60-64,201,204,405
5950,13309,65+,611,555,1166
5951,13311,15-19,939,996,1935
5952,13311,20-24,859,908,1767
5953,13311,25-29,727,820,1547
5954,13311,30-34,740,773,1513
5955,13311,35-39,713,708,1421
5956,13311,40-44,781,790,1571
5957,13311,45-49,864,782,1646
5958,13311,50-54,944,923,1867
5959,13311,55-59,1087,968,2055
5960,13311,60-64,1127,1075,2202
5961,13311,65+,3430,3013,6443
5962,13313,15-19,3775,3957,7732
5963,13313,20-24,3420,3638,7058
5964,13313,25-29,3283,3457,6740
5965,13313,30-34,3248,3458,6706
5966,13313,35-39,3271,3335,6606
5967,13313,40-44,3202,3302,6504
5968,13313,45-49,3181,3224,6405
5969,13313,50-54,3363,3439,6802
5970,13313,55-59,3228,3224,6452
5971,13313,60-64,2897,2819,5716
5972,13313,65+,8142,6782,14924
5973,13315,15-19,194,272,466
5974,13315,20-24,185,403,588
5975,13315,25-29,175,454,629
5976,13315,30-34,207,444,651
5977,13315,35-39,174,416,590
5978,13315,40-44,200,448,648
5979,13315,45-49,171,437,608
5980,13315,50-54,200,351,551
5981,13315,55-59,210,337,547
5982,13315,60-64,219,264,483
5983,13315,65+,880,754,1634
5984,13317,15-19,276,272,548
5985,13317,20-24,271,254,525
5986,13317,25-29,227,250,477
5987,13317,30-34,222,292,514
5988,13317,35-39,249,242,491
5989,13317,40-44,282,220,502
5990,13317,45-49,273,253,526
5991,13317,50-54,297,316,613
5992,13317,55-59,377,338,715
5993,13317,60-64,375,350,725
5994,13317,65+,1274,996,2270
5995,13319,15-19,276,276,552
5996,13319,20-24,252,240,492
5997,13319,25-29,246,242,488
5998,13319,30-34,241,220,461
5999,13319,35-39,258,273,531
6000,13319,40-44,236,263,499
6001,13319,45-49,234,216,450
6002,13319,50-54,297,243,540
6003,13319,55-59,358,358,716
6004,13319,60-64,318,346,664
6005,13319,65+,1070,778,1848
6006,13321,15-19,637,617,1254
6007,13321,20-24,558,547,1105
6008,13321,25-29,626,601,1227
6009,13321,30-34,644,606,1250
6010,13321,35-39,645,564,1209
6011,13321,40-44,574,556,1130
6012,13321,45-49,660,531,1191
6013,13321,50-54,696,691,1387
6014,13321,55-59,775,734,1509
6015,13321,60-64,790,739,1529
6016,13321,65+,2297,1832,4129
6017,15001,15-19,5487,5825,11312
6018,15001,20-24,4911,4821,9732
6019,15001,25-29,5375,5330,10705
6020,15001,30-34,6254,6026,12280
6021,15001,35-39,6516,6362,12878
6022,15001,40-44,6343,6229,12572
6023,15001,45-49,5745,5744,11489
6024,15001,50-54,5890,5790,11680
6025,15001,55-59,6687,6319,13006
6026,15001,60-64,7724,7530,15254
6027,15001,65+,23745,22302,46047
6028,15003,15-19,25908,28278,54186
6029,15003,20-24,28958,37848,66806
6030,15003,25-29,32754,38069,70823
6031,15003,30-34,34840,38269,73109
6032,15003,35-39,33655,36247,69902
6033,15003,40-44,30850,32292,63142
6034,15003,45-49,28329,29048,57377
6035,15003,50-54,29714,30170,59884
6036,15003,55-59,30139,30495,60634
6037,15003,60-64,29910,29433,59343
6038,15003,65+,103587,84348,187935
6039,15005,15-19,0,0,0
6040,15005,20-24,0,0,0
6041,15005,25-29,0,0,0
6042,15005,30-34,2,2,4
6043,15005,35-39,1,5,6
6044,15005,40-44,2,2,4
6045,15005,45-49,2,3,5
6046,15005,50-54,4,2,6
6047,15005,55-59,4,7,11
6048,15005,60-64,2,2,4
6049,15005,65+,25,17,42
6050,15007,15-19,1910,2087,3997
6051,15007,20-24,1644,1715,3359
6052,15007,25-29,2044,2088,4132
6053,15007,30-34,2294,2222,4516
6054,15007,35-39,2415,2466,4881
6055,15007,40-44,2368,2452,4820
6056,15007,45-49,2145,2152,4297
6057,15007,50-54,2246,2281,4527
6058,15007,55-59,2413,2359,4772
6059,15007,60-64,2617,2531,5148
6060,15007,65+,8325,7430,15755
6061,15009,15-19,4368,4585,8953
6062,15009,20-24,4052,3803,7855
6063,15009,25-29,4473,4302,8775
6064,15009,30-34,5256,4854,10110
6065,15009,35-39,5752,5740,11492
6066,15009,40-44,5456,5763,11219
6067,15009,45-49,4900,5091,9991
6068,15009,50-54,5328,5475,10803
6069,15009,55-59,5685,5565,11250
6070,15009,60-64,5882,5851,11733
6071,15009,65+,17078,15447,32525
6072,16001,15-19,16808,17815,34623
6073,16001,20-24,14824,16048,30872
6074,16001,25-29,16554,18287,34841
6075,16001,30-34,18078,18358,36436
6076,16001,35-39,18553,19364,37917
6077,16001,40-44,18063,18800,36863
6078,16001,45-49,15818,17071,32889
6079,16001,50-54,15761,16896,32657
6080,16001,55-59,15553,15359,30912
6081,16001,60-64,15783,15018,30801
6082,16001,65+,42782,36909,79691
6083,16003,15-19,108,117,225
6084,16003,20-24,68,79,147
6085,16003,25-29,93,108,201
6086,16003,30-34,96,101,197
6087,16003,35-39,92,109,201
6088,16003,40-44,105,127,232
6089,16003,45-49,116,128,244
6090,16003,50-54,127,122,249
6091,16003,55-59,180,179,359
6092,16003,60-64,254,239,493
6093,16003,65+,668,767,1435
6094,16005,15-19,3216,3394,6610
6095,16005,20-24,3110,3256,6366
6096,16005,25-29,3003,3108,6111
6097,16005,30-34,3168,3099,6267
6098,16005,35-39,3063,3192,6255
6099,16005,40-44,2934,2897,5831
6100,16005,45-49,2353,2405,4758
6101,16005,50-54,2327,2247,4574
6102,16005,55-59,2320,2222,4542
6103,16005,60-64,2594,2473,5067
6104,16005,65+,7001,6343,13344
6105,16007,15-19,222,241,463
6106,16007,20-24,154,153,307
6107,16007,25-29,149,176,325
6108,16007,30-34,198,198,396
6109,16007,35-39,172,190,362
6110,16007,40-44,180,209,389
6111,16007,45-49,168,150,318
6112,16007,50-54,176,172,348
6113,16007,55-59,194,181,375
6114,16007,60-64,233,245,478
6115,16007,65+,680,649,1329
6116,16009,15-19,263,314,577
6117,16009,20-24,201,215,416
6118,16009,25-29,246,259,505
6119,16009,30-34,255,267,522
6120,16009,35-39,240,266,506
6121,16009,40-44,276,282,558
6122,16009,45-49,270,250,520
6123,16009,50-54,276,313,589
6124,16009,55-59,356,355,711
6125,16009,60-64,435,449,884
6126,16009,65+,1157,1160,2317
6127,16011,15-19,1999,2054,4053
6128,16011,20-24,1403,1555,2958
6129,16011,25-29,1407,1400,2807
6130,16011,30-34,1498,1443,2941
6131,16011,35-39,1640,1567,3207
6132,16011,40-44,1535,1603,3138
6133,16011,45-49,1281,1378,2659
6134,16011,50-54,1246,1222,2468
6135,16011,55-59,1322,1352,2674
6136,16011,60-64,1440,1438,2878
6137,16011,65+,3685,3520,7205
6138,16013,15-19,737,846,1583
6139,16013,20-24,623,602,1225
6140,16013,25-29,563,702,1265
6141,16013,30-34,651,694,1345
6142,16013,35-39,715,746,1461
6143,16013,40-44,832,823,1655
6144,16013,45-49,823,804,1627
6145,16013,50-54,776,846,1622
6146,16013,55-59,1069,825,1894
6147,16013,60-64,1063,922,1985
6148,16013,65+,2554,2657,5211
6149,16015,15-19,187,232,419
6150,16015,20-24,142,143,285
6151,16015,25-29,153,153,306
6152,16015,30-34,197,197,394
6153,16015,35-39,228,207,435
6154,16015,40-44,235,218,453
6155,16015,45-49,208,226,434
6156,16015,50-54,259,285,544
6157,16015,55-59,355,338,693
6158,16015,60-64,435,453,888
6159,16015,65+,1010,1236,2246
6160,16017,15-19,1229,1409,2638
6161,16017,20-24,950,991,1941
6162,16017,25-29,1058,1129,2187
6163,16017,30-34,1314,1279,2593
6164,16017,35-39,1297,1441,2738
6165,16017,40-44,1519,1455,2974
6166,16017,45-49,1362,1337,2699
6167,16017,50-54,1490,1491,2981
6168,16017,55-59,1794,1760,3554
6169,16017,60-64,2249,2203,4452
6170,16017,65+,6301,6524,12825
6171,16019,15-19,4753,4993,9746
6172,16019,20-24,3685,3827,7512
6173,16019,25-29,4285,4327,8612
6174,16019,30-34,4425,4394,8819
6175,16019,35-39,4472,4537,9009
6176,16019,40-44,4100,4384,8484
6177,16019,45-49,3385,3445,6830
6178,16019,50-54,3066,3196,6262
6179,16019,55-59,3202,3364,6566
6180,16019,60-64,3261,3258,6519
6181,16019,65+,9210,8105,17315
6182,16021,15-19,380,377,757
6183,16021,20-24,287,294,581
6184,16021,25-29,315,322,637
6185,16021,30-34,291,303,594
6186,16021,35-39,358,330,688
6187,16021,40-44,348,374,722
6188,16021,45-49,334,348,682
6189,16021,50-54,362,361,723
6190,16021,55-59,412,414,826
6191,16021,60-64,542,476,1018
6192,16021,65+,1445,1485,2930
6193,16023,15-19,90,97,187
6194,16023,20-24,54,65,119
6195,16023,25-29,51,45,96
6196,16023,30-34,65,60,125
6197,16023,35-39,79,60,139
6198,16023,40-44,88,88,176
6199,16023,45-49,55,72,127
6200,16023,50-54,68,71,139
6201,16023,55-59,79,81,160
6202,16023,60-64,117,124,241
6203,16023,65+,330,337,667
6204,16025,15-19,38,31,69
6205,16025,20-24,19,16,35
6206,16025,25-29,21,17,38
6207,16025,30-34,17,27,44
6208,16025,35-39,34,37,71
6209,16025,40-44,43,39,82
6210,16025,45-49,27,47,74
6211,16025,50-54,45,27,72
6212,16025,55-59,36,46,82
6213,16025,60-64,45,59,104
6214,16025,65+,127,143,270
6215,16027,15-19,8911,9483,18394
6216,16027,20-24,7854,8059,15913
6217,16027,25-29,8388,8498,16886
6218,16027,30-34,8600,8421,17021
6219,16027,35-39,8127,8076,16203
6220,16027,40-44,7784,7940,15724
6221,16027,45-49,6858,7003,13861
6222,16027,50-54,6689,6970,13659
6223,16027,55-59,6880,6647,13527
6224,16027,60-64,6814,6335,13149
6225,16027,65+,18330,16197,34527
6226,16029,15-19,261,265,526
6227,16029,20-24,155,200,355
6228,16029,25-29,176,168,344
6229,16029,30-34,198,202,400
6230,16029,35-39,230,258,488
6231,16029,40-44,249,268,517
6232,16029,45-49,177,200,377
6233,16029,50-54,178,172,350
6234,16029,55-59,199,189,388
6235,16029,60-64,201,224,425
6236,16029,65+,674,619,1293
6237,16031,15-19,996,1132,2128
6238,16031,20-24,741,839,1580
6239,16031,25-29,754,850,1604
6240,16031,30-34,709,763,1472
6241,16031,35-39,755,781,1536
6242,16031,40-44,747,802,1549
6243,16031,45-49,649,684,1333
6244,16031,50-54,560,659,1219
6245,16031,55-59,623,636,1259
6246,16031,60-64,666,709,1375
6247,16031,65+,1933,1775,3708
6248,16033,15-19,27,17,44
6249,16033,20-24,25,24,49
6250,16033,25-29,21,18,39
6251,16033,30-34,23,25,48
6252,16033,35-39,25,32,57
6253,16033,40-44,24,23,47
6254,16033,45-49,21,29,50
6255,16033,50-54,27,19,46
6256,16033,55-59,27,28,55
6257,16033,60-64,11,31,42
6258,16033,65+,73,81,154
6259,16035,15-19,161,279,440
6260,16035,20-24,119,213,332
6261,16035,25-29,190,315,505
6262,16035,30-34,180,299,479
6263,16035,35-39,202,303,505
6264,16035,40-44,213,296,509
6265,16035,45-49,208,282,490
6266,16035,50-54,273,334,607
6267,16035,55-59,328,327,655
6268,16035,60-64,426,415,841
6269,16035,65+,1140,1338,2478
6270,16037,15-19,102,109,211
6271,16037,20-24,63,72,135
6272,16037,25-29,76,84,160
6273,16037,30-34,101,115,216
6274,16037,35-39,117,125,242
6275,16037,40-44,117,126,243
6276,16037,45-49,105,135,240
6277,16037,50-54,130,123,253
6278,16037,55-59,153,157,310
6279,16037,60-64,223,232,455
6280,16037,65+,627,742,1369
6281,16039,15-19,820,952,1772
6282,16039,20-24,1011,1503,2514
6283,16039,25-29,1078,1388,2466
6284,16039,30-34,1062,1224,2286
6285,16039,35-39,892,1027,1919
6286,16039,40-44,750,829,1579
6287,16039,45-49,627,710,1337
6288,16039,50-54,691,702,1393
6289,16039,55-59,848,858,1706
6290,16039,60-64,802,852,1654
6291,16039,65+,2147,2034,4181
6292,16041,15-19,605,725,1330
6293,16041,20-24,386,498,884
6294,16041,25-29,416,411,827
6295,16041,30-34,385,412,797
6296,16041,35-39,424,404,828
6297,16041,40-44,499,514,1013
6298,16041,45-49,430,439,869
6299,16041,50-54,354,397,751
6300,16041,55-59,407,368,775
6301,16041,60-64,391,439,830
6302,16041,65+,1095,1049,2144
6303,16043,15-19,469,560,1029
6304,16043,20-24,414,444,858
6305,16043,25-29,406,457,863
6306,16043,30-34,329,411,740
6307,16043,35-39,400,429,829
6308,16043,40-44,404,502,906
6309,16043,45-49,373,430,803
6310,16043,50-54,373,421,794
6311,16043,55-59,400,462,862
6312,16043,60-64,441,493,934
6313,16043,65+,1177,1241,2418
6314,16045,15-19,542,651,1193
6315,16045,20-24,468,507,975
6316,16045,25-29,479,501,980
6317,16045,30-34,557,590,1147
6318,16045,35-39,567,598,1165
6319,16045,40-44,579,517,1096
6320,16045,45-49,542,516,1058
6321,16045,50-54,553,577,1130
6322,16045,55-59,719,699,1418
6323,16045,60-64,800,791,1591
6324,16045,65+,2251,2179,4430
6325,16047,15-19,559,608,1167
6326,16047,20-24,432,478,910
6327,16047,25-29,470,461,931
6328,16047,30-34,432,516,948
6329,16047,35-39,456,406,862
6330,16047,40-44,434,527,961
6331,16047,45-49,423,488,911
6332,16047,50-54,429,458,887
6333,16047,55-59,438,506,944
6334,16047,60-64,492,457,949
6335,16047,65+,1446,1436,2882
6336,16049,15-19,424,483,907
6337,16049,20-24,304,488,792
6338,16049,25-29,299,451,750
6339,16049,30-34,350,403,753
6340,16049,35-39,419,460,879
6341,16049,40-44,399,479,878
6342,16049,45-49,404,431,835
6343,16049,50-54,450,419,869
6344,16049,55-59,593,580,1173
6345,16049,60-64,786,761,1547
6346,16049,65+,2323,2597,4920
6347,16051,15-19,1357,1427,2784
6348,16051,20-24,857,972,1829
6349,16051,25-29,883,861,1744
6350,16051,30-34,961,997,1958
6351,16051,35-39,1110,1116,2226
6352,16051,40-44,1095,1206,2301
6353,16051,45-49,824,1011,1835
6354,16051,50-54,772,779,1551
6355,16051,55-59,763,829,1592
6356,16051,60-64,850,914,1764
6357,16051,65+,1964,1934,3898
6358,16053,15-19,951,1014,1965
6359,16053,20-24,698,765,1463
6360,16053,25-29,736,803,1539
6361,16053,30-34,785,890,1675
6362,16053,35-39,772,916,1688
6363,16053,40-44,757,811,1568
6364,16053,45-49,602,720,1322
6365,16053,50-54,623,694,1317
6366,16053,55-59,659,755,1414
6367,16053,60-64,690,742,1432
6368,16053,65+,1671,1616,3287
6369,16055,15-19,5163,5672,10835
6370,16055,20-24,4448,4768,9216
6371,16055,25-29,5327,5592,10919
6372,16055,30-34,6072,5966,12038
6373,16055,35-39,6018,5889,11907
6374,16055,40-44,5586,5708,11294
6375,16055,45-49,4967,5145,10112
6376,16055,50-54,5427,5488,10915
6377,16055,55-59,6026,5553,11579
6378,16055,60-64,6431,6068,12499
6379,16055,65+,18565,16441,35006
6380,16057,15-19,1797,1822,3619
6381,16057,20-24,2964,3411,6375
6382,16057,25-29,1457,1693,3150
6383,16057,30-34,1277,1351,2628
6384,16057,35-39,1142,1163,2305
6385,16057,40-44,1032,1114,2146
6386,16057,45-49,907,959,1866
6387,16057,50-54,921,948,1869
6388,16057,55-59,997,1013,2010
6389,16057,60-64,1056,967,2023
6390,16057,65+,3028,2906,5934
6391,16059,15-19,180,238,418
6392,16059,20-24,138,140,278
6393,16059,25-29,175,164,339
6394,16059,30-34,191,196,387
6395,16059,35-39,236,224,460
6396,16059,40-44,202,241,443
6397,16059,45-49,181,172,353
6398,16059,50-54,210,208,418
6399,16059,55-59,293,270,563
6400,16059,60-64,380,372,752
6401,16059,65+,1268,1296,2564
6402,16061,15-19,130,117,247
6403,16061,20-24,65,84,149
6404,16061,25-29,74,71,145
6405,16061,30-34,99,75,174
6406,16061,35-39,102,93,195
6407,16061,40-44,96,109,205
6408,16061,45-49,83,76,159
6409,16061,50-54,100,90,190
6410,16061,55-59,101,124,225
6411,16061,60-64,172,154,326
6412,16061,65+,504,524,1028
6413,16063,15-19,197,216,413
6414,16063,20-24,170,148,318
6415,16063,25-29,174,183,357
6416,16063,30-34,153,170,323
6417,16063,35-39,152,150,302
6418,16063,40-44,178,226,404
6419,16063,45-49,135,179,314
6420,16063,50-54,118,145,263
6421,16063,55-59,152,186,338
6422,16063,60-64,170,162,332
6423,16063,65+,389,399,788
6424,16065,15-19,3620,2446,6066
6425,16065,20-24,5667,6387,12054
6426,16065,25-29,2455,3439,5894
6427,16065,30-34,1180,1337,2517
6428,16065,35-39,1065,1145,2210
6429,16065,40-44,1051,1149,2200
6430,16065,45-49,931,963,1894
6431,16065,50-54,825,825,1650
6432,16065,55-59,830,827,1657
6433,16065,60-64,881,811,1692
6434,16065,65+,2183,1982,4165
6435,16067,15-19,767,831,1598
6436,16067,20-24,650,666,1316
6437,16067,25-29,727,723,1450
6438,16067,30-34,681,680,1361
6439,16067,35-39,648,676,1324
6440,16067,40-44,576,663,1239
6441,16067,45-49,557,601,1158
6442,16067,50-54,527,614,1141
6443,16067,55-59,611,612,1223
6444,16067,60-64,681,668,1349
6445,16067,65+,1872,1674,3546
6446,16069,15-19,1254,1325,2579
6447,16069,20-24,1236,1302,2538
6448,16069,25-29,1267,1323,2590
6449,16069,30-34,1415,1406,2821
6450,16069,35-39,1272,1322,2594
6451,16069,40-44,1260,1208,2468
6452,16069,45-49,1131,1215,2346
6453,16069,50-54,1288,1262,2550
6454,16069,55-59,1402,1311,2713
6455,16069,60-64,1524,1479,3003
6456,16069,65+,4712,4087,8799
6457,16071,15-19,151,184,335
6458,16071,20-24,112,116,228
6459,16071,25-29,102,115,217
6460,16071,30-34,106,99,205
6461,16071,35-39,138,126,264
6462,16071,40-44,154,145,299
6463,16071,45-49,106,127,233
6464,16071,50-54,124,117,241
6465,16071,55-59,133,123,256
6466,16071,60-64,160,183,343
6467,16071,65+,487,495,982
6468,16073,15-19,451,419,870
6469,16073,20-24,344,382,726
6470,16073,25-29,356,394,750
6471,16073,30-34,347,348,695
6472,16073,35-39,368,386,754
6473,16073,40-44,343,369,712
6474,16073,45-49,363,340,703
6475,16073,50-54,377,364,741
6476,16073,55-59,394,401,795
6477,16073,60-64,409,468,877
6478,16073,65+,1076,1114,2190
6479,16075,15-19,825,948,1773
6480,16075,20-24,633,708,1341
6481,16075,25-29,728,768,1496
6482,16075,30-34,809,759,1568
6483,16075,35-39,761,829,1590
6484,16075,40-44,778,771,1549
6485,16075,45-49,738,750,1488
6486,16075,50-54,807,796,1603
6487,16075,55-59,822,824,1646
6488,16075,60-64,885,805,1690
6489,16075,65+,2578,2407,4985
6490,16077,15-19,292,331,623
6491,16077,20-24,187,253,440
6492,16077,25-29,229,207,436
6493,16077,30-34,236,269,505
6494,16077,35-39,239,260,499
6495,16077,40-44,216,226,442
6496,16077,45-49,193,192,385
6497,16077,50-54,163,198,361
6498,16077,55-59,250,235,485
6499,16077,60-64,222,239,461
6500,16077,65+,667,625,1292
6501,16079,15-19,347,361,708
6502,16079,20-24,287,344,631
6503,16079,25-29,373,405,778
6504,16079,30-34,393,409,802
6505,16079,35-39,329,383,712
6506,16079,40-44,374,384,758
6507,16079,45-49,359,379,738
6508,16079,50-54,429,430,859
6509,16079,55-59,474,488,962
6510,16079,60-64,560,568,1128
6511,16079,65+,1610,1549,3159
6512,16081,15-19,331,401,732
6513,16081,20-24,259,307,566
6514,16081,25-29,326,389,715
6515,16081,30-34,403,450,853
6516,16081,35-39,480,458,938
6517,16081,40-44,531,552,1083
6518,16081,45-49,415,548,963
6519,16081,50-54,411,474,885
6520,16081,55-59,391,398,789
6521,16081,60-64,361,414,775
6522,16081,65+,792,878,1670
6523,16083,15-19,3208,3345,6553
6524,16083,20-24,2703,2625,5328
6525,16083,25-29,3083,2926,6009
6526,16083,30-34,3330,3068,6398
6527,16083,35-39,3266,3299,6565
6528,16083,40-44,2896,3050,5946
6529,16083,45-49,2434,2518,4952
6530,16083,50-54,2241,2443,4684
6531,16083,55-59,2549,2512,5061
6532,16083,60-64,2730,2613,5343
6533,16083,65+,7966,6844,14810
6534,16085,15-19,271,288,559
6535,16085,20-24,205,228,433
6536,16085,25-29,258,246,504
6537,16085,30-34,324,332,656
6538,16085,35-39,380,370,750
6539,16085,40-44,402,420,822
6540,16085,45-49,337,400,737
6541,16085,50-54,396,394,790
6542,16085,55-59,433,441,874
6543,16085,60-64,566,521,1087
6544,16085,65+,1512,1759,3271
6545,16087,15-19,401,368,769
6546,16087,20-24,244,272,516
6547,16087,25-29,213,267,480
6548,16087,30-34,258,264,522
6549,16087,35-39,282,269,551
6550,16087,40-44,296,296,592
6551,16087,45-49,289,280,569
6552,16087,50-54,316,302,618
6553,16087,55-59,361,339,700
6554,16087,60-64,434,406,840
6555,16087,65+,1385,1408,2793
6556,17001,15-19,1923,2063,3986
6557,17001,20-24,1753,1820,3573
6558,17001,25-29,1852,1852,3704
6559,17001,30-34,2004,1983,3987
6560,17001,35-39,1992,2001,3993
6561,17001,40-44,1850,1952,3802
6562,17001,45-49,1705,1755,3460
6563,17001,50-54,1970,1868,3838
6564,17001,55-59,2205,2206,4411
6565,17001,60-64,2320,2286,4606
6566,17001,65+,7292,6171,13463
6567,17003,15-19,135,157,292
6568,17003,20-24,97,99,196
6569,17003,25-29,102,129,231
6570,17003,30-34,131,118,249
6571,17003,35-39,110,135,245
6572,17003,40-44,141,131,272
6573,17003,45-49,144,125,269
6574,17003,50-54,165,159,324
6575,17003,55-59,217,202,419
6576,17003,60-64,210,214,424
6577,17003,65+,669,547,1216
6578,17005,15-19,466,503,969
6579,17005,20-24,395,476,871
6580,17005,25-29,403,590,993
6581,17005,30-34,487,735,1222
6582,17005,35-39,513,675,1188
6583,17005,40-44,515,625,1140
6584,17005,45-49,433,548,981
6585,17005,50-54,477,558,1035
6586,17005,55-59,573,601,1174
6587,17005,60-64,621,610,1231
6588,17005,65+,1783,1504,3287
6589,17007,15-19,2001,2120,4121
6590,17007,20-24,1592,1700,3292
6591,17007,25-29,1461,1585,3046
6592,17007,30-34,1454,1430,2884
6593,17007,35-39,1615,1538,3153
6594,17007,40-44,1650,1641,3291
6595,17007,45-49,1694,1758,3452
6596,17007,50-54,1924,1964,3888
6597,17007,55-59,1811,1926,3737
6598,17007,60-64,1687,1721,3408
6599,17007,65+,4677,4146,8823
6600,17009,15-19,118,178,296
6601,17009,20-24,99,453,552
6602,17009,25-29,119,502,621
6603,17009,30-34,120,470,590
6604,17009,35-39,138,446,584
6605,17009,40-44,119,370,489
6606,17009,45-49,123,310,433
6607,17009,50-54,129,265,394
6608,17009,55-59,143,223,366
6609,17009,60-64,147,191,338
6610,17009,65+,493,406,899
6611,17011,15-19,998,1074,2072
6612,17011,20-24,820,882,1702
6613,17011,25-29,861,872,1733
6614,17011,30-34,895,879,1774
6615,17011,35-39,907,1003,1910
6616,17011,40-44,917,974,1891
6617,17011,45-49,931,941,1872
6618,17011,50-54,1065,1056,2121
6619,17011,55-59,1139,1188,2327
6620,17011,60-64,1292,1206,2498
6621,17011,65+,4057,3374,7431
6622,17013,15-19,116,126,242
6623,17013,20-24,84,106,190
6624,17013,25-29,104,95,199
6625,17013,30-34,87,110,197
6626,17013,35-39,113,114,227
6627,17013,40-44,122,115,237
6628,17013,45-49,118,144,262
6629,17013,50-54,154,155,309
6630,17013,55-59,170,175,345
6631,17013,60-64,180,202,382
6632,17013,65+,557,503,1060
6633,17015,15-19,418,473,891
6634,17015,20-24,336,422,758
6635,17015,25-29,367,394,761
6636,17015,30-34,362,425,787
6637,17015,35-39,426,434,860
6638,17015,40-44,423,432,855
6639,17015,45-49,437,457,894
6640,17015,50-54,465,474,939
6641,17015,55-59,532,573,1105
6642,17015,60-64,665,632,1297
6643,17015,65+,2121,1974,4095
6644,17017,15-19,417,435,852
6645,17017,20-24,320,375,695
6646,17017,25-29,363,355,718
6647,17017,30-34,353,329,682
6648,17017,35-39,371,409,780
6649,17017,40-44,372,454,826
6650,17017,45-49,370,399,769
6651,17017,50-54,414,371,785
6652,17017,55-59,412,444,856
6653,17017,60-64,421,429,850
6654,17017,65+,1271,1071,2342
6655,17019,15-19,10060,10457,20517
6656,17019,20-24,15351,17043,32394
6657,17019,25-29,7153,7397,14550
6658,17019,30-34,6555,6714,13269
6659,17019,35-39,6272,6249,12521
6660,17019,40-44,5792,5613,11405
6661,17019,45-49,5073,4945,10018
6662,17019,50-54,4926,4929,9855
6663,17019,55-59,5106,4757,9863
6664,17019,60-64,5551,5093,10644
6665,17019,65+,15654,12619,28273
6666,17021,15-19,910,1030,1940
6667,17021,20-24,814,1038,1852
6668,17021,25-29,903,1128,2031
6669,17021,30-34,926,1108,2034
6670,17021,35-39,916,1148,2064
6671,17021,40-44,952,1143,2095
6672,17021,45-49,891,1140,2031
6673,17021,50-54,1072,1151,2223
6674,17021,55-59,1225,1272,2497
6675,17021,60-64,1194,1310,2504
6676,17021,65+,3810,3099,6909
6677,17023,15-19,442,461,903
6678,17023,20-24,414,388,802
6679,17023,25-29,393,444,837
6680,17023,30-34,443,397,840
6681,17023,35-39,460,453,913
6682,17023,40-44,462,465,927
6683,17023,45-49,408,447,855
6684,17023,50-54,480,508,988
6685,17023,55-59,565,583,1148
6686,17023,60-64,558,591,1149
6687,17023,65+,1692,1385,3077
6688,17025,15-19,387,411,798
6689,17025,20-24,333,326,659
6690,17025,25-29,359,412,771
6691,17025,30-34,395,371,766
6692,17025,35-39,372,366,738
6693,17025,40-44,372,392,764
6694,17025,45-49,370,370,740
6695,17025,50-54,378,471,849
6696,17025,55-59,457,441,898
6697,17025,60-64,476,473,949
6698,17025,65+,1497,1239,2736
6699,17027,15-19,968,1123,2091
6700,17027,20-24,897,1116,2013
6701,17027,25-29,984,1317,2301
6702,17027,30-34,1080,1284,2364
6703,17027,35-39,1161,1451,2612
6704,17027,40-44,1040,1362,2402
6705,17027,45-49,989,1125,2114
6706,17027,50-54,1107,1259,2366
6707,17027,55-59,1353,1359,2712
6708,17027,60-64,1313,1392,2705
6709,17027,65+,3545,3108,6653
6710,17029,15-19,1959,1775,3734
6711,17029,20-24,2950,2750,5700
6712,17029,25-29,1422,1467,2889
6713,17029,30-34,1521,1461,2982
6714,17029,35-39,1336,1368,2704
6715,17029,40-44,1272,1326,2598
6716,17029,45-49,1179,1285,2464
6717,17029,50-54,1274,1290,2564
6718,17029,55-59,1401,1321,2722
6719,17029,60-64,1582,1536,3118
6720,17029,65+,4622,3689,8311
6721,17031,15-19,155859,160031,315890
6722,17031,20-24,161260,155843,317103
6723,17031,25-29,205306,199909,405215
6724,17031,30-34,203970,204527,408497
6725,17031,35-39,188118,188852,376970
6726,17031,40-44,173215,172010,345225
6727,17031,45-49,160272,157661,317933
6728,17031,50-54,162959,160266,323225
6729,17031,55-59,163573,157892,321465
6730,17031,60-64,164755,152299,317054
6731,17031,65+,458578,348608,807186
6732,17033,15-19,482,511,993
6733,17033,20-24,422,574,996
6734,17033,25-29,496,741,1237
6735,17033,30-34,530,730,1260
6736,17033,35-39,541,753,1294
6737,17033,40-44,499,732,1231
6738,17033,45-49,503,647,1150
6739,17033,50-54,508,624,1132
6740,17033,55-59,625,673,1298
6741,17033,60-64,644,699,1343
6742,17033,65+,2002,1631,3633
6743,17035,15-19,298,327,625
6744,17035,20-24,251,237,488
6745,17035,25-29,254,257,511
6746,17035,30-34,289,305,594
6747,17035,35-39,320,314,634
6748,17035,40-44,324,321,645
6749,17035,45-49,277,310,587
6750,17035,50-54,302,338,640
6751,17035,55-59,342,377,719
6752,17035,60-64,425,412,837
6753,17035,65+,1142,1014,2156
6754,17037,15-19,4414,4484,8898
6755,17037,20-24,7013,6916,13929
6756,17037,25-29,3529,3428,6957
6757,17037,30-34,3072,3127,6199
6758,17037,35-39,2932,3061,5993
6759,17037,40-44,2826,2904,5730
6760,17037,45-49,2468,2567,5035
6761,17037,50-54,2606,2692,5298
6762,17037,55-59,2838,2753,5591
6763,17037,60-64,2763,2798,5561
6764,17037,65+,7215,6122,13337
6765,17039,15-19,438,476,914
6766,17039,20-24,403,397,800
6767,17039,25-29,408,407,815
6768,17039,30-34,427,465,892
6769,17039,35-39,465,481,946
6770,17039,40-44,468,485,953
6771,17039,45-49,442,458,900
6772,17039,50-54,485,529,1014
6773,17039,55-59,588,587,1175
6774,17039,60-64,582,612,1194
6775,17039,65+,1657,1417,3074
6776,17041,15-19,638,698,1336
6777,17041,20-24,558,619,1177
6778,17041,25-29,573,607,1180
6779,17041,30-34,599,636,1235
6780,17041,35-39,610,584,1194
6781,17041,40-44,590,592,1182
6782,17041,45-49,557,571,1128
6783,17041,50-54,548,575,1123
6784,17041,55-59,580,608,1188
6785,17041,60-64,659,685,1344
6786,17041,65+,2004,1666,3670
6787,17043,15-19,29591,31231,60822
6788,17043,20-24,27101,27612,54713
6789,17043,25-29,27340,28202,55542
6790,17043,30-34,28571,29187,57758
6791,17043,35-39,31498,32581,64079
6792,17043,40-44,30619,31073,61692
6793,17043,45-49,28443,28410,56853
6794,17043,50-54,31258,30672,61930
6795,17043,55-59,32779,31556,64335
6796,17043,60-64,32552,30798,63350
6797,17043,65+,85128,70224,155352
6798,17045,15-19,469,488,957
6799,17045,20-24,391,423,814
6800,17045,25-29,413,417,830
6801,17045,30-34,447,470,917
6802,17045,35-39,499,485,984
6803,17045,40-44,518,495,1013
6804,17045,45-49,485,527,1012
6805,17045,50-54,483,541,1024
6806,17045,55-59,564,577,1141
6807,17045,60-64,686,663,1349
6808,17045,65+,2105,1730,3835
6809,17047,15-19,172,209,381
6810,17047,20-24,146,140,286
6811,17047,25-29,146,142,288
6812,17047,30-34,145,156,301
6813,17047,35-39,160,168,328
6814,17047,40-44,187,186,373
6815,17047,45-49,180,187,367
6816,17047,50-54,198,208,406
6817,17047,55-59,193,223,416
6818,17047,60-64,226,229,455
6819,17047,65+,782,598,1380
6820,17049,15-19,997,1106,2103
6821,17049,20-24,897,975,1872
6822,17049,25-29,1002,1121,2123
6823,17049,30-34,1061,1117,2178
6824,17049,35-39,1019,1174,2193
6825,17049,40-44,988,1032,2020
6826,17049,45-49,883,922,1805
6827,17049,50-54,974,1012,1986
6828,17049,55-59,1213,1210,2423
6829,17049,60-64,1254,1262,2516
6830,17049,65+,3454,2942,6396
6831,17051,15-19,589,676,1265
6832,17051,20-24,492,786,1278
6833,17051,25-29,557,812,1369
6834,17051,30-34,618,736,1354
6835,17051,35-39,582,745,1327
6836,17051,40-44,606,804,1410
6837,17051,45-49,573,750,1323
6838,17051,50-54,585,718,1303
6839,17051,55-59,660,757,1417
6840,17051,60-64,735,772,1507
6841,17051,65+,2230,1950,4180
6842,17053,15-19,428,449,877
6843,17053,20-24,355,383,738
6844,17053,25-29,363,382,745
6845,17053,30-34,394,406,800
6846,17053,35-39,426,418,844
6847,17053,40-44,386,417,803
6848,17053,45-49,369,397,766
6849,17053,50-54,415,425,840
6850,17053,55-59,452,423,875
6851,17053,60-64,510,526,1036
6852,17053,65+,1503,1169,2672
6853,17055,15-19,1073,1171,2244
6854,17055,20-24,938,992,1930
6855,17055,25-29,1013,1111,2124
6856,17055,30-34,1040,1086,2126
6857,17055,35-39,1052,1051,2103
6858,17055,40-44,1149,1093,2242
6859,17055,45-49,1175,1144,2319
6860,17055,50-54,1222,1257,2479
6861,17055,55-59,1337,1276,2613
6862,17055,60-64,1316,1329,2645
6863,17055,65+,4300,3515,7815
6864,17057,15-19,879,1004,1883
6865,17057,20-24,778,1124,1902
6866,17057,25-29,805,1220,2025
6867,17057,30-34,835,1146,1981
6868,17057,35-39,873,1254,2127
6869,17057,40-44,968,1245,2213
6870,17057,45-49,914,1179,2093
6871,17057,50-54,947,1186,2133
6872,17057,55-59,1106,1165,2271
6873,17057,60-64,1189,1161,2350
6874,17057,65+,3815,3214,7029
6875,17059,15-19,143,141,284
6876,17059,20-24,100,105,205
6877,17059,25-29,127,125,252
6878,17059,30-34,115,132,247
6879,17059,35-39,138,143,281
6880,17059,40-44,146,141,287
6881,17059,45-49,155,169,324
6882,17059,50-54,146,160,306
6883,17059,55-59,174,202,376
6884,17059,60-64,186,161,347
6885,17059,65+,644,554,1198
6886,17061,15-19,363,357,720
6887,17061,20-24,291,321,612
6888,17061,25-29,288,365,653
6889,17061,30-34,306,366,672
6890,17061,35-39,316,366,682
6891,17061,40-44,331,392,723
6892,17061,45-49,323,387,710
6893,17061,50-54,402,396,798
6894,17061,55-59,464,469,933
6895,17061,60-64,441,447,888
6896,17061,65+,1272,1116,2388
6897,17063,15-19,1750,1972,3722
6898,17063,20-24,1529,1518,3047
6899,17063,25-29,1548,1632,3180
6900,17063,30-34,1677,1647,3324
6901,17063,35-39,1845,1807,3652
6902,17063,40-44,1883,1917,3800
6903,17063,45-49,1674,1692,3366
6904,17063,50-54,1802,1872,3674
6905,17063,55-59,1698,1782,3480
6906,17063,60-64,1613,1650,3263
6907,17063,65+,4241,3614,7855
6908,17065,15-19,242,250,492
6909,17065,20-24,193,186,379
6910,17065,25-29,209,225,434
6911,17065,30-34,230,210,440
6912,17065,35-39,217,251,468
6913,17065,40-44,238,225,463
6914,17065,45-49,236,221,457
6915,17065,50-54,229,241,470
6916,17065,55-59,259,294,553
6917,17065,60-64,288,300,588
6918,17065,65+,968,785,1753
6919,17067,15-19,503,503,1006
6920,17067,20-24,392,414,806
6921,17067,25-29,425,470,895
6922,17067,30-34,429,452,881
6923,17067,35-39,490,499,989
6924,17067,40-44,506,466,972
6925,17067,45-49,442,493,935
6926,17067,50-54,505,545,1050
6927,17067,55-59,645,624,1269
6928,17067,60-64,663,710,1373
6929,17067,65+,2250,1954,4204
6930,17069,15-19,96,92,188
6931,17069,20-24,79,90,169
6932,17069,25-29,87,77,164
6933,17069,30-34,89,82,171
6934,17069,35-39,83,105,188
6935,17069,40-44,101,101,202
6936,17069,45-49,101,120,221
6937,17069,50-54,120,136,256
6938,17069,55-59,145,150,295
6939,17069,60-64,142,150,292
6940,17069,65+,505,490,995
6941,17071,15-19,156,142,298
6942,17071,20-24,125,144,269
6943,17071,25-29,145,147,292
6944,17071,30-34,155,156,311
6945,17071,35-39,156,167,323
6946,17071,40-44,152,176,328
6947,17071,45-49,182,168,350
6948,17071,50-54,209,188,397
6949,17071,55-59,240,253,493
6950,17071,60-64,275,299,574
6951,17071,65+,894,806,1700
6952,17073,15-19,1447,1746,3193
6953,17073,20-24,1100,1266,2366
6954,17073,25-29,1202,1291,2493
6955,17073,30-34,1380,1343,2723
6956,17073,35-39,1426,1483,2909
6957,17073,40-44,1544,1593,3137
6958,17073,45-49,1462,1522,2984
6959,17073,50-54,1563,1534,3097
6960,17073,55-59,1670,1666,3336
6961,17073,60-64,1857,1835,3692
6962,17073,65+,5534,4816,10350
6963,17075,15-19,782,910,1692
6964,17075,20-24,646,721,1367
6965,17075,25-29,662,722,1384
6966,17075,30-34,672,722,1394
6967,17075,35-39,781,729,1510
6968,17075,40-44,816,771,1587
6969,17075,45-49,722,807,1529
6970,17075,50-54,814,767,1581
6971,17075,55-59,979,965,1944
6972,17075,60-64,1094,1034,2128
6973,17075,65+,3272,2721,5993
6974,17077,15-19,2189,2262,4451
6975,17077,20-24,4066,4351,8417
6976,17077,25-29,1734,1772,3506
6977,17077,30-34,1562,1553,3115
6978,17077,35-39,1367,1416,2783
6979,17077,40-44,1286,1352,2638
6980,17077,45-49,1176,1276,2452
6981,17077,50-54,1261,1211,2472
6982,17077,55-59,1409,1364,2773
6983,17077,60-64,1517,1449,2966
6984,17077,65+,4775,3996,8771
6985,17079,15-19,261,286,547
6986,17079,20-24,219,229,448
6987,17079,25-29,260,207,467
6988,17079,30-34,242,235,477
6989,17079,35-39,246,295,541
6990,17079,40-44,268,300,568
6991,17079,45-49,227,259,486
6992,17079,50-54,285,268,553
6993,17079,55-59,363,387,750
6994,17079,60-64,334,377,711
6995,17079,65+,998,906,1904
6996,17081,15-19,1027,1103,2130
6997,17081,20-24,849,1123,1972
6998,17081,25-29,1026,1345,2371
6999,17081,30-34,1027,1274,2301
7000,17081,35-39,1044,1241,2285
7001,17081,40-44,1029,1325,2354
7002,17081,45-49,1003,1212,2215
7003,17081,50-54,1101,1232,2333
7004,17081,55-59,1195,1290,2485
7005,17081,60-64,1237,1231,2468
7006,17081,65+,3845,3297,7142
7007,17083,15-19,723,697,1420
7008,17083,20-24,692,721,1413
7009,17083,25-29,561,563,1124
7010,17083,30-34,584,565,1149
7011,17083,35-39,625,647,1272
7012,17083,40-44,629,644,1273
7013,17083,45-49,576,627,1203
7014,17083,50-54,702,700,1402
7015,17083,55-59,837,790,1627
7016,17083,60-64,854,849,1703
7017,17083,65+,2326,1954,4280
7018,17085,15-19,544,649,1193
7019,17085,20-24,445,553,998
7020,17085,25-29,464,508,972
7021,17085,30-34,461,486,947
7022,17085,35-39,553,572,1125
7023,17085,40-44,524,564,1088
7024,17085,45-49,565,576,1141
7025,17085,50-54,641,675,1316
7026,17085,55-59,806,794,1600
7027,17085,60-64,960,970,1930
7028,17085,65+,3339,3078,6417
7029,17087,15-19,332,409,741
7030,17087,20-24,234,530,764
7031,17087,25-29,303,553,856
7032,17087,30-34,319,589,908
7033,17087,35-39,343,517,860
7034,17087,40-44,341,525,866
7035,17087,45-49,308,520,828
7036,17087,50-54,359,511,870
7037,17087,55-59,443,487,930
7038,17087,60-64,492,513,1005
7039,17087,65+,1470,1412,2882
7040,17089,15-19,18651,19804,38455
7041,17089,20-24,16110,16671,32781
7042,17089,25-29,14824,15529,30353
7043,17089,30-34,15199,15669,30868
7044,17089,35-39,16296,17294,33590
7045,17089,40-44,17155,17736,34891
7046,17089,45-49,16934,17129,34063
7047,17089,50-54,17677,18224,35901
7048,17089,55-59,17280,17654,34934
7049,17089,60-64,15976,15952,31928
7050,17089,65+,41725,34904,76629
7051,17091,15-19,4057,4079,8136
7052,17091,20-24,4030,4009,8039
7053,17091,25-29,3259,3331,6590
7054,17091,30-34,3180,3223,6403
7055,17091,35-39,3128,3170,6298
7056,17091,40-44,3235,3216,6451
7057,17091,45-49,3083,3072,6155
7058,17091,50-54,3280,3406,6686
7059,17091,55-59,3469,3451,6920
7060,17091,60-64,3490,3443,6933
7061,17091,65+,9900,8518,18418
7062,17093,15-19,5113,5550,10663
7063,17093,20-24,3844,3991,7835
7064,17093,25-29,3759,3725,7484
7065,17093,30-34,4555,4424,8979
7066,17093,35-39,5395,5360,10755
7067,17093,40-44,5505,5403,10908
7068,17093,45-49,5008,5053,10061
7069,17093,50-54,4532,4820,9352
7070,17093,55-59,3691,3906,7597
7071,17093,60-64,3244,3144,6388
7072,17093,65+,8188,6542,14730
7073,17095,15-19,1559,1573,3132
7074,17095,20-24,1517,1786,3303
7075,17095,25-29,1211,1632,2843
7076,17095,30-34,1278,1629,2907
7077,17095,35-39,1263,1565,2828
7078,17095,40-44,1332,1601,2933
7079,17095,45-49,1246,1460,2706
7080,17095,50-54,1367,1475,2842
7081,17095,55-59,1651,1607,3258
7082,17095,60-64,1750,1709,3459
7083,17095,65+,5969,4961,10930
7084,17097,15-19,25806,29132,54938
7085,17097,20-24,22706,26798,49504
7086,17097,25-29,19476,21348,40824
7087,17097,30-34,19173,19868,39041
7088,17097,35-39,22138,22335,44473
7089,17097,40-44,23087,23499,46586
7090,17097,45-49,22697,22819,45516
7091,17097,50-54,24546,24667,49213
7092,17097,55-59,25118,24849,49967
7093,17097,60-64,23914,23593,47507
7094,17097,65+,59016,50297,109313
7095,17099,15-19,3214,3555,6769
7096,17099,20-24,2927,3440,6367
7097,17099,25-29,3005,3468,6473
7098,17099,30-34,3052,3459,6511
7099,17099,35-39,3208,3622,6830
7100,17099,40-44,3162,3530,6692
7101,17099,45-49,2928,3260,6188
7102,17099,50-54,3400,3516,6916
7103,17099,55-59,3873,3970,7843
7104,17099,60-64,4139,4203,8342
7105,17099,65+,11487,9853,21340
7106,17101,15-19,344,458,802
7107,17101,20-24,291,722,1013
7108,17101,25-29,362,838,1200
7109,17101,30-34,369,746,1115
7110,17101,35-39,377,710,1087
7111,17101,40-44,401,670,1071
7112,17101,45-49,366,608,974
7113,17101,50-54,376,549,925
7114,17101,55-59,461,495,956
7115,17101,60-64,527,478,1005
7116,17101,65+,1484,1195,2679
7117,17103,15-19,915,968,1883
7118,17103,20-24,785,980,1765
7119,17103,25-29,911,1244,2155
7120,17103,30-34,876,1298,2174
7121,17103,35-39,819,1272,2091
7122,17103,40-44,899,1326,2225
7123,17103,45-49,869,1158,2027
7124,17103,50-54,1019,1240,2259
7125,17103,55-59,1112,1308,2420
7126,17103,60-64,1191,1417,2608
7127,17103,65+,3663,3302,6965
7128,17105,15-19,979,1183,2162
7129,17105,20-24,964,1114,2078
7130,17105,25-29,1075,1101,2176
7131,17105,30-34,1064,1173,2237
7132,17105,35-39,1126,1151,2277
7133,17105,40-44,1024,1133,2157
7134,17105,45-49,933,1076,2009
7135,17105,50-54,1037,1104,2141
7136,17105,55-59,1217,1223,2440
7137,17105,60-64,1301,1378,2679
7138,17105,65+,3770,3193,6963
7139,17107,15-19,869,969,1838
7140,17107,20-24,867,1069,1936
7141,17107,25-29,869,1114,1983
7142,17107,30-34,877,1084,1961
7143,17107,35-39,873,1078,1951
7144,17107,40-44,932,1001,1933
7145,17107,45-49,791,810,1601
7146,17107,50-54,795,874,1669
7147,17107,55-59,844,865,1709
7148,17107,60-64,918,934,1852
7149,17107,65+,2887,2295,5182
7150,17109,15-19,1413,1224,2637
7151,17109,20-24,2115,2220,4335
7152,17109,25-29,652,750,1402
7153,17109,30-34,655,784,1439
7154,17109,35-39,731,694,1425
7155,17109,40-44,653,641,1294
7156,17109,45-49,591,622,1213
7157,17109,50-54,628,620,1248
7158,17109,55-59,734,751,1485
7159,17109,60-64,844,814,1658
7160,17109,65+,2726,2178,4904
7161,17111,15-19,10382,11080,21462
7162,17111,20-24,8634,9287,17921
7163,17111,25-29,8536,8962,17498
7164,17111,30-34,9192,9535,18727
7165,17111,35-39,9784,10335,20119
7166,17111,40-44,9911,10399,20310
7167,17111,45-49,9860,9842,19702
7168,17111,50-54,11482,11507,22989
7169,17111,55-59,11831,11941,23772
7170,17111,60-64,11124,11068,22192
7171,17111,65+,26519,22803,49322
7172,17113,15-19,7887,6992,14879
7173,17113,20-24,11015,10308,21323
7174,17113,25-29,5520,5630,11150
7175,17113,30-34,5202,5145,10347
7176,17113,35-39,5296,5344,10640
7177,17113,40-44,5163,5203,10366
7178,17113,45-49,4536,4590,9126
7179,17113,50-54,4812,4716,9528
7180,17113,55-59,5081,4860,9941
7181,17113,60-64,4892,4676,9568
7182,17113,65+,13390,10870,24260
7183,17115,15-19,3286,3317,6603
7184,17115,20-24,3207,2960,6167
7185,17115,25-29,3176,2857,6033
7186,17115,30-34,3163,2920,6083
7187,17115,35-39,3048,2774,5822
7188,17115,40-44,3184,2884,6068
7189,17115,45-49,3023,2791,5814
7190,17115,50-54,2879,2847,5726
7191,17115,55-59,3408,3186,6594
7192,17115,60-64,3696,3479,7175
7193,17115,65+,11863,9422,21285
7194,17117,15-19,1301,1459,2760
7195,17117,20-24,1179,1254,2433
7196,17117,25-29,1125,1116,2241
7197,17117,30-34,1265,1159,2424
7198,17117,35-39,1339,1350,2689
7199,17117,40-44,1387,1364,2751
7200,17117,45-49,1303,1313,2616
7201,17117,50-54,1372,1435,2807
7202,17117,55-59,1704,1608,3312
7203,17117,60-64,1725,1736,3461
7204,17117,65+,5124,4298,9422
7205,17119,15-19,7984,8473,16457
7206,17119,20-24,7586,7512,15098
7207,17119,25-29,8162,8127,16289
7208,17119,30-34,9027,8820,17847
7209,17119,35-39,8754,8654,17408
7210,17119,40-44,8483,8020,16503
7211,17119,45-49,7938,7596,15534
7212,17119,50-54,8373,8375,16748
7213,17119,55-59,9312,9105,18417
7214,17119,60-64,9707,9485,19192
7215,17119,65+,26662,21228,47890
7216,17121,15-19,1038,1177,2215
7217,17121,20-24,950,943,1893
7218,17121,25-29,1076,1108,2184
7219,17121,30-34,1103,1130,2233
7220,17121,35-39,1051,1076,2127
7221,17121,40-44,1075,1118,2193
7222,17121,45-49,1042,1095,2137
7223,17121,50-54,1119,1106,2225
7224,17121,55-59,1300,1299,2599
7225,17121,60-64,1425,1278,2703
7226,17121,65+,4132,3410,7542
7227,17123,15-19,298,323,621
7228,17123,20-24,256,300,556
7229,17123,25-29,353,338,691
7230,17123,30-34,277,334,611
7231,17123,35-39,315,320,635
7232,17123,40-44,298,348,646
7233,17123,45-49,308,321,629
7234,17123,50-54,356,372,728
7235,17123,55-59,460,423,883
7236,17123,60-64,445,469,914
7237,17123,65+,1511,1284,2795
7238,17125,15-19,424,374,798
7239,17125,20-24,336,335,671
7240,17125,25-29,314,346,660
7241,17125,30-34,322,347,669
7242,17125,35-39,351,320,671
7243,17125,40-44,387,404,791
7244,17125,45-49,394,408,802
7245,17125,50-54,376,422,798
7246,17125,55-59,485,485,970
7247,17125,60-64,491,482,973
7248,17125,65+,1553,1377,2930
7249,17127,15-19,428,424,852
7250,17127,20-24,368,354,722
7251,17127,25-29,342,354,696
7252,17127,30-34,344,352,696
7253,17127,35-39,384,357,741
7254,17127,40-44,464,399,863
7255,17127,45-49,446,422,868
7256,17127,50-54,462,505,967
7257,17127,55-59,493,525,1018
7258,17127,60-64,579,524,1103
7259,17127,65+,1690,1327,3017
7260,17129,15-19,354,388,742
7261,17129,20-24,258,294,552
7262,17129,25-29,317,289,606
7263,17129,30-34,387,342,729
7264,17129,35-39,385,356,741
7265,17129,40-44,388,409,797
7266,17129,45-49,337,357,694
7267,17129,50-54,397,368,765
7268,17129,55-59,502,475,977
7269,17129,60-64,462,479,941
7270,17129,65+,1350,1139,2489
7271,17131,15-19,469,479,948
7272,17131,20-24,353,421,774
7273,17131,25-29,345,401,746
7274,17131,30-34,403,442,845
7275,17131,35-39,486,465,951
7276,17131,40-44,487,488,975
7277,17131,45-49,440,478,918
7278,17131,50-54,531,486,1017
7279,17131,55-59,585,578,1163
7280,17131,60-64,553,622,1175
7281,17131,65+,1771,1656,3427
7282,17133,15-19,997,1086,2083
7283,17133,20-24,797,895,1692
7284,17133,25-29,786,884,1670
7285,17133,30-34,992,904,1896
7286,17133,35-39,1203,1159,2362
7287,17133,40-44,1160,1255,2415
7288,17133,45-49,1006,1072,2078
7289,17133,50-54,1216,1137,2353
7290,17133,55-59,1332,1298,2630
7291,17133,60-64,1400,1424,2824
7292,17133,65+,3533,3096,6629
7293,17135,15-19,731,848,1579
7294,17135,20-24,590,952,1542
7295,17135,25-29,668,1055,1723
7296,17135,30-34,669,1065,1734
7297,17135,35-39,780,1073,1853
7298,17135,40-44,728,1045,1773
7299,17135,45-49,683,933,1616
7300,17135,50-54,778,952,1730
7301,17135,55-59,1018,995,2013
7302,17135,60-64,1044,1030,2074
7303,17135,65+,3139,2650,5789
7304,17137,15-19,964,1158,2122
7305,17137,20-24,1129,1181,2310
7306,17137,25-29,854,1080,1934
7307,17137,30-34,914,1143,2057
7308,17137,35-39,910,1237,2147
7309,17137,40-44,920,1078,1998
7310,17137,45-49,841,977,1818
7311,17137,50-54,933,1014,1947
7312,17137,55-59,1129,1115,2244
7313,17137,60-64,1204,1145,2349
7314,17137,65+,3674,2957,6631
7315,17139,15-19,490,528,1018
7316,17139,20-24,340,421,761
7317,17139,25-29,384,402,786
7318,17139,30-34,434,391,825
7319,17139,35-39,441,449,890
7320,17139,40-44,464,434,898
7321,17139,45-49,416,404,820
7322,17139,50-54,406,435,841
7323,17139,55-59,498,453,951
7324,17139,60-64,500,496,996
7325,17139,65+,1514,1214,2728
7326,17141,15-19,1595,1666,3261
7327,17141,20-24,1371,1394,2765
7328,17141,25-29,1394,1480,2874
7329,17141,30-34,1490,1497,2987
7330,17141,35-39,1566,1584,3150
7331,17141,40-44,1501,1583,3084
7332,17141,45-49,1466,1509,2975
7333,17141,50-54,1709,1740,3449
7334,17141,55-59,1822,1943,3765
7335,17141,60-64,1958,1899,3857
7336,17141,65+,5257,4701,9958
7337,17143,15-19,5857,5986,11843
7338,17143,20-24,5652,5319,10971
7339,17143,25-29,5933,5780,11713
7340,17143,30-34,6021,5767,11788
7341,17143,35-39,5732,5602,11334
7342,17143,40-44,5458,5525,10983
7343,17143,45-49,5162,4882,10044
7344,17143,50-54,5492,5241,10733
7345,17143,55-59,5476,5317,10793
7346,17143,60-64,5929,5261,11190
7347,17143,65+,17904,14278,32182
7348,17145,15-19,536,738,1274
7349,17145,20-24,383,1022,1405
7350,17145,25-29,488,945,1433
7351,17145,30-34,509,970,1479
7352,17145,35-39,543,851,1394
7353,17145,40-44,549,811,1360
7354,17145,45-49,586,749,1335
7355,17145,50-54,558,719,1277
7356,17145,55-59,661,748,1409
7357,17145,60-64,671,684,1355
7358,17145,65+,2187,1856,4043
7359,17147,15-19,473,543,1016
7360,17147,20-24,387,413,800
7361,17147,25-29,409,466,875
7362,17147,30-34,504,468,972
7363,17147,35-39,559,556,1115
7364,17147,40-44,511,542,1053
7365,17147,45-49,487,502,989
7366,17147,50-54,479,509,988
7367,17147,55-59,612,590,1202
7368,17147,60-64,635,659,1294
7369,17147,65+,1807,1592,3399
7370,17149,15-19,402,458,860
7371,17149,20-24,335,402,737
7372,17149,25-29,393,446,839
7373,17149,30-34,414,424,838
7374,17149,35-39,427,477,904
7375,17149,40-44,398,412,810
7376,17149,45-49,381,416,797
7377,17149,50-54,449,466,915
7378,17149,55-59,491,477,968
7379,17149,60-64,531,504,1035
7380,17149,65+,1711,1434,3145
7381,17151,15-19,89,139,228
7382,17151,20-24,81,130,211
7383,17151,25-29,77,88,165
7384,17151,30-34,74,63,137
7385,17151,35-39,94,92,186
7386,17151,40-44,98,104,202
7387,17151,45-49,103,105,208
7388,17151,50-54,129,134,263
7389,17151,55-59,179,195,374
7390,17151,60-64,192,193,385
7391,17151,65+,562,553,1115
7392,17153,15-19,161,167,328
7393,17153,20-24,129,123,252
7394,17153,25-29,116,135,251
7395,17153,30-34,141,147,288
7396,17153,35-39,151,128,279
7397,17153,40-44,136,147,283
7398,17153,45-49,166,127,293
7399,17153,50-54,136,138,274
7400,17153,55-59,169,172,341
7401,17153,60-64,231,196,427
7402,17153,65+,633,572,1205
7403,17155,15-19,159,163,322
7404,17155,20-24,120,146,266
7405,17155,25-29,126,135,261
7406,17155,30-34,145,148,293
7407,17155,35-39,171,164,335
7408,17155,40-44,150,175,325
7409,17155,45-49,136,135,271
7410,17155,50-54,183,182,365
7411,17155,55-59,214,222,436
7412,17155,60-64,231,250,481
7413,17155,65+,662,659,1321
7414,17157,15-19,727,879,1606
7415,17157,20-24,624,1101,1725
7416,17157,25-29,683,1347,2030
7417,17157,30-34,723,1387,2110
7418,17157,35-39,751,1320,2071
7419,17157,40-44,800,1240,2040
7420,17157,45-49,736,1147,1883
7421,17157,50-54,754,1102,1856
7422,17157,55-59,920,1206,2126
7423,17157,60-64,999,1136,2135
7424,17157,65+,3217,2599,5816
7425,17159,15-19,457,515,972
7426,17159,20-24,358,393,751
7427,17159,25-29,427,446,873
7428,17159,30-34,454,461,915
7429,17159,35-39,492,467,959
7430,17159,40-44,446,489,935
7431,17159,45-49,450,433,883
7432,17159,50-54,463,486,949
7433,17159,55-59,554,534,1088
7434,17159,60-64,593,568,1161
7435,17159,65+,1824,1493,3317
7436,17161,15-19,4461,4756,9217
7437,17161,20-24,4238,4449,8687
7438,17161,25-29,4297,4265,8562
7439,17161,30-34,4325,4428,8753
7440,17161,35-39,4158,4500,8658
7441,17161,40-44,4195,4492,8687
7442,17161,45-49,3905,4073,7978
7443,17161,50-54,4078,4224,8302
7444,17161,55-59,4505,4450,8955
7445,17161,60-64,5027,4697,9724
7446,17161,65+,15900,12943,28843
7447,17163,15-19,7746,8199,15945
7448,17163,20-24,7104,7434,14538
7449,17163,25-29,8009,7859,15868
7450,17163,30-34,8599,7869,16468
7451,17163,35-39,8930,8272,17202
7452,17163,40-44,8528,7995,16523
7453,17163,45-49,7803,7221,15024
7454,17163,50-54,8220,7362,15582
7455,17163,55-59,9065,8576,17641
7456,17163,60-64,9201,8514,17715
7457,17163,65+,24156,18883,43039
7458,17165,15-19,587,910,1497
7459,17165,20-24,563,603,1166
7460,17165,25-29,672,671,1343
7461,17165,30-34,719,674,1393
7462,17165,35-39,698,679,1377
7463,17165,40-44,701,672,1373
7464,17165,45-49,678,655,1333
7465,17165,50-54,761,803,1564
7466,17165,55-59,872,842,1714
7467,17165,60-64,893,814,1707
7468,17165,65+,2656,2212,4868
7469,17167,15-19,5959,6299,12258
7470,17167,20-24,5678,5590,11268
7471,17167,25-29,5978,5603,11581
7472,17167,30-34,6304,5756,12060
7473,17167,35-39,6615,6071,12686
7474,17167,40-44,6269,6067,12336
7475,17167,45-49,5773,5504,11277
7476,17167,50-54,6270,6059,12329
7477,17167,55-59,6940,6658,13598
7478,17167,60-64,7106,6579,13685
7479,17167,65+,20831,15769,36600
7480,17169,15-19,181,165,346
7481,17169,20-24,142,156,298
7482,17169,25-29,134,197,331
7483,17169,30-34,178,227,405
7484,17169,35-39,189,245,434
7485,17169,40-44,170,282,452
7486,17169,45-49,189,250,439
7487,17169,50-54,189,294,483
7488,17169,55-59,233,274,507
7489,17169,60-64,245,260,505
7490,17169,65+,840,772,1612
7491,17171,15-19,131,164,295
7492,17171,20-24,137,132,269
7493,17171,25-29,137,129,266
7494,17171,30-34,126,115,241
7495,17171,35-39,145,127,272
7496,17171,40-44,140,160,300
7497,17171,45-49,154,136,290
7498,17171,50-54,144,161,305
7499,17171,55-59,206,183,389
7500,17171,60-64,182,231,413
7501,17171,65+,536,451,987
7502,17173,15-19,541,663,1204
7503,17173,20-24,487,460,947
7504,17173,25-29,538,550,1088
7505,17173,30-34,558,546,1104
7506,17173,35-39,585,623,1208
7507,17173,40-44,565,635,1200
7508,17173,45-49,562,590,1152
7509,17173,50-54,630,635,1265
7510,17173,55-59,772,749,1521
7511,17173,60-64,799,792,1591
7512,17173,65+,2553,2309,4862
7513,17175,15-19,139,154,293
7514,17175,20-24,143,152,295
7515,17175,25-29,136,141,277
7516,17175,30-34,122,135,257
7517,17175,35-39,127,153,280
7518,17175,40-44,163,160,323
7519,17175,45-49,136,167,303
7520,17175,50-54,185,161,346
7521,17175,55-59,177,198,375
7522,17175,60-64,177,211,388
7523,17175,65+,640,577,1217
7524,17177,15-19,1260,1356,2616
7525,17177,20-24,1139,1171,2310
7526,17177,25-29,1166,1140,2306
7527,17177,30-34,1140,1137,2277
7528,17177,35-39,1217,1170,2387
7529,17177,40-44,1165,1178,2343
7530,17177,45-49,1155,1147,2302
7531,17177,50-54,1379,1393,2772
7532,17177,55-59,1621,1571,3192
7533,17177,60-64,1723,1705,3428
7534,17177,65+,5735,4679,10414
7535,17179,15-19,4016,4185,8201
7536,17179,20-24,3177,3448,6625
7537,17179,25-29,3611,3736,7347
7538,17179,30-34,3864,4021,7885
7539,17179,35-39,4250,4382,8632
7540,17179,40-44,4237,4444,8681
7541,17179,45-49,3994,4015,8009
7542,17179,50-54,4099,4161,8260
7543,17179,55-59,4312,4261,8573
7544,17179,60-64,4619,4349,8968
7545,17179,65+,14063,11392,25455
7546,17181,15-19,501,531,1032
7547,17181,20-24,381,415,796
7548,17181,25-29,447,455,902
7549,17181,30-34,485,528,1013
7550,17181,35-39,474,534,1008
7551,17181,40-44,452,498,950
7552,17181,45-49,511,533,1044
7553,17181,50-54,544,575,1119
7554,17181,55-59,608,571,1179
7555,17181,60-64,586,648,1234
7556,17181,65+,1994,1773,3767
7557,17183,15-19,2143,2404,4547
7558,17183,20-24,1941,2165,4106
7559,17183,25-29,2040,2310,4350
7560,17183,30-34,1999,2198,4197
7561,17183,35-39,2141,2254,4395
7562,17183,40-44,2065,2265,4330
7563,17183,45-49,1943,2153,4096
7564,17183,50-54,2137,2163,4300
7565,17183,55-59,2470,2379,4849
7566,17183,60-64,2584,2575,5159
7567,17183,65+,7972,6665,14637
7568,17185,15-19,318,351,669
7569,17185,20-24,265,293,558
7570,17185,25-29,283,311,594
7571,17185,30-34,334,334,668
7572,17185,35-39,323,298,621
7573,17185,40-44,303,357,660
7574,17185,45-49,299,327,626
7575,17185,50-54,325,284,609
7576,17185,55-59,391,383,774
7577,17185,60-64,437,439,876
7578,17185,65+,1346,1158,2504
7579,17187,15-19,676,633,1309
7580,17187,20-24,654,663,1317
7581,17187,25-29,416,415,831
7582,17187,30-34,416,462,878
7583,17187,35-39,456,452,908
7584,17187,40-44,452,516,968
7585,17187,45-49,451,462,913
7586,17187,50-54,471,451,922
7587,17187,55-59,524,519,1043
7588,17187,60-64,588,544,1132
7589,17187,65+,1780,1583,3363
7590,17189,15-19,409,447,856
7591,17189,20-24,304,318,622
7592,17189,25-29,345,356,701
7593,17189,30-34,401,419,820
7594,17189,35-39,382,394,776
7595,17189,40-44,438,439,877
7596,17189,45-49,354,420,774
7597,17189,50-54,441,445,886
7598,17189,55-59,506,518,1024
7599,17189,60-64,547,563,1110
7600,17189,65+,1478,1436,2914
7601,17191,15-19,448,479,927
7602,17191,20-24,372,405,777
7603,17191,25-29,407,438,845
7604,17191,30-34,443,455,898
7605,17191,35-39,414,465,879
7606,17191,40-44,516,460,976
7607,17191,45-49,438,450,888
7608,17191,50-54,479,491,970
7609,17191,55-59,560,559,1119
7610,17191,60-64,567,606,1173
7611,17191,65+,1862,1618,3480
7612,17193,15-19,380,409,789
7613,17193,20-24,315,331,646
7614,17193,25-29,358,357,715
7615,17193,30-34,369,390,759
7616,17193,35-39,419,434,853
7617,17193,40-44,434,416,850
7618,17193,45-49,382,381,763
7619,17193,50-54,398,427,825
7620,17193,55-59,500,514,1014
7621,17193,60-64,542,533,1075
7622,17193,65+,1623,1341,2964
7623,17195,15-19,1627,1752,3379
7624,17195,20-24,1441,1568,3009
7625,17195,25-29,1473,1559,3032
7626,17195,30-34,1559,1592,3151
7627,17195,35-39,1574,1531,3105
7628,17195,40-44,1471,1564,3035
7629,17195,45-49,1564,1642,3206
7630,17195,50-54,1744,1789,3533
7631,17195,55-59,1907,1892,3799
7632,17195,60-64,2075,2018,4093
7633,17195,65+,6458,5520,11978
7634,17197,15-19,25118,27063,52181
7635,17197,20-24,21468,23203,44671
7636,17197,25-29,20468,21082,41550
7637,17197,30-34,20700,21285,41985
7638,17197,35-39,22926,23128,46054
7639,17197,40-44,24156,24024,48180
7640,17197,45-49,24239,24318,48557
7641,17197,50-54,25497,25695,51192
7642,17197,55-59,24056,24546,48602
7643,17197,60-64,21384,21263,42647
7644,17197,65+,53300,44636,97936
7645,17199,15-19,1841,1997,3838
7646,17199,20-24,1587,1723,3310
7647,17199,25-29,1927,2019,3946
7648,17199,30-34,2132,2278,4410
7649,17199,35-39,2121,2292,4413
7650,17199,40-44,2137,2271,4408
7651,17199,45-49,1988,2122,4110
7652,17199,50-54,2081,2143,4224
7653,17199,55-59,2250,2205,4455
7654,17199,60-64,2328,2266,4594
7655,17199,65+,7219,5985,13204
7656,17201,15-19,8716,9331,18047
7657,17201,20-24,8404,8491,16895
7658,17201,25-29,9126,8717,17843
7659,17201,30-34,9131,8603,17734
7660,17201,35-39,8728,8400,17128
7661,17201,40-44,8459,8188,16647
7662,17201,45-49,8225,8122,16347
7663,17201,50-54,8977,8920,17897
7664,17201,55-59,9622,9312,18934
7665,17201,60-64,9709,9358,19067
7666,17201,65+,28468,23333,51801
7667,17203,15-19,1321,1384,2705
7668,17203,20-24,1093,1145,2238
7669,17203,25-29,909,915,1824
7670,17203,30-34,1005,1090,2095
7671,17203,35-39,1223,1163,2386
7672,17203,40-44,1241,1254,2495
7673,17203,45-49,1055,1128,2183
7674,17203,50-54,1173,1201,2374
7675,17203,55-59,1265,1327,2592
7676,17203,60-64,1361,1331,2692
7677,17203,65+,3828,3357,7185
7678,18001,15-19,1308,1375,2683
7679,18001,20-24,1074,1108,2182
7680,18001,25-29,1002,1131,2133
7681,18001,30-34,979,1055,2034
7682,18001,35-39,943,964,1907
7683,18001,40-44,939,953,1892
7684,18001,45-49,877,958,1835
7685,18001,50-54,951,1011,1962
7686,18001,55-59,999,1019,2018
7687,18001,60-64,1041,1013,2054
7688,18001,65+,3218,2549,5767
7689,18003,15-19,12964,13523,26487
7690,18003,20-24,12832,12595,25427
7691,18003,25-29,14108,14050,28158
7692,18003,30-34,13612,13167,26779
7693,18003,35-39,12833,12522,25355
7694,18003,40-44,12093,11898,23991
7695,18003,45-49,11112,11129,22241
7696,18003,50-54,11494,11607,23101
7697,18003,55-59,11529,11414,22943
7698,18003,60-64,11860,11000,22860
7699,18003,65+,32675,26368,59043
7700,18005,15-19,2645,2498,5143
7701,18005,20-24,2290,2472,4762
7702,18005,25-29,2719,3219,5938
7703,18005,30-34,2688,3044,5732
7704,18005,35-39,2610,2912,5522
7705,18005,40-44,2449,2624,5073
7706,18005,45-49,2473,2585,5058
7707,18005,50-54,2434,2674,5108
7708,18005,55-59,2505,2544,5049
7709,18005,60-64,2524,2423,4947
7710,18005,65+,7460,6206,13666
7711,18007,15-19,302,318,620
7712,18007,20-24,216,243,459
7713,18007,25-29,246,284,530
7714,18007,30-34,240,245,485
7715,18007,35-39,260,276,536
7716,18007,40-44,242,267,509
7717,18007,45-49,248,247,495
7718,18007,50-54,279,270,549
7719,18007,55-59,302,309,611
7720,18007,60-64,330,308,638
7721,18007,65+,837,713,1550
7722,18009,15-19,325,375,700
7723,18009,20-24,272,355,627
7724,18009,25-29,331,362,693
7725,18009,30-34,360,341,701
7726,18009,35-39,325,326,651
7727,18009,40-44,329,302,631
7728,18009,45-49,357,379,736
7729,18009,50-54,391,407,798
7730,18009,55-59,416,413,829
7731,18009,60-64,419,446,865
7732,18009,65+,1454,1192,2646
7733,18011,15-19,2324,2585,4909
7734,18011,20-24,1984,2046,4030
7735,18011,25-29,2059,2035,4094
7736,18011,30-34,2324,2422,4746
7737,18011,35-39,2676,2550,5226
7738,18011,40-44,2607,2646,5253
7739,18011,45-49,2417,2445,4862
7740,18011,50-54,2363,2422,4785
7741,18011,55-59,2396,2365,4761
7742,18011,60-64,2250,2216,4466
7743,18011,65+,5637,4755,10392
7744,18013,15-19,417,427,844
7745,18013,20-24,298,344,642
7746,18013,25-29,340,378,718
7747,18013,30-34,386,393,779
7748,18013,35-39,384,406,790
7749,18013,40-44,412,410,822
7750,18013,45-49,459,486,945
7751,18013,50-54,592,563,1155
7752,18013,55-59,665,650,1315
7753,18013,60-64,703,719,1422
7754,18013,65+,2055,1950,4005
7755,18015,15-19,607,671,1278
7756,18015,20-24,536,520,1056
7757,18015,25-29,547,575,1122
7758,18015,30-34,596,641,1237
7759,18015,35-39,573,594,1167
7760,18015,40-44,583,621,1204
7761,18015,45-49,607,665,1272
7762,18015,50-54,618,724,1342
7763,18015,55-59,733,731,1464
7764,18015,60-64,775,797,1572
7765,18015,65+,2135,1944,4079
7766,18017,15-19,1156,1314,2470
7767,18017,20-24,1025,1137,2162
7768,18017,25-29,1080,1189,2269
7769,18017,30-34,1002,1085,2087
7770,18017,35-39,1150,1140,2290
7771,18017,40-44,1163,1210,2373
7772,18017,45-49,1151,1185,2336
7773,18017,50-54,1137,1344,2481
7774,18017,55-59,1236,1319,2555
7775,18017,60-64,1312,1359,2671
7776,18017,65+,3846,3137,6983
7777,18019,15-19,3385,3685,7070
7778,18019,20-24,3518,3469,6987
7779,18019,25-29,4317,4264,8581
7780,18019,30-34,4384,4350,8734
7781,18019,35-39,4064,4163,8227
7782,18019,40-44,4081,4091,8172
7783,18019,45-49,3944,3933,7877
7784,18019,50-54,4047,4050,8097
7785,18019,55-59,4229,4068,8297
7786,18019,60-64,4215,3863,8078
7787,18019,65+,11265,8720,19985
7788,18021,15-19,760,848,1608
7789,18021,20-24,678,657,1335
7790,18021,25-29,794,801,1595
7791,18021,30-34,805,781,1586
7792,18021,35-39,795,842,1637
7793,18021,40-44,823,824,1647
7794,18021,45-49,772,844,1616
7795,18021,50-54,820,827,1647
7796,18021,55-59,888,922,1810
7797,18021,60-64,941,969,1910
7798,18021,65+,2727,2256,4983
7799,18023,15-19,1134,1234,2368
7800,18023,20-24,915,990,1905
7801,18023,25-29,975,996,1971
7802,18023,30-34,987,1022,2009
7803,18023,35-39,971,1039,2010
7804,18023,40-44,940,982,1922
7805,18023,45-49,930,980,1910
7806,18023,50-54,913,1049,1962
7807,18023,55-59,1044,1034,2078
7808,18023,60-64,1117,1017,2134
7809,18023,65+,3081,2547,5628
7810,18025,15-19,323,324,647
7811,18025,20-24,231,254,485
7812,18025,25-29,284,283,567
7813,18025,30-34,254,272,526
7814,18025,35-39,282,294,576
7815,18025,40-44,286,338,624
7816,18025,45-49,352,344,696
7817,18025,50-54,323,352,675
7818,18025,55-59,439,440,879
7819,18025,60-64,404,456,860
7820,18025,65+,1072,1070,2142
7821,18027,15-19,1203,1271,2474
7822,18027,20-24,952,1029,1981
7823,18027,25-29,1007,1129,2136
7824,18027,30-34,985,1031,2016
7825,18027,35-39,939,1040,1979
7826,18027,40-44,899,954,1853
7827,18027,45-49,855,880,1735
7828,18027,50-54,865,897,1762
7829,18027,55-59,994,1006,2000
7830,18027,60-64,983,1021,2004
7831,18027,65+,2809,2387,5196
7832,18029,15-19,1633,1763,3396
7833,18029,20-24,1412,1465,2877
7834,18029,25-29,1294,1427,2721
7835,18029,30-34,1435,1414,2849
7836,18029,35-39,1468,1512,2980
7837,18029,40-44,1571,1615,3186
7838,18029,45-49,1539,1624,3163
7839,18029,50-54,1767,1823,3590
7840,18029,55-59,1887,1917,3804
7841,18029,60-64,1901,1874,3775
7842,18029,65+,4995,4486,9481
7843,18031,15-19,849,847,1696
7844,18031,20-24,729,864,1593
7845,18031,25-29,827,808,1635
7846,18031,30-34,787,820,1607
7847,18031,35-39,771,794,1565
7848,18031,40-44,806,819,1625
7849,18031,45-49,769,815,1584
7850,18031,50-54,816,874,1690
7851,18031,55-59,905,922,1827
7852,18031,60-64,900,959,1859
7853,18031,65+,2483,2035,4518
7854,18033,15-19,1373,1467,2840
7855,18033,20-24,1187,1276,2463
7856,18033,25-29,1315,1413,2728
7857,18033,30-34,1374,1378,2752
7858,18033,35-39,1306,1311,2617
7859,18033,40-44,1340,1373,2713
7860,18033,45-49,1289,1292,2581
7861,18033,50-54,1341,1419,2760
7862,18033,55-59,1469,1565,3034
7863,18033,60-64,1452,1459,2911
7864,18033,65+,3978,3334,7312
7865,18035,15-19,5158,4637,9795
7866,18035,20-24,8156,7431,15587
7867,18035,25-29,3528,3490,7018
7868,18035,30-34,3048,3068,6116
7869,18035,35-39,2920,2901,5821
7870,18035,40-44,2932,2866,5798
7871,18035,45-49,2957,2885,5842
7872,18035,50-54,3260,3225,6485
7873,18035,55-59,3408,3263,6671
7874,18035,60-64,3545,3349,6894
7875,18035,65+,10846,8442,19288
7876,18037,15-19,1315,1486,2801
7877,18037,20-24,1243,1222,2465
7878,18037,25-29,1212,1242,2454
7879,18037,30-34,1135,1196,2331
7880,18037,35-39,1183,1370,2553
7881,18037,40-44,1222,1338,2560
7882,18037,45-49,1159,1254,2413
7883,18037,50-54,1313,1416,2729
7884,18037,55-59,1549,1681,3230
7885,18037,60-64,1599,1590,3189
7886,18037,65+,4400,3665,8065
7887,18039,15-19,7415,7748,15163
7888,18039,20-24,6581,7008,13589
7889,18039,25-29,6585,6841,13426
7890,18039,30-34,6551,6561,13112
7891,18039,35-39,6230,6376,12606
7892,18039,40-44,6256,6226,12482
7893,18039,45-49,5923,5893,11816
7894,18039,50-54,6091,6259,12350
7895,18039,55-59,6113,6291,12404
7896,18039,60-64,5908,5806,11714
7897,18039,65+,17440,14120,31560
7898,18041,15-19,739,754,1493
7899,18041,20-24,617,655,1272
7900,18041,25-29,676,679,1355
7901,18041,30-34,664,642,1306
7902,18041,35-39,615,591,1206
7903,18041,40-44,744,710,1454
7904,18041,45-49,745,777,1522
7905,18041,50-54,720,800,1520
7906,18041,55-59,820,844,1664
7907,18041,60-64,826,737,1563
7908,18041,65+,2619,2221,4840
7909,18043,15-19,2529,2598,5127
7910,18043,20-24,2334,2273,4607
7911,18043,25-29,2511,2577,5088
7912,18043,30-34,2594,2549,5143
7913,18043,35-39,2780,2572,5352
7914,18043,40-44,2698,2580,5278
7915,18043,45-49,2443,2453,4896
7916,18043,50-54,2679,2592,5271
7917,18043,55-59,2839,2757,5596
7918,18043,60-64,2832,2714,5546
7919,18043,65+,7592,5997,13589
7920,18045,15-19,474,496,970
7921,18045,20-24,455,477,932
7922,18045,25-29,493,529,1022
7923,18045,30-34,452,450,902
7924,18045,35-39,445,473,918
7925,18045,40-44,443,461,904
7926,18045,45-49,510,468,978
7927,18045,50-54,563,582,1145
7928,18045,55-59,598,607,1205
7929,18045,60-64,597,594,1191
7930,18045,65+,1811,1527,3338
7931,18047,15-19,688,793,1481
7932,18047,20-24,576,667,1243
7933,18047,25-29,625,658,1283
7934,18047,30-34,604,599,1203
7935,18047,35-39,646,633,1279
7936,18047,40-44,678,659,1337
7937,18047,45-49,685,702,1387
7938,18047,50-54,770,788,1558
7939,18047,55-59,797,896,1693
7940,18047,60-64,841,868,1709
7941,18047,65+,2360,2101,4461
7942,18049,15-19,616,672,1288
7943,18049,20-24,508,588,1096
7944,18049,25-29,527,571,1098
7945,18049,30-34,574,601,1175
7946,18049,35-39,573,607,1180
7947,18049,40-44,611,639,1250
7948,18049,45-49,594,616,1210
7949,18049,50-54,579,617,1196
7950,18049,55-59,682,668,1350
7951,18049,60-64,723,747,1470
7952,18049,65+,2209,1926,4135
7953,18051,15-19,1076,1126,2202
7954,18051,20-24,893,952,1845
7955,18051,25-29,949,1004,1953
7956,18051,30-34,1029,973,2002
7957,18051,35-39,967,1062,2029
7958,18051,40-44,954,1061,2015
7959,18051,45-49,919,966,1885
7960,18051,50-54,1022,1072,2094
7961,18051,55-59,1071,1180,2251
7962,18051,60-64,1150,1175,2325
7963,18051,65+,3202,2677,5879
7964,18053,15-19,2666,2405,5071
7965,18053,20-24,3018,2767,5785
7966,18053,25-29,1905,1838,3743
7967,18053,30-34,1862,1708,3570
7968,18053,35-39,1752,1572,3324
7969,18053,40-44,1832,1752,3584
7970,18053,45-49,1792,1763,3555
7971,18053,50-54,2005,2034,4039
7972,18053,55-59,2224,2149,4373
7973,18053,60-64,2438,2189,4627
7974,18053,65+,7227,5751,12978
7975,18055,15-19,869,996,1865
7976,18055,20-24,727,824,1551
7977,18055,25-29,879,921,1800
7978,18055,30-34,915,929,1844
7979,18055,35-39,853,840,1693
7980,18055,40-44,868,939,1807
7981,18055,45-49,941,934,1875
7982,18055,50-54,1011,1063,2074
7983,18055,55-59,1155,1232,2387
7984,18055,60-64,1120,1154,2274
7985,18055,65+,3252,2915,6167
7986,18057,15-19,12379,13027,25406
7987,18057,20-24,9982,9858,19840
7988,18057,25-29,10181,10000,20181
7989,18057,30-34,11406,10818,22224
7990,18057,35-39,13909,13030,26939
7991,18057,40-44,13755,13240,26995
7992,18057,45-49,12377,12410,24787
7993,18057,50-54,12481,12546,25027
7994,18057,55-59,11572,11373,22945
7995,18057,60-64,10291,9802,20093
7996,18057,65+,26005,21296,47301
7997,18059,15-19,2507,2664,5171
7998,18059,20-24,2064,2186,4250
7999,18059,25-29,2395,2341,4736
8000,18059,30-34,2616,2582,5198
8001,18059,35-39,2932,2795,5727
8002,18059,40-44,2653,2734,5387
8003,18059,45-49,2620,2594,5214
8004,18059,50-54,2795,2785,5580
8005,18059,55-59,2991,2844,5835
8006,18059,60-64,2707,2650,5357
8007,18059,65+,7397,6270,13667
8008,18061,15-19,1192,1210,2402
8009,18061,20-24,961,1053,2014
8010,18061,25-29,1024,1114,2138
8011,18061,30-34,1191,1177,2368
8012,18061,35-39,1271,1268,2539
8013,18061,40-44,1271,1379,2650
8014,18061,45-49,1216,1202,2418
8015,18061,50-54,1287,1368,2655
8016,18061,55-59,1506,1506,3012
8017,18061,60-64,1468,1457,2925
8018,18061,65+,3962,3494,7456
8019,18063,15-19,5849,6572,12421
8020,18063,20-24,4889,5537,10426
8021,18063,25-29,5027,5750,10777
8022,18063,30-34,5852,6025,11877
8023,18063,35-39,6518,6629,13147
8024,18063,40-44,6511,6769,13280
8025,18063,45-49,5871,6306,12177
8026,18063,50-54,5753,6047,11800
8027,18063,55-59,5721,5620,11341
8028,18063,60-64,5410,5234,10644
8029,18063,65+,14334,11722,26056
8030,18065,15-19,1342,1575,2917
8031,18065,20-24,1220,1684,2904
8032,18065,25-29,1328,1904,3232
8033,18065,30-34,1340,1766,3106
8034,18065,35-39,1240,1605,2845
8035,18065,40-44,1322,1730,3052
8036,18065,45-49,1419,1762,3181
8037,18065,50-54,1485,1807,3292
8038,18065,55-59,1749,1843,3592
8039,18065,60-64,1658,1673,3331
8040,18065,65+,5124,4330,9454
8041,18067,15-19,2471,2582,5053
8042,18067,20-24,2502,2452,4954
8043,18067,25-29,2693,2722,5415
8044,18067,30-34,2503,2482,4985
8045,18067,35-39,2441,2288,4729
8046,18067,40-44,2516,2289,4805
8047,18067,45-49,2434,2313,4747
8048,18067,50-54,2560,2594,5154
8049,18067,55-59,2895,2741,5636
8050,18067,60-64,2990,2796,5786
8051,18067,65+,9183,7318,16501
8052,18069,15-19,1177,1231,2408
8053,18069,20-24,1213,1282,2495
8054,18069,25-29,1081,1138,2219
8055,18069,30-34,1087,1145,2232
8056,18069,35-39,1057,1119,2176
8057,18069,40-44,1093,1153,2246
8058,18069,45-49,1079,1061,2140
8059,18069,50-54,1121,1185,2306
8060,18069,55-59,1336,1274,2610
8061,18069,60-64,1362,1391,2753
8062,18069,65+,3631,2920,6551
8063,18071,15-19,1369,1565,2934
8064,18071,20-24,1195,1307,2502
8065,18071,25-29,1374,1388,2762
8066,18071,30-34,1378,1344,2722
8067,18071,35-39,1344,1507,2851
8068,18071,40-44,1487,1579,3066
8069,18071,45-49,1360,1502,2862
8070,18071,50-54,1417,1585,3002
8071,18071,55-59,1579,1566,3145
8072,18071,60-64,1552,1523,3075
8073,18071,65+,4293,3507,7800
8074,18073,15-19,1155,1247,2402
8075,18073,20-24,1056,1139,2195
8076,18073,25-29,895,974,1869
8077,18073,30-34,944,947,1891
8078,18073,35-39,923,915,1838
8079,18073,40-44,1016,1101,2117
8080,18073,45-49,1025,1007,2032
8081,18073,50-54,984,1078,2062
8082,18073,55-59,1151,1075,2226
8083,18073,60-64,1168,1197,2365
8084,18073,65+,3253,2811,6064
8085,18075,15-19,622,723,1345
8086,18075,20-24,549,578,1127
8087,18075,25-29,564,625,1189
8088,18075,30-34,554,608,1162
8089,18075,35-39,537,521,1058
8090,18075,40-44,520,612,1132
8091,18075,45-49,607,566,1173
8092,18075,50-54,643,673,1316
8093,18075,55-59,680,696,1376
8094,18075,60-64,669,680,1349
8095,18075,65+,2032,1737,3769
8096,18077,15-19,1094,1038,2132
8097,18077,20-24,1162,1108,2270
8098,18077,25-29,1114,926,2040
8099,18077,30-34,1010,913,1923
8100,18077,35-39,1043,921,1964
8101,18077,40-44,1053,983,2036
8102,18077,45-49,1020,972,1992
8103,18077,50-54,1080,1079,2159
8104,18077,55-59,1199,1191,2390
8105,18077,60-64,1267,1230,2497
8106,18077,65+,3304,2918,6222
8107,18079,15-19,816,857,1673
8108,18079,20-24,757,830,1587
8109,18079,25-29,912,921,1833
8110,18079,30-34,819,854,1673
8111,18079,35-39,723,774,1497
8112,18079,40-44,747,791,1538
8113,18079,45-49,874,902,1776
8114,18079,50-54,969,1060,2029
8115,18079,55-59,994,1011,2005
8116,18079,60-64,910,1002,1912
8117,18079,65+,2512,2142,4654
8118,18081,15-19,5195,5659,10854
8119,18081,20-24,4725,5140,9865
8120,18081,25-29,5427,5484,10911
8121,18081,30-34,5625,5671,11296
8122,18081,35-39,5766,5631,11397
8123,18081,40-44,5602,5715,11317
8124,18081,45-49,5128,5181,10309
8125,18081,50-54,5084,5302,10386
8126,18081,55-59,5207,5104,10311
8127,18081,60-64,5071,4833,9904
8128,18081,65+,13657,11054,24711
8129,18083,15-19,1261,1559,2820
8130,18083,20-24,1291,1610,2901
8131,18083,25-29,941,1079,2020
8132,18083,30-34,942,1135,2077
8133,18083,35-39,1036,1190,2226
8134,18083,40-44,1039,1045,2084
8135,18083,45-49,887,927,1814
8136,18083,50-54,986,1051,2037
8137,18083,55-59,1178,1226,2404
8138,18083,60-64,1262,1283,2545
8139,18083,65+,3745,2928,6673
8140,18085,15-19,2620,2737,5357
8141,18085,20-24,2529,2587,5116
8142,18085,25-29,2419,2635,5054
8143,18085,30-34,2484,2569,5053
8144,18085,35-39,2394,2556,4950
8145,18085,40-44,2218,2424,4642
8146,18085,45-49,2131,2223,4354
8147,18085,50-54,2381,2507,4888
8148,18085,55-59,2709,2626,5335
8149,18085,60-64,2765,2809,5574
8150,18085,65+,7512,6688,14200
8151,18087,15-19,1593,1833,3426
8152,18087,20-24,1256,1428,2684
8153,18087,25-29,1104,1293,2397
8154,18087,30-34,1163,1135,2298
8155,18087,35-39,1086,1165,2251
8156,18087,40-44,1072,1098,2170
8157,18087,45-49,1112,1122,2234
8158,18087,50-54,1029,1122,2151
8159,18087,55-59,1105,1101,2206
8160,18087,60-64,1107,1133,2240
8161,18087,65+,3001,2781,5782
8162,18089,15-19,16367,17259,33626
8163,18089,20-24,15059,15327,30386
8164,18089,25-29,15327,15158,30485
8165,18089,30-34,15611,14797,30408
8166,18089,35-39,16341,15619,31960
8167,18089,40-44,16716,15968,32684
8168,18089,45-49,15526,14725,30251
8169,18089,50-54,15909,15111,31020
8170,18089,55-59,16825,16002,32827
8171,18089,60-64,17666,16404,34070
8172,18089,65+,47971,38069,86040
8173,18091,15-19,2963,3266,6229
8174,18091,20-24,2976,3873,6849
8175,18091,25-29,3185,4311,7496
8176,18091,30-34,3261,4253,7514
8177,18091,35-39,3004,4014,7018
8178,18091,40-44,3129,3794,6923
8179,18091,45-49,2957,3615,6572
8180,18091,50-54,3439,3759,7198
8181,18091,55-59,3834,3921,7755
8182,18091,60-64,3890,3956,7846
8183,18091,65+,11476,9571,21047
8184,18093,15-19,1342,1430,2772
8185,18093,20-24,1153,1329,2482
8186,18093,25-29,1259,1356,2615
8187,18093,30-34,1223,1301,2524
8188,18093,35-39,1319,1302,2621
8189,18093,40-44,1378,1327,2705
8190,18093,45-49,1336,1444,2780
8191,18093,50-54,1441,1614,3055
8192,18093,55-59,1704,1567,3271
8193,18093,60-64,1616,1631,3247
8194,18093,65+,4986,4208,9194
8195,18095,15-19,3984,4368,8352
8196,18095,20-24,3861,4152,8013
8197,18095,25-29,3932,4346,8278
8198,18095,30-34,4063,4530,8593
8199,18095,35-39,3798,4206,8004
8200,18095,40-44,3947,4318,8265
8201,18095,45-49,3816,4137,7953
8202,18095,50-54,4240,4448,8688
8203,18095,55-59,4418,4475,8893
8204,18095,60-64,4439,4288,8727
8205,18095,65+,13430,10909,24339
8206,18097,15-19,30651,31507,62158
8207,18097,20-24,34636,31917,66553
8208,18097,25-29,42059,39794,81853
8209,18097,30-34,41030,38521,79551
8210,18097,35-39,35125,33458,68583
8211,18097,40-44,31328,29855,61183
8212,18097,45-49,27647,26019,53666
8213,18097,50-54,28176,26581,54757
8214,18097,55-59,29462,27518,56980
8215,18097,60-64,29780,26734,56514
8216,18097,65+,72755,54783,127538
8217,18099,15-19,1625,1701,3326
8218,18099,20-24,1277,1400,2677
8219,18099,25-29,1226,1385,2611
8220,18099,30-34,1238,1266,2504
8221,18099,35-39,1289,1314,2603
8222,18099,40-44,1337,1376,2713
8223,18099,45-49,1325,1378,2703
8224,18099,50-54,1456,1446,2902
8225,18099,55-59,1532,1597,3129
8226,18099,60-64,1504,1582,3086
8227,18099,65+,4675,3940,8615
8228,18101,15-19,263,326,589
8229,18101,20-24,259,291,550
8230,18101,25-29,279,291,570
8231,18101,30-34,268,236,504
8232,18101,35-39,254,329,583
8233,18101,40-44,265,286,551
8234,18101,45-49,285,308,593
8235,18101,50-54,289,320,609
8236,18101,55-59,341,345,686
8237,18101,60-64,365,388,753
8238,18101,65+,1080,938,2018
8239,18103,15-19,1025,1180,2205
8240,18103,20-24,863,1369,2232
8241,18103,25-29,922,1456,2378
8242,18103,30-34,981,1473,2454
8243,18103,35-39,899,1430,2329
8244,18103,40-44,970,1393,2363
8245,18103,45-49,1031,1294,2325
8246,18103,50-54,1056,1324,2380
8247,18103,55-59,1145,1281,2426
8248,18103,60-64,1142,1174,2316
8249,18103,65+,3472,3028,6500
8250,18105,15-19,7344,7059,14403
8251,18105,20-24,12937,12874,25811
8252,18105,25-29,4946,5625,10571
8253,18105,30-34,4157,4634,8791
8254,18105,35-39,3807,4021,7828
8255,18105,40-44,3776,3848,7624
8256,18105,45-49,3270,3224,6494
8257,18105,50-54,3374,3360,6734
8258,18105,55-59,3443,3392,6835
8259,18105,60-64,3739,3457,7196
8260,18105,65+,10841,8736,19577
8261,18107,15-19,1110,1471,2581
8262,18107,20-24,1029,1436,2465
8263,18107,25-29,1118,1136,2254
8264,18107,30-34,1095,1177,2272
8265,18107,35-39,1071,1157,2228
8266,18107,40-44,986,1085,2071
8267,18107,45-49,1114,1072,2186
8268,18107,50-54,1144,1252,2396
8269,18107,55-59,1365,1337,2702
8270,18107,60-64,1318,1386,2704
8271,18107,65+,3803,3204,7007
8272,18109,15-19,2280,2411,4691
8273,18109,20-24,1863,2072,3935
8274,18109,25-29,2032,2087,4119
8275,18109,30-34,2132,2119,4251
8276,18109,35-39,2187,2056,4243
8277,18109,40-44,2241,2219,4460
8278,18109,45-49,2233,2227,4460
8279,18109,50-54,2588,2633,5221
8280,18109,55-59,2730,2809,5539
8281,18109,60-64,2673,2758,5431
8282,18109,65+,6890,5972,12862
8283,18111,15-19,382,398,780
8284,18111,20-24,325,391,716
8285,18111,25-29,386,443,829
8286,18111,30-34,382,413,795
8287,18111,35-39,411,426,837
8288,18111,40-44,382,464,846
8289,18111,45-49,361,406,767
8290,18111,50-54,431,504,935
8291,18111,55-59,511,525,1036
8292,18111,60-64,521,562,1083
8293,18111,65+,1489,1319,2808
8294,18113,15-19,1496,1588,3084
8295,18113,20-24,1359,1443,2802
8296,18113,25-29,1462,1505,2967
8297,18113,30-34,1390,1424,2814
8298,18113,35-39,1369,1457,2826
8299,18113,40-44,1428,1481,2909
8300,18113,45-49,1374,1449,2823
8301,18113,50-54,1437,1548,2985
8302,18113,55-59,1539,1682,3221
8303,18113,60-64,1573,1714,3287
8304,18113,65+,4329,3730,8059
8305,18115,15-19,149,161,310
8306,18115,20-24,118,139,257
8307,18115,25-29,152,119,271
8308,18115,30-34,197,179,376
8309,18115,35-39,145,167,312
8310,18115,40-44,170,174,344
8311,18115,45-49,176,182,358
8312,18115,50-54,185,192,377
8313,18115,55-59,243,252,495
8314,18115,60-64,277,237,514
8315,18115,65+,711,652,1363
8316,18117,15-19,570,634,1204
8317,18117,20-24,528,551,1079
8318,18117,25-29,556,565,1121
8319,18117,30-34,543,583,1126
8320,18117,35-39,548,542,1090
8321,18117,40-44,563,567,1130
8322,18117,45-49,569,594,1163
8323,18117,50-54,587,611,1198
8324,18117,55-59,692,717,1409
8325,18117,60-64,792,733,1525
8326,18117,65+,2168,1871,4039
8327,18119,15-19,616,641,1257
8328,18119,20-24,506,568,1074
8329,18119,25-29,577,589,1166
8330,18119,30-34,634,609,1243
8331,18119,35-39,591,620,1211
8332,18119,40-44,595,636,1231
8333,18119,45-49,633,638,1271
8334,18119,50-54,722,734,1456
8335,18119,55-59,888,901,1789
8336,18119,60-64,875,912,1787
8337,18119,65+,2230,2124,4354
8338,18121,15-19,462,474,936
8339,18121,20-24,523,386,909
8340,18121,25-29,632,419,1051
8341,18121,30-34,601,455,1056
8342,18121,35-39,584,418,1002
8343,18121,40-44,547,367,914
8344,18121,45-49,520,450,970
8345,18121,50-54,519,497,1016
8346,18121,55-59,584,565,1149
8347,18121,60-64,599,625,1224
8348,18121,65+,1676,1562,3238
8349,18123,15-19,528,594,1122
8350,18123,20-24,417,699,1116
8351,18123,25-29,499,834,1333
8352,18123,30-34,497,758,1255
8353,18123,35-39,502,769,1271
8354,18123,40-44,515,747,1262
8355,18123,45-49,508,645,1153
8356,18123,50-54,500,637,1137
8357,18123,55-59,610,713,1323
8358,18123,60-64,693,691,1384
8359,18123,65+,1903,1764,3667
8360,18125,15-19,347,369,716
8361,18125,20-24,285,308,593
8362,18125,25-29,329,354,683
8363,18125,30-34,333,376,709
8364,18125,35-39,337,366,703
8365,18125,40-44,326,356,682
8366,18125,45-49,358,386,744
8367,18125,50-54,388,389,777
8368,18125,55-59,447,466,913
8369,18125,60-64,473,488,961
8370,18125,65+,1268,1196,2464
8371,18127,15-19,5612,6096,11708
8372,18127,20-24,5408,5607,11015
8373,18127,25-29,5116,5267,10383
8374,18127,30-34,5260,5269,10529
8375,18127,35-39,5915,5850,11765
8376,18127,40-44,5935,5949,11884
8377,18127,45-49,5487,5533,11020
8378,18127,50-54,5633,5685,11318
8379,18127,55-59,5800,5706,11506
8380,18127,60-64,6355,5865,12220
8381,18127,65+,16387,14054,30441
8382,18129,15-19,665,826,1491
8383,18129,20-24,580,606,1186
8384,18129,25-29,661,676,1337
8385,18129,30-34,744,741,1485
8386,18129,35-39,756,759,1515
8387,18129,40-44,745,829,1574
8388,18129,45-49,711,727,1438
8389,18129,50-54,782,806,1588
8390,18129,55-59,930,915,1845
8391,18129,60-64,968,1030,1998
8392,18129,65+,2732,2345,5077
8393,18131,15-19,385,410,795
8394,18131,20-24,283,353,636
8395,18131,25-29,348,369,717
8396,18131,30-34,312,367,679
8397,18131,35-39,344,387,731
8398,18131,40-44,329,390,719
8399,18131,45-49,355,387,742
8400,18131,50-54,378,385,763
8401,18131,55-59,456,458,914
8402,18131,60-64,435,502,937
8403,18131,65+,1312,1210,2522
8404,18133,15-19,1382,1379,2761
8405,18133,20-24,1524,1838,3362
8406,18133,25-29,933,1597,2530
8407,18133,30-34,970,1371,2341
8408,18133,35-39,933,1267,2200
8409,18133,40-44,946,1248,2194
8410,18133,45-49,964,1171,2135
8411,18133,50-54,1082,1270,2352
8412,18133,55-59,1165,1330,2495
8413,18133,60-64,1214,1249,2463
8414,18133,65+,3306,2919,6225
8415,18135,15-19,734,789,1523
8416,18135,20-24,677,708,1385
8417,18135,25-29,654,695,1349
8418,18135,30-34,661,668,1329
8419,18135,35-39,629,677,1306
8420,18135,40-44,740,701,1441
8421,18135,45-49,746,768,1514
8422,18135,50-54,743,828,1571
8423,18135,55-59,876,853,1729
8424,18135,60-64,891,857,1748
8425,18135,65+,2737,2308,5045
8426,18137,15-19,881,1035,1916
8427,18137,20-24,825,864,1689
8428,18137,25-29,855,916,1771
8429,18137,30-34,771,777,1548
8430,18137,35-39,802,783,1585
8431,18137,40-44,892,872,1764
8432,18137,45-49,895,854,1749
8433,18137,50-54,965,1000,1965
8434,18137,55-59,1054,1022,2076
8435,18137,60-64,1010,1001,2011
8436,18137,65+,2906,2511,5417
8437,18139,15-19,512,543,1055
8438,18139,20-24,457,450,907
8439,18139,25-29,505,501,1006
8440,18139,30-34,519,465,984
8441,18139,35-39,472,481,953
8442,18139,40-44,491,463,954
8443,18139,45-49,478,524,1002
8444,18139,50-54,566,549,1115
8445,18139,55-59,570,654,1224
8446,18139,60-64,619,636,1255
8447,18139,65+,1740,1435,3175
8448,18141,15-19,10074,10323,20397
8449,18141,20-24,10700,10105,20805
8450,18141,25-29,9281,9269,18550
8451,18141,30-34,8999,8846,17845
8452,18141,35-39,8396,8639,17035
8453,18141,40-44,8190,8111,16301
8454,18141,45-49,7686,7304,14990
8455,18141,50-54,8062,7847,15909
8456,18141,55-59,8347,7884,16231
8457,18141,60-64,8558,8172,16730
8458,18141,65+,24768,20056,44824
8459,18143,15-19,726,759,1485
8460,18143,20-24,710,719,1429
8461,18143,25-29,787,788,1575
8462,18143,30-34,754,760,1514
8463,18143,35-39,727,713,1440
8464,18143,40-44,785,732,1517
8465,18143,45-49,811,800,1611
8466,18143,50-54,824,905,1729
8467,18143,55-59,872,913,1785
8468,18143,60-64,866,822,1688
8469,18143,65+,2231,1872,4103
8470,18145,15-19,1331,1503,2834
8471,18145,20-24,1244,1279,2523
8472,18145,25-29,1312,1362,2674
8473,18145,30-34,1358,1428,2786
8474,18145,35-39,1353,1317,2670
8475,18145,40-44,1288,1398,2686
8476,18145,45-49,1356,1478,2834
8477,18145,50-54,1502,1464,2966
8478,18145,55-59,1699,1647,3346
8479,18145,60-64,1649,1683,3332
8480,18145,65+,4418,3707,8125
8481,18147,15-19,565,642,1207
8482,18147,20-24,524,524,1048
8483,18147,25-29,525,519,1044
8484,18147,30-34,523,544,1067
8485,18147,35-39,513,592,1105
8486,18147,40-44,566,623,1189
8487,18147,45-49,596,573,1169
8488,18147,50-54,595,696,1291
8489,18147,55-59,786,773,1559
8490,18147,60-64,777,810,1587
8491,18147,65+,2089,1956,4045
8492,18149,15-19,739,721,1460
8493,18149,20-24,598,624,1222
8494,18149,25-29,657,667,1324
8495,18149,30-34,702,691,1393
8496,18149,35-39,658,626,1284
8497,18149,40-44,669,740,1409
8498,18149,45-49,668,699,1367
8499,18149,50-54,779,778,1557
8500,18149,55-59,837,787,1624
8501,18149,60-64,870,905,1775
8502,18149,65+,2333,2229,4562
8503,18151,15-19,1081,1311,2392
8504,18151,20-24,995,1306,2301
8505,18151,25-29,875,932,1807
8506,18151,30-34,941,969,1910
8507,18151,35-39,852,894,1746
8508,18151,40-44,874,904,1778
8509,18151,45-49,961,965,1926
8510,18151,50-54,1103,1163,2266
8511,18151,55-59,1266,1330,2596
8512,18151,60-64,1365,1369,2734
8513,18151,65+,3884,3586,7470
8514,18153,15-19,495,661,1156
8515,18153,20-24,463,781,1244
8516,18153,25-29,546,956,1502
8517,18153,30-34,567,918,1485
8518,18153,35-39,548,843,1391
8519,18153,40-44,576,863,1439
8520,18153,45-49,594,837,1431
8521,18153,50-54,582,777,1359
8522,18153,55-59,681,714,1395
8523,18153,60-64,661,687,1348
8524,18153,65+,2088,1751,3839
8525,18155,15-19,270,332,602
8526,18155,20-24,228,274,502
8527,18155,25-29,229,264,493
8528,18155,30-34,281,262,543
8529,18155,35-39,300,289,589
8530,18155,40-44,289,313,602
8531,18155,45-49,278,309,587
8532,18155,50-54,318,372,690
8533,18155,55-59,364,374,738
8534,18155,60-64,328,383,711
8535,18155,65+,891,910,1801
8536,18157,15-19,8509,9717,18226
8537,18157,20-24,14013,18151,32164
8538,18157,25-29,6761,7626,14387
8539,18157,30-34,5786,6279,12065
8540,18157,35-39,5061,5374,10435
8541,18157,40-44,4997,4981,9978
8542,18157,45-49,4383,4460,8843
8543,18157,50-54,4568,4469,9037
8544,18157,55-59,4543,4445,8988
8545,18157,60-64,4561,4199,8760
8546,18157,65+,12523,10113,22636
8547,18159,15-19,455,459,914
8548,18159,20-24,379,440,819
8549,18159,25-29,441,453,894
8550,18159,30-34,432,457,889
8551,18159,35-39,407,411,818
8552,18159,40-44,418,439,857
8553,18159,45-49,478,451,929
8554,18159,50-54,513,571,1084
8555,18159,55-59,550,553,1103
8556,18159,60-64,572,590,1162
8557,18159,65+,1772,1583,3355
8558,18161,15-19,197,237,434
8559,18161,20-24,199,202,401
8560,18161,25-29,189,211,400
8561,18161,30-34,208,186,394
8562,18161,35-39,188,183,371
8563,18161,40-44,238,203,441
8564,18161,45-49,217,181,398
8565,18161,50-54,251,247,498
8566,18161,55-59,278,249,527
8567,18161,60-64,263,262,525
8568,18161,65+,768,664,1432
8569,18163,15-19,6010,5754,11764
8570,18163,20-24,6371,5997,12368
8571,18163,25-29,6299,6385,12684
8572,18163,30-34,6365,6248,12613
8573,18163,35-39,5771,5959,11730
8574,18163,40-44,5365,5387,10752
8575,18163,45-49,4843,4908,9751
8576,18163,50-54,5218,5126,10344
8577,18163,55-59,5949,5545,11494
8578,18163,60-64,6456,6012,12468
8579,18163,65+,17687,14041,31728
8580,18165,15-19,433,558,991
8581,18165,20-24,372,474,846
8582,18165,25-29,442,451,893
8583,18165,30-34,416,438,854
8584,18165,35-39,430,401,831
8585,18165,40-44,466,503,969
8586,18165,45-49,472,473,945
8587,18165,50-54,495,546,1041
8588,18165,55-59,533,510,1043
8589,18165,60-64,582,513,1095
8590,18165,65+,1715,1419,3134
8591,18167,15-19,3811,4146,7957
8592,18167,20-24,5609,5961,11570
8593,18167,25-29,3307,3978,7285
8594,18167,30-34,2916,3706,6622
8595,18167,35-39,2903,3555,6458
8596,18167,40-44,2832,3247,6079
8597,18167,45-49,2724,3027,5751
8598,18167,50-54,2899,3214,6113
8599,18167,55-59,3043,3142,6185
8600,18167,60-64,3291,3036,6327
8601,18167,65+,10191,7561,17752
8602,18169,15-19,1057,1172,2229
8603,18169,20-24,1008,1048,2056
8604,18169,25-29,884,884,1768
8605,18169,30-34,798,848,1646
8606,18169,35-39,871,797,1668
8607,18169,40-44,863,928,1791
8608,18169,45-49,898,863,1761
8609,18169,50-54,939,917,1856
8610,18169,55-59,1059,1014,2073
8611,18169,60-64,1134,1178,2312
8612,18169,65+,3580,2870,6450
8613,18171,15-19,252,272,524
8614,18171,20-24,189,230,419
8615,18171,25-29,246,195,441
8616,18171,30-34,235,244,479
8617,18171,35-39,230,238,468
8618,18171,40-44,257,254,511
8619,18171,45-49,234,245,479
8620,18171,50-54,281,306,587
8621,18171,55-59,308,360,668
8622,18171,60-64,278,323,601
8623,18171,65+,959,831,1790
8624,18173,15-19,2088,2205,4293
8625,18173,20-24,1558,1784,3342
8626,18173,25-29,1823,1790,3613
8627,18173,30-34,1935,1882,3817
8628,18173,35-39,2161,1987,4148
8629,18173,40-44,2130,2230,4360
8630,18173,45-49,2036,2101,4137
8631,18173,50-54,2055,2147,4202
8632,18173,55-59,2198,2144,4342
8633,18173,60-64,2273,2226,4499
8634,18173,65+,6304,5274,11578
8635,18175,15-19,860,947,1807
8636,18175,20-24,708,777,1485
8637,18175,25-29,830,832,1662
8638,18175,30-34,845,874,1719
8639,18175,35-39,769,807,1576
8640,18175,40-44,890,896,1786
8641,18175,45-49,840,897,1737
8642,18175,50-54,910,961,1871
8643,18175,55-59,1081,1051,2132
8644,18175,60-64,1038,1018,2056
8645,18175,65+,2682,2417,5099
8646,18177,15-19,2110,2245,4355
8647,18177,20-24,2237,2248,4485
8648,18177,25-29,1924,2014,3938
8649,18177,30-34,1902,1915,3817
8650,18177,35-39,1933,1812,3745
8651,18177,40-44,1932,1911,3843
8652,18177,45-49,1920,1953,3873
8653,18177,50-54,2152,2106,4258
8654,18177,55-59,2318,2231,4549
8655,18177,60-64,2298,2236,4534
8656,18177,65+,7291,5568,12859
8657,18179,15-19,870,972,1842
8658,18179,20-24,683,791,1474
8659,18179,25-29,840,848,1688
8660,18179,30-34,804,814,1618
8661,18179,35-39,844,855,1699
8662,18179,40-44,819,871,1690
8663,18179,45-49,728,783,1511
8664,18179,50-54,833,858,1691
8665,18179,55-59,951,941,1892
8666,18179,60-64,1023,1014,2037
8667,18179,65+,2906,2357,5263
8668,18181,15-19,709,872,1581
8669,18181,20-24,599,717,1316
8670,18181,25-29,681,708,1389
8671,18181,30-34,675,676,1351
8672,18181,35-39,639,657,1296
8673,18181,40-44,688,693,1381
8674,18181,45-49,688,731,1419
8675,18181,50-54,768,813,1581
8676,18181,55-59,854,809,1663
8677,18181,60-64,942,914,1856
8678,18181,65+,2734,2432,5166
8679,18183,15-19,1006,1158,2164
8680,18183,20-24,858,966,1824
8681,18183,25-29,1027,1057,2084
8682,18183,30-34,1040,1026,2066
8683,18183,35-39,985,1044,2029
8684,18183,40-44,997,1019,2016
8685,18183,45-49,992,1096,2088
8686,18183,50-54,1118,1109,2227
8687,18183,55-59,1164,1142,2306
8688,18183,60-64,1332,1319,2651
8689,18183,65+,3476,3033,6509
8690,19001,15-19,223,206,429
8691,19001,20-24,160,185,345
8692,19001,25-29,201,220,421
8693,19001,30-34,204,221,425
8694,19001,35-39,226,212,438
8695,19001,40-44,203,214,417
8696,19001,45-49,184,184,368
8697,19001,50-54,209,216,425
8698,19001,55-59,267,281,548
8699,19001,60-64,301,316,617
8700,19001,65+,881,792,1673
8701,19003,15-19,106,94,200
8702,19003,20-24,63,80,143
8703,19003,25-29,85,88,173
8704,19003,30-34,104,98,202
8705,19003,35-39,94,102,196
8706,19003,40-44,108,97,205
8707,19003,45-49,74,92,166
8708,19003,50-54,92,94,186
8709,19003,55-59,152,129,281
8710,19003,60-64,169,187,356
8711,19003,65+,458,411,869
8712,19005,15-19,378,432,810
8713,19005,20-24,291,343,634
8714,19005,25-29,351,385,736
8715,19005,30-34,330,336,666
8716,19005,35-39,358,388,746
8717,19005,40-44,361,368,729
8718,19005,45-49,327,354,681
8719,19005,50-54,387,401,788
8720,19005,55-59,487,491,978
8721,19005,60-64,521,587,1108
8722,19005,65+,1661,1587,3248
8723,19007,15-19,369,387,756
8724,19007,20-24,269,299,568
8725,19007,25-29,303,305,608
8726,19007,30-34,317,299,616
8727,19007,35-39,353,332,685
8728,19007,40-44,340,344,684
8729,19007,45-49,338,327,665
8730,19007,50-54,366,377,743
8731,19007,55-59,426,456,882
8732,19007,60-64,451,443,894
8733,19007,65+,1520,1369,2889
8734,19009,15-19,145,158,303
8735,19009,20-24,131,125,256
8736,19009,25-29,154,151,305
8737,19009,30-34,142,130,272
8738,19009,35-39,140,133,273
8739,19009,40-44,147,164,311
8740,19009,45-49,153,130,283
8741,19009,50-54,147,173,320
8742,19009,55-59,219,199,418
8743,19009,60-64,222,251,473
8744,19009,65+,778,633,1411
8745,19011,15-19,814,842,1656
8746,19011,20-24,614,656,1270
8747,19011,25-29,639,720,1359
8748,19011,30-34,674,743,1417
8749,19011,35-39,739,733,1472
8750,19011,40-44,801,789,1590
8751,19011,45-49,718,765,1483
8752,19011,50-54,864,831,1695
8753,19011,55-59,1015,1037,2052
8754,19011,60-64,964,1030,1994
8755,19011,65+,2500,2354,4854
8756,19013,15-19,4643,4326,8969
8757,19013,20-24,7391,6904,14295
8758,19013,25-29,4279,4505,8784
8759,19013,30-34,3829,4087,7916
8760,19013,35-39,3904,4050,7954
8761,19013,40-44,3653,3818,7471
8762,19013,45-49,3173,3299,6472
8763,19013,50-54,3368,3478,6846
8764,19013,55-59,3672,3567,7239
8765,19013,60-64,4051,3782,7833
8766,19013,65+,12371,10296,22667
8767,19015,15-19,662,982,1644
8768,19015,20-24,614,737,1351
8769,19015,25-29,773,852,1625
8770,19015,30-34,844,861,1705
8771,19015,35-39,873,934,1807
8772,19015,40-44,857,919,1776
8773,19015,45-49,772,819,1591
8774,19015,50-54,787,867,1654
8775,19015,55-59,936,952,1888
8776,19015,60-64,1051,1074,2125
8777,19015,65+,2701,2395,5096
8778,19017,15-19,1052,1033,2085
8779,19017,20-24,956,980,1936
8780,19017,25-29,592,660,1252
8781,19017,30-34,687,683,1370
8782,19017,35-39,776,758,1534
8783,19017,40-44,775,814,1589
8784,19017,45-49,676,690,1366
8785,19017,50-54,676,736,1412
8786,19017,55-59,749,731,1480
8787,19017,60-64,778,789,1567
8788,19017,65+,2643,2243,4886
8789,19019,15-19,699,796,1495
8790,19019,20-24,484,558,1042
8791,19019,25-29,531,532,1063
8792,19019,30-34,561,582,1143
8793,19019,35-39,625,677,1302
8794,19019,40-44,645,671,1316
8795,19019,45-49,547,617,1164
8796,19019,50-54,591,566,1157
8797,19019,55-59,712,685,1397
8798,19019,60-64,712,721,1433
8799,19019,65+,2025,1781,3806
8800,19021,15-19,766,917,1683
8801,19021,20-24,739,717,1456
8802,19021,25-29,619,616,1235
8803,19021,30-34,589,651,1240
8804,19021,35-39,649,780,1429
8805,19021,40-44,533,647,1180
8806,19021,45-49,495,496,991
8807,19021,50-54,527,546,1073
8808,19021,55-59,569,606,1175
8809,19021,60-64,680,694,1374
8810,19021,65+,1737,1631,3368
8811,19023,15-19,423,459,882
8812,19023,20-24,330,363,693
8813,19023,25-29,362,391,753
8814,19023,30-34,345,357,702
8815,19023,35-39,442,417,859
8816,19023,40-44,439,456,895
8817,19023,45-49,387,390,777
8818,19023,50-54,449,421,870
8819,19023,55-59,477,467,944
8820,19023,60-64,515,512,1027
8821,19023,65+,1724,1550,3274
8822,19025,15-19,254,324,578
8823,19025,20-24,198,330,528
8824,19025,25-29,235,336,571
8825,19025,30-34,279,349,628
8826,19025,35-39,249,317,566
8827,19025,40-44,245,328,573
8828,19025,45-49,199,284,483
8829,19025,50-54,273,280,553
8830,19025,55-59,285,319,604
8831,19025,60-64,364,393,757
8832,19025,65+,1246,1068,2314
8833,19027,15-19,643,689,1332
8834,19027,20-24,510,540,1050
8835,19027,25-29,560,546,1106
8836,19027,30-34,551,553,1104
8837,19027,35-39,556,628,1184
8838,19027,40-44,577,591,1168
8839,19027,45-49,507,522,1029
8840,19027,50-54,572,610,1182
8841,19027,55-59,721,728,1449
8842,19027,60-64,761,800,1561
8843,19027,65+,2383,1945,4328
8844,19029,15-19,387,443,830
8845,19029,20-24,260,315,575
8846,19029,25-29,347,339,686
8847,19029,30-34,344,346,690
8848,19029,35-39,343,383,726
8849,19029,40-44,367,429,796
8850,19029,45-49,338,362,700
8851,19029,50-54,336,368,704
8852,19029,55-59,463,440,903
8853,19029,60-64,518,486,1004
8854,19029,65+,1650,1387,3037
8855,19031,15-19,571,610,1181
8856,19031,20-24,424,444,868
8857,19031,25-29,447,460,907
8858,19031,30-34,508,513,1021
8859,19031,35-39,553,584,1137
8860,19031,40-44,595,622,1217
8861,19031,45-49,518,581,1099
8862,19031,50-54,576,582,1158
8863,19031,55-59,694,665,1359
8864,19031,60-64,721,758,1479
8865,19031,65+,1997,1777,3774
8866,19033,15-19,1202,1316,2518
8867,19033,20-24,1129,1200,2329
8868,19033,25-29,1188,1206,2394
8869,19033,30-34,1191,1176,2367
8870,19033,35-39,1194,1255,2449
8871,19033,40-44,1186,1267,2453
8872,19033,45-49,1084,1055,2139
8873,19033,50-54,1245,1261,2506
8874,19033,55-59,1510,1449,2959
8875,19033,60-64,1759,1679,3438
8876,19033,65+,5373,4381,9754
8877,19035,15-19,318,328,646
8878,19035,20-24,251,242,493
8879,19035,25-29,279,288,567
8880,19035,30-34,311,332,643
8881,19035,35-39,288,373,661
8882,19035,40-44,299,342,641
8883,19035,45-49,261,292,553
8884,19035,50-54,305,322,627
8885,19035,55-59,400,402,802
8886,19035,60-64,450,483,933
8887,19035,65+,1506,1295,2801
8888,19037,15-19,374,383,757
8889,19037,20-24,283,323,606
8890,19037,25-29,278,347,625
8891,19037,30-34,316,286,602
8892,19037,35-39,303,346,649
8893,19037,40-44,337,350,687
8894,19037,45-49,265,308,573
8895,19037,50-54,335,381,716
8896,19037,55-59,393,443,836
8897,19037,60-64,483,512,995
8898,19037,65+,1323,1225,2548
8899,19039,15-19,309,386,695
8900,19039,20-24,269,263,532
8901,19039,25-29,233,261,494
8902,19039,30-34,245,294,539
8903,19039,35-39,252,310,562
8904,19039,40-44,276,296,572
8905,19039,45-49,317,251,568
8906,19039,50-54,264,322,586
8907,19039,55-59,310,336,646
8908,19039,60-64,311,356,667
8909,19039,65+,987,858,1845
8910,19041,15-19,520,502,1022
8911,19041,20-24,419,400,819
8912,19041,25-29,427,443,870
8913,19041,30-34,463,500,963
8914,19041,35-39,514,509,1023
8915,19041,40-44,482,493,975
8916,19041,45-49,434,448,882
8917,19041,50-54,444,469,913
8918,19041,55-59,510,518,1028
8919,19041,60-64,636,616,1252
8920,19041,65+,1919,1675,3594
8921,19043,15-19,481,486,967
8922,19043,20-24,390,400,790
8923,19043,25-29,427,438,865
8924,19043,30-34,422,431,853
8925,19043,35-39,443,468,911
8926,19043,40-44,416,469,885
8927,19043,45-49,375,483,858
8928,19043,50-54,488,519,1007
8929,19043,55-59,577,610,1187
8930,19043,60-64,738,771,1509
8931,19043,65+,2181,2001,4182
8932,19045,15-19,1340,1409,2749
8933,19045,20-24,1242,1209,2451
8934,19045,25-29,1360,1320,2680
8935,19045,30-34,1317,1289,2606
8936,19045,35-39,1336,1345,2681
8937,19045,40-44,1385,1423,2808
8938,19045,45-49,1264,1234,2498
8939,19045,50-54,1423,1464,2887
8940,19045,55-59,1687,1655,3342
8941,19045,60-64,1788,1784,3572
8942,19045,65+,5037,4330,9367
8943,19047,15-19,543,644,1187
8944,19047,20-24,474,540,1014
8945,19047,25-29,489,450,939
8946,19047,30-34,500,487,987
8947,19047,35-39,394,509,903
8948,19047,40-44,423,518,941
8949,19047,45-49,418,511,929
8950,19047,50-54,455,497,952
8951,19047,55-59,491,524,1015
8952,19047,60-64,486,573,1059
8953,19047,65+,1521,1401,2922
8954,19049,15-19,3246,3380,6626
8955,19049,20-24,2833,2790,5623
8956,19049,25-29,3617,3657,7274
8957,19049,30-34,3739,3742,7481
8958,19049,35-39,4340,4373,8713
8959,19049,40-44,4110,4263,8373
8960,19049,45-49,3192,3349,6541
8961,19049,50-54,3133,3232,6365
8962,19049,55-59,2712,2764,5476
8963,19049,60-64,2592,2456,5048
8964,19049,65+,7234,5662,12896
8965,19051,15-19,334,336,670
8966,19051,20-24,241,250,491
8967,19051,25-29,217,246,463
8968,19051,30-34,239,242,481
8969,19051,35-39,233,246,479
8970,19051,40-44,262,263,525
8971,19051,45-49,225,241,466
8972,19051,50-54,234,263,497
8973,19051,55-59,273,277,550
8974,19051,60-64,286,302,588
8975,19051,65+,874,776,1650
8976,19053,15-19,324,348,672
8977,19053,20-24,391,480,871
8978,19053,25-29,185,218,403
8979,19053,30-34,176,179,355
8980,19053,35-39,190,182,372
8981,19053,40-44,194,170,364
8982,19053,45-49,172,199,371
8983,19053,50-54,186,176,362
8984,19053,55-59,210,206,416
8985,19053,60-64,250,247,497
8986,19053,65+,850,723,1573
8987,19055,15-19,551,602,1153
8988,19055,20-24,450,470,920
8989,19055,25-29,395,457,852
8990,19055,30-34,406,409,815
8991,19055,35-39,469,522,991
8992,19055,40-44,494,492,986
8993,19055,45-49,462,469,931
8994,19055,50-54,504,567,1071
8995,19055,55-59,680,687,1367
8996,19055,60-64,719,773,1492
8997,19055,65+,1862,1729,3591
8998,19057,15-19,1142,1165,2307
8999,19057,20-24,1004,1044,2048
9000,19057,25-29,1102,1107,2209
9001,19057,30-34,1063,1006,2069
9002,19057,35-39,1205,1134,2339
9003,19057,40-44,1162,1201,2363
9004,19057,45-49,1055,1032,2087
9005,19057,50-54,1193,1166,2359
9006,19057,55-59,1333,1286,2619
9007,19057,60-64,1403,1372,2775
9008,19057,65+,4442,3747,8189
9009,19059,15-19,427,503,930
9010,19059,20-24,457,421,878
9011,19059,25-29,433,435,868
9012,19059,30-34,425,485,910
9013,19059,35-39,442,506,948
9014,19059,40-44,473,512,985
9015,19059,45-49,430,470,900
9016,19059,50-54,532,542,1074
9017,19059,55-59,608,589,1197
9018,19059,60-64,750,720,1470
9019,19059,65+,2579,2265,4844
9020,19061,15-19,3329,3473,6802
9021,19061,20-24,3291,3470,6761
9022,19061,25-29,3132,3351,6483
9023,19061,30-34,3001,3116,6117
9024,19061,35-39,3002,3142,6144
9025,19061,40-44,2741,2782,5523
9026,19061,45-49,2433,2492,4925
9027,19061,50-54,2819,2935,5754
9028,19061,55-59,3239,3252,6491
9029,19061,60-64,3341,3353,6694
9030,19061,65+,10242,8201,18443
9031,19063,15-19,370,340,710
9032,19063,20-24,234,314,548
9033,19063,25-29,262,266,528
9034,19063,30-34,225,262,487
9035,19063,35-39,257,288,545
9036,19063,40-44,268,328,596
9037,19063,45-49,259,241,500
9038,19063,50-54,262,272,534
9039,19063,55-59,298,313,611
9040,19063,60-64,366,397,763
9041,19063,65+,1118,949,2067
9042,19065,15-19,612,722,1334
9043,19065,20-24,538,594,1132
9044,19065,25-29,444,559,1003
9045,19065,30-34,522,543,1065
9046,19065,35-39,512,516,1028
9047,19065,40-44,511,546,1057
9048,19065,45-49,456,486,942
9049,19065,50-54,549,580,1129
9050,19065,55-59,668,723,1391
9051,19065,60-64,763,800,1563
9052,19065,65+,2297,1946,4243
9053,19067,15-19,448,501,949
9054,19067,20-24,373,421,794
9055,19067,25-29,428,406,834
9056,19067,30-34,416,394,810
9057,19067,35-39,412,441,853
9058,19067,40-44,427,425,852
9059,19067,45-49,399,424,823
9060,19067,50-54,463,462,925
9061,19067,55-59,547,572,1119
9062,19067,60-64,564,545,1109
9063,19067,65+,1824,1588,3412
9064,19069,15-19,284,358,642
9065,19069,20-24,251,235,486
9066,19069,25-29,250,252,502
9067,19069,30-34,241,241,482
9068,19069,35-39,273,328,601
9069,19069,40-44,277,315,592
9070,19069,45-49,240,265,505
9071,19069,50-54,287,287,574
9072,19069,55-59,325,327,652
9073,19069,60-64,394,381,775
9074,19069,65+,1158,1068,2226
9075,19071,15-19,184,215,399
9076,19071,20-24,146,166,312
9077,19071,25-29,177,185,362
9078,19071,30-34,143,165,308
9079,19071,35-39,171,187,358
9080,19071,40-44,177,198,375
9081,19071,45-49,197,188,385
9082,19071,50-54,178,200,378
9083,19071,55-59,242,224,466
9084,19071,60-64,248,281,529
9085,19071,65+,793,724,1517
9086,19073,15-19,245,268,513
9087,19073,20-24,217,241,458
9088,19073,25-29,219,217,436
9089,19073,30-34,215,226,441
9090,19073,35-39,248,262,510
9091,19073,40-44,224,254,478
9092,19073,45-49,219,230,449
9093,19073,50-54,235,267,502
9094,19073,55-59,314,314,628
9095,19073,60-64,342,313,655
9096,19073,65+,1096,944,2040
9097,19075,15-19,388,374,762
9098,19075,20-24,299,329,628
9099,19075,25-29,316,326,642
9100,19075,30-34,340,345,685
9101,19075,35-39,384,381,765
9102,19075,40-44,372,409,781
9103,19075,45-49,322,348,670
9104,19075,50-54,358,383,741
9105,19075,55-59,400,422,822
9106,19075,60-64,459,442,901
9107,19075,65+,1397,1203,2600
9108,19077,15-19,314,366,680
9109,19077,20-24,234,263,497
9110,19077,25-29,248,263,511
9111,19077,30-34,242,250,492
9112,19077,35-39,284,297,581
9113,19077,40-44,318,325,643
9114,19077,45-49,275,304,579
9115,19077,50-54,316,335,651
9116,19077,55-59,412,390,802
9117,19077,60-64,439,454,893
9118,19077,65+,1295,1184,2479
9119,19079,15-19,428,482,910
9120,19079,20-24,352,374,726
9121,19079,25-29,370,394,764
9122,19079,30-34,384,397,781
9123,19079,35-39,420,460,880
9124,19079,40-44,457,424,881
9125,19079,45-49,397,429,826
9126,19079,50-54,435,461,896
9127,19079,55-59,522,568,1090
9128,19079,60-64,569,603,1172
9129,19079,65+,1708,1427,3135
9130,19081,15-19,307,349,656
9131,19081,20-24,249,293,542
9132,19081,25-29,265,296,561
9133,19081,30-34,269,273,542
9134,19081,35-39,292,329,621
9135,19081,40-44,300,327,627
9136,19081,45-49,291,297,588
9137,19081,50-54,268,278,546
9138,19081,55-59,372,384,756
9139,19081,60-64,425,425,850
9140,19081,65+,1331,1185,2516
9141,19083,15-19,463,664,1127
9142,19083,20-24,406,468,874
9143,19083,25-29,412,483,895
9144,19083,30-34,421,461,882
9145,19083,35-39,515,513,1028
9146,19083,40-44,477,535,1012
9147,19083,45-49,441,485,926
9148,19083,50-54,465,505,970
9149,19083,55-59,622,588,1210
9150,19083,60-64,673,690,1363
9151,19083,65+,2082,1805,3887
9152,19085,15-19,446,450,896
9153,19085,20-24,317,381,698
9154,19085,25-29,396,398,794
9155,19085,30-34,368,396,764
9156,19085,35-39,450,438,888
9157,19085,40-44,414,440,854
9158,19085,45-49,415,467,882
9159,19085,50-54,452,454,906
9160,19085,55-59,514,535,1049
9161,19085,60-64,590,615,1205
9162,19085,65+,1491,1374,2865
9163,19087,15-19,625,739,1364
9164,19087,20-24,646,771,1417
9165,19087,25-29,519,720,1239
9166,19087,30-34,486,645,1131
9167,19087,35-39,555,734,1289
9168,19087,40-44,564,633,1197
9169,19087,45-49,544,597,1141
9170,19087,50-54,593,671,1264
9171,19087,55-59,690,736,1426
9172,19087,60-64,669,700,1369
9173,19087,65+,2152,1849,4001
9174,19089,15-19,301,336,637
9175,19089,20-24,226,243,469
9176,19089,25-29,257,258,515
9177,19089,30-34,255,238,493
9178,19089,35-39,261,293,554
9179,19089,40-44,268,293,561
9180,19089,45-49,226,244,470
9181,19089,50-54,251,271,522
9182,19089,55-59,331,345,676
9183,19089,60-64,347,360,707
9184,19089,65+,994,924,1918
9185,19091,15-19,302,310,612
9186,19091,20-24,223,228,451
9187,19091,25-29,228,263,491
9188,19091,30-34,271,271,542
9189,19091,35-39,320,315,635
9190,19091,40-44,264,308,572
9191,19091,45-49,212,207,419
9192,19091,50-54,252,273,525
9193,19091,55-59,320,330,650
9194,19091,60-64,409,372,781
9195,19091,65+,1091,962,2053
9196,19093,15-19,211,248,459
9197,19093,20-24,182,207,389
9198,19093,25-29,167,180,347
9199,19093,30-34,174,171,345
9200,19093,35-39,200,204,404
9201,19093,40-44,201,210,411
9202,19093,45-49,164,181,345
9203,19093,50-54,192,194,386
9204,19093,55-59,231,203,434
9205,19093,60-64,249,271,520
9206,19093,65+,787,696,1483
9207,19095,15-19,502,527,1029
9208,19095,20-24,383,413,796
9209,19095,25-29,429,468,897
9210,19095,30-34,448,449,897
9211,19095,35-39,493,534,1027
9212,19095,40-44,502,515,1017
9213,19095,45-49,434,454,888
9214,19095,50-54,479,537,1016
9215,19095,55-59,618,642,1260
9216,19095,60-64,671,695,1366
9217,19095,65+,1742,1473,3215
9218,19097,15-19,581,595,1176
9219,19097,20-24,438,522,960
9220,19097,25-29,494,524,1018
9221,19097,30-34,481,493,974
9222,19097,35-39,509,566,1075
9223,19097,40-44,497,544,1041
9224,19097,45-49,503,522,1025
9225,19097,50-54,605,609,1214
9226,19097,55-59,773,776,1549
9227,19097,60-64,801,812,1613
9228,19097,65+,2209,1981,4190
9229,19099,15-19,1111,1194,2305
9230,19099,20-24,896,1110,2006
9231,19099,25-29,1015,1258,2273
9232,19099,30-34,1041,1328,2369
9233,19099,35-39,1119,1314,2433
9234,19099,40-44,1123,1340,2463
9235,19099,45-49,940,1246,2186
9236,19099,50-54,1124,1294,2418
9237,19099,55-59,1252,1290,2542
9238,19099,60-64,1332,1377,2709
9239,19099,65+,3974,3323,7297
9240,19101,15-19,331,375,706
9241,19101,20-24,370,1028,1398
9242,19101,25-29,395,764,1159
9243,19101,30-34,413,570,983
9244,19101,35-39,408,534,942
9245,19101,40-44,424,449,873
9246,19101,45-49,397,412,809
9247,19101,50-54,423,425,848
9248,19101,55-59,459,451,910
9249,19101,60-64,580,570,1150
9250,19101,65+,1962,1857,3819
9251,19103,15-19,6774,6277,13051
9252,19103,20-24,12131,11324,23455
9253,19103,25-29,6177,6620,12797
9254,19103,30-34,5032,5355,10387
9255,19103,35-39,4884,5132,10016
9256,19103,40-44,4499,4825,9324
9257,19103,45-49,3627,4029,7656
9258,19103,50-54,3805,3947,7752
9259,19103,55-59,3731,3659,7390
9260,19103,60-64,3874,3620,7494
9261,19103,65+,10923,9013,19936
9262,19105,15-19,582,671,1253
9263,19105,20-24,456,577,1033
9264,19105,25-29,500,635,1135
9265,19105,30-34,537,657,1194
9266,19105,35-39,617,712,1329
9267,19105,40-44,589,774,1363
9268,19105,45-49,552,664,1216
9269,19105,50-54,602,689,1291
9270,19105,55-59,734,816,1550
9271,19105,60-64,748,773,1521
9272,19105,65+,2313,2113,4426
9273,19107,15-19,292,357,649
9274,19107,20-24,200,259,459
9275,19107,25-29,263,289,552
9276,19107,30-34,244,263,507
9277,19107,35-39,296,289,585
9278,19107,40-44,289,320,609
9279,19107,45-49,252,263,515
9280,19107,50-54,286,295,581
9281,19107,55-59,334,333,667
9282,19107,60-64,369,393,762
9283,19107,65+,1156,1038,2194
9284,19109,15-19,440,456,896
9285,19109,20-24,330,353,683
9286,19109,25-29,324,396,720
9287,19109,30-34,360,401,761
9288,19109,35-39,400,405,805
9289,19109,40-44,370,415,785
9290,19109,45-49,343,352,695
9291,19109,50-54,371,402,773
9292,19109,55-59,504,542,1046
9293,19109,60-64,555,635,1190
9294,19109,65+,1883,1710,3593
9295,19111,15-19,891,940,1831
9296,19111,20-24,802,951,1753
9297,19111,25-29,898,1033,1931
9298,19111,30-34,914,994,1908
9299,19111,35-39,943,1047,1990
9300,19111,40-44,939,1098,2037
9301,19111,45-49,901,943,1844
9302,19111,50-54,992,1042,2034
9303,19111,55-59,1175,1224,2399
9304,19111,60-64,1246,1272,2518
9305,19111,65+,3855,3246,7101
9306,19113,15-19,7435,7612,15047
9307,19113,20-24,7423,7367,14790
9308,19113,25-29,7454,7658,15112
9309,19113,30-34,7468,7680,15148
9310,19113,35-39,7723,7870,15593
9311,19113,40-44,7487,7717,15204
9312,19113,45-49,6746,6740,13486
9313,19113,50-54,6985,7231,14216
9314,19113,55-59,7366,7388,14754
9315,19113,60-64,7381,7135,14516
9316,19113,65+,21028,17135,38163
9317,19115,15-19,290,368,658
9318,19115,20-24,254,314,568
9319,19115,25-29,278,344,622
9320,19115,30-34,285,287,572
9321,19115,35-39,307,346,653
9322,19115,40-44,352,369,721
9323,19115,45-49,291,312,603
9324,19115,50-54,309,347,656
9325,19115,55-59,422,430,852
9326,19115,60-64,398,390,788
9327,19115,65+,1140,993,2133
9328,19117,15-19,254,245,499
9329,19117,20-24,186,239,425
9330,19117,25-29,242,248,490
9331,19117,30-34,218,241,459
9332,19117,35-39,196,223,419
9333,19117,40-44,240,250,490
9334,19117,45-49,214,228,442
9335,19117,50-54,244,281,525
9336,19117,55-59,304,324,628
9337,19117,60-64,355,366,721
9338,19117,65+,999,926,1925
9339,19119,15-19,411,496,907
9340,19119,20-24,300,347,647
9341,19119,25-29,282,360,642
9342,19119,30-34,313,307,620
9343,19119,35-39,345,353,698
9344,19119,40-44,384,413,797
9345,19119,45-49,313,339,652
9346,19119,50-54,289,314,603
9347,19119,55-59,327,359,686
9348,19119,60-64,351,394,745
9349,19119,65+,1224,1021,2245
9350,19121,15-19,544,658,1202
9351,19121,20-24,403,425,828
9352,19121,25-29,411,370,781
9353,19121,30-34,456,423,879
9354,19121,35-39,533,518,1051
9355,19121,40-44,579,623,1202
9356,19121,45-49,523,555,1078
9357,19121,50-54,583,590,1173
9358,19121,55-59,596,567,1163
9359,19121,60-64,554,577,1131
9360,19121,65+,1544,1359,2903
9361,19123,15-19,701,970,1671
9362,19123,20-24,660,875,1535
9363,19123,25-29,590,652,1242
9364,19123,30-34,605,625,1230
9365,19123,35-39,652,674,1326
9366,19123,40-44,638,699,1337
9367,19123,45-49,591,627,1218
9368,19123,50-54,611,630,1241
9369,19123,55-59,618,708,1326
9370,19123,60-64,776,796,1572
9371,19123,65+,2128,1853,3981
9372,19125,15-19,1218,1312,2530
9373,19125,20-24,1120,1233,2353
9374,19125,25-29,822,911,1733
9375,19125,30-34,833,900,1733
9376,19125,35-39,977,1028,2005
9377,19125,40-44,1030,1044,2074
9378,19125,45-49,892,952,1844
9379,19125,50-54,971,1005,1976
9380,19125,55-59,1122,1182,2304
9381,19125,60-64,1108,1167,2275
9382,19125,65+,3352,2847,6199
9383,19127,15-19,1363,1503,2866
9384,19127,20-24,1085,1252,2337
9385,19127,25-29,1103,1312,2415
9386,19127,30-34,1159,1181,2340
9387,19127,35-39,1186,1266,2452
9388,19127,40-44,1038,1222,2260
9389,19127,45-49,1024,1109,2133
9390,19127,50-54,1128,1207,2335
9391,19127,55-59,1255,1302,2557
9392,19127,60-64,1350,1322,2672
9393,19127,65+,3841,3380,7221
9394,19129,15-19,455,519,974
9395,19129,20-24,325,347,672
9396,19129,25-29,355,352,707
9397,19129,30-34,364,345,709
9398,19129,35-39,413,452,865
9399,19129,40-44,466,453,919
9400,19129,45-49,429,498,927
9401,19129,50-54,517,509,1026
9402,19129,55-59,505,532,1037
9403,19129,60-64,537,549,1086
9404,19129,65+,1481,1385,2866
9405,19131,15-19,330,352,682
9406,19131,20-24,267,291,558
9407,19131,25-29,250,319,569
9408,19131,30-34,281,282,563
9409,19131,35-39,293,300,593
9410,19131,40-44,273,304,577
9411,19131,45-49,260,282,542
9412,19131,50-54,299,294,593
9413,19131,55-59,401,393,794
9414,19131,60-64,393,427,820
9415,19131,65+,1175,1020,2195
9416,19133,15-19,276,290,566
9417,19133,20-24,190,213,403
9418,19133,25-29,242,247,489
9419,19133,30-34,217,219,436
9420,19133,35-39,231,211,442
9421,19133,40-44,229,225,454
9422,19133,45-49,210,212,422
9423,19133,50-54,247,237,484
9424,19133,55-59,294,301,595
9425,19133,60-64,346,348,694
9426,19133,65+,1135,936,2071
9427,19135,15-19,240,252,492
9428,19135,20-24,187,217,404
9429,19135,25-29,214,207,421
9430,19135,30-34,197,209,406
9431,19135,35-39,217,219,436
9432,19135,40-44,218,239,457
9433,19135,45-49,196,205,401
9434,19135,50-54,239,270,509
9435,19135,55-59,278,244,522
9436,19135,60-64,295,285,580
9437,19135,65+,819,697,1516
9438,19137,15-19,308,331,639
9439,19137,20-24,258,278,536
9440,19137,25-29,276,281,557
9441,19137,30-34,267,280,547
9442,19137,35-39,263,275,538
9443,19137,40-44,281,295,576
9444,19137,45-49,300,281,581
9445,19137,50-54,302,312,614
9446,19137,55-59,368,335,703
9447,19137,60-64,393,424,817
9448,19137,65+,1255,1019,2274
9449,19139,15-19,1409,1470,2879
9450,19139,20-24,1221,1250,2471
9451,19139,25-29,1250,1343,2593
9452,19139,30-34,1296,1370,2666
9453,19139,35-39,1276,1370,2646
9454,19139,40-44,1272,1344,2616
9455,19139,45-49,1181,1256,2437
9456,19139,50-54,1324,1305,2629
9457,19139,55-59,1380,1440,2820
9458,19139,60-64,1415,1443,2858
9459,19139,65+,4040,3509,7549
9460,19141,15-19,444,493,937
9461,19141,20-24,362,438,800
9462,19141,25-29,399,432,831
9463,19141,30-34,334,396,730
9464,19141,35-39,374,445,819
9465,19141,40-44,407,451,858
9466,19141,45-49,348,346,694
9467,19141,50-54,354,415,769
9468,19141,55-59,441,429,870
9469,19141,60-64,497,524,1021
9470,19141,65+,1577,1346,2923
9471,19143,15-19,192,218,410
9472,19143,20-24,131,154,285
9473,19143,25-29,153,159,312
9474,19143,30-34,142,181,323
9475,19143,35-39,148,194,342
9476,19143,40-44,175,154,329
9477,19143,45-49,139,151,290
9478,19143,50-54,174,198,372
9479,19143,55-59,208,211,419
9480,19143,60-64,240,259,499
9481,19143,65+,741,665,1406
9482,19145,15-19,329,570,899
9483,19145,20-24,308,492,800
9484,19145,25-29,397,562,959
9485,19145,30-34,386,561,947
9486,19145,35-39,403,576,979
9487,19145,40-44,410,594,1004
9488,19145,45-49,386,550,936
9489,19145,50-54,384,521,905
9490,19145,55-59,493,492,985
9491,19145,60-64,564,557,1121
9492,19145,65+,1873,1609,3482
9493,19147,15-19,282,337,619
9494,19147,20-24,208,257,465
9495,19147,25-29,242,253,495
9496,19147,30-34,226,255,481
9497,19147,35-39,251,294,545
9498,19147,40-44,229,238,467
9499,19147,45-49,230,222,452
9500,19147,50-54,227,220,447
9501,19147,55-59,277,291,568
9502,19147,60-64,327,356,683
9503,19147,65+,1095,905,2000
9504,19149,15-19,828,914,1742
9505,19149,20-24,654,728,1382
9506,19149,25-29,652,686,1338
9507,19149,30-34,666,710,1376
9508,19149,35-39,751,787,1538
9509,19149,40-44,820,864,1684
9510,19149,45-49,672,701,1373
9511,19149,50-54,740,817,1557
9512,19149,55-59,840,819,1659
9513,19149,60-64,904,958,1862
9514,19149,65+,2612,2294,4906
9515,19151,15-19,236,208,444
9516,19151,20-24,147,168,315
9517,19151,25-29,156,185,341
9518,19151,30-34,175,186,361
9519,19151,35-39,181,198,379
9520,19151,40-44,178,187,365
9521,19151,45-49,143,179,322
9522,19151,50-54,186,196,382
9523,19151,55-59,267,270,537
9524,19151,60-64,300,328,628
9525,19151,65+,904,769,1673
9526,19153,15-19,16051,16290,32341
9527,19153,20-24,15931,15433,31364
9528,19153,25-29,18633,19306,37939
9529,19153,30-34,18322,19025,37347
9530,19153,35-39,18033,19255,37288
9531,19153,40-44,16512,17357,33869
9532,19153,45-49,14533,14965,29498
9533,19153,50-54,15012,15503,30515
9534,19153,55-59,14835,14798,29633
9535,19153,60-64,14549,13730,28279
9536,19153,65+,37750,30125,67875
9537,19155,15-19,3120,3374,6494
9538,19155,20-24,2508,2688,5196
9539,19155,25-29,2700,2728,5428
9540,19155,30-34,2800,2818,5618
9541,19155,35-39,2886,2858,5744
9542,19155,40-44,2953,2911,5864
9543,19155,45-49,2666,2731,5397
9544,19155,50-54,2833,2757,5590
9545,19155,55-59,3228,3128,6356
9546,19155,60-64,3383,3287,6670
9547,19155,65+,9334,7711,17045
9548,19157,15-19,795,781,1576
9549,19157,20-24,902,878,1780
9550,19157,25-29,417,465,882
9551,19157,30-34,472,456,928
9552,19157,35-39,530,544,1074
9553,19157,40-44,473,496,969
9554,19157,45-49,493,448,941
9555,19157,50-54,473,530,1003
9556,19157,55-59,638,555,1193
9557,19157,60-64,683,652,1335
9558,19157,65+,2130,1784,3914
9559,19159,15-19,158,167,325
9560,19159,20-24,118,134,252
9561,19159,25-29,97,92,189
9562,19159,30-34,119,110,229
9563,19159,35-39,126,150,276
9564,19159,40-44,117,126,243
9565,19159,45-49,112,119,231
9566,19159,50-54,114,126,240
9567,19159,55-59,165,163,328
9568,19159,60-64,202,182,384
9569,19159,65+,596,514,1110
9570,19161,15-19,284,300,584
9571,19161,20-24,224,247,471
9572,19161,25-29,245,249,494
9573,19161,30-34,251,268,519
9574,19161,35-39,258,257,515
9575,19161,40-44,233,286,519
9576,19161,45-49,229,226,455
9577,19161,50-54,284,296,580
9578,19161,55-59,342,336,678
9579,19161,60-64,406,408,814
9580,19161,65+,1265,1067,2332
9581,19163,15-19,5675,5809,11484
9582,19163,20-24,5070,5017,10087
9583,19163,25-29,5345,5415,10760
9584,19163,30-34,5732,5404,11136
9585,19163,35-39,6016,6007,12023
9586,19163,40-44,5739,5960,11699
9587,19163,45-49,4988,5168,10156
9588,19163,50-54,5383,5462,10845
9589,19163,55-59,5537,5481,11018
9590,19163,60-64,5889,5579,11468
9591,19163,65+,16166,13588,29754
9592,19165,15-19,355,388,743
9593,19165,20-24,280,322,602
9594,19165,25-29,273,283,556
9595,19165,30-34,292,281,573
9596,19165,35-39,309,306,615
9597,19165,40-44,292,289,581
9598,19165,45-49,315,325,640
9599,19165,50-54,348,358,706
9600,19165,55-59,466,423,889
9601,19165,60-64,464,505,969
9602,19165,65+,1446,1232,2678
9603,19167,15-19,1712,1606,3318
9604,19167,20-24,1543,1567,3110
9605,19167,25-29,922,992,1914
9606,19167,30-34,882,942,1824
9607,19167,35-39,1040,1149,2189
9608,19167,40-44,1047,1083,2130
9609,19167,45-49,807,877,1684
9610,19167,50-54,842,935,1777
9611,19167,55-59,927,1012,1939
9612,19167,60-64,1036,1112,2148
9613,19167,65+,3166,2651,5817
9614,19169,15-19,5379,5835,11214
9615,19169,20-24,9064,11774,20838
9616,19169,25-29,3247,4352,7599
9617,19169,30-34,2640,2934,5574
9618,19169,35-39,2421,2682,5103
9619,19169,40-44,2460,2626,5086
9620,19169,45-49,2021,2199,4220
9621,19169,50-54,1986,2149,4135
9622,19169,55-59,2263,2214,4477
9623,19169,60-64,2423,2376,4799
9624,19169,65+,7003,5949,12952
9625,19171,15-19,487,643,1130
9626,19171,20-24,444,476,920
9627,19171,25-29,427,442,869
9628,19171,30-34,413,458,871
9629,19171,35-39,427,506,933
9630,19171,40-44,488,460,948
9631,19171,45-49,441,446,887
9632,19171,50-54,548,559,1107
9633,19171,55-59,584,598,1182
9634,19171,60-64,622,653,1275
9635,19171,65+,1832,1609,3441
9636,19173,15-19,155,199,354
9637,19173,20-24,137,179,316
9638,19173,25-29,142,143,285
9639,19173,30-34,149,137,286
9640,19173,35-39,172,201,373
9641,19173,40-44,158,195,353
9642,19173,45-49,147,132,279
9643,19173,50-54,155,166,321
9644,19173,55-59,197,205,402
9645,19173,60-64,219,206,425
9646,19173,65+,681,649,1330
9647,19175,15-19,440,479,919
9648,19175,20-24,378,331,709
9649,19175,25-29,322,333,655
9650,19175,30-34,310,311,621
9651,19175,35-39,385,385,770
9652,19175,40-44,352,343,695
9653,19175,45-49,331,322,653
9654,19175,50-54,336,353,689
9655,19175,55-59,377,381,758
9656,19175,60-64,452,410,862
9657,19175,65+,1374,1140,2514
9658,19177,15-19,203,241,444
9659,19177,20-24,180,177,357
9660,19177,25-29,174,188,362
9661,19177,30-34,178,173,351
9662,19177,35-39,207,190,397
9663,19177,40-44,180,232,412
9664,19177,45-49,173,213,386
9665,19177,50-54,207,240,447
9666,19177,55-59,265,252,517
9667,19177,60-64,276,279,555
9668,19177,65+,841,768,1609
9669,19179,15-19,1137,1190,2327
9670,19179,20-24,996,1030,2026
9671,19179,25-29,1098,1179,2277
9672,19179,30-34,1071,1169,2240
9673,19179,35-39,1039,1157,2196
9674,19179,40-44,1029,1140,2169
9675,19179,45-49,951,1047,1998
9676,19179,50-54,980,1067,2047
9677,19179,55-59,1139,1081,2220
9678,19179,60-64,1224,1191,2415
9679,19179,65+,3525,2978,6503
9680,19181,15-19,1918,1998,3916
9681,19181,20-24,1671,1650,3321
9682,19181,25-29,1466,1405,2871
9683,19181,30-34,1611,1612,3223
9684,19181,35-39,1851,1833,3684
9685,19181,40-44,1756,1811,3567
9686,19181,45-49,1543,1621,3164
9687,19181,50-54,1718,1717,3435
9688,19181,55-59,1722,1704,3426
9689,19181,60-64,1705,1652,3357
9690,19181,65+,4671,3974,8645
9691,19183,15-19,654,744,1398
9692,19183,20-24,597,596,1193
9693,19183,25-29,655,655,1310
9694,19183,30-34,634,678,1312
9695,19183,35-39,662,695,1357
9696,19183,40-44,632,645,1277
9697,19183,45-49,580,585,1165
9698,19183,50-54,671,638,1309
9699,19183,55-59,743,768,1511
9700,19183,60-64,753,795,1548
9701,19183,65+,2406,2055,4461
9702,19185,15-19,199,244,443
9703,19185,20-24,151,153,304
9704,19185,25-29,174,169,343
9705,19185,30-34,171,153,324
9706,19185,35-39,190,175,365
9707,19185,40-44,142,171,313
9708,19185,45-49,152,163,315
9709,19185,50-54,153,161,314
9710,19185,55-59,207,241,448
9711,19185,60-64,215,263,478
9712,19185,65+,764,663,1427
9713,19187,15-19,1166,1623,2789
9714,19187,20-24,1134,1776,2910
9715,19187,25-29,995,1493,2488
9716,19187,30-34,995,1222,2217
9717,19187,35-39,994,1098,2092
9718,19187,40-44,1019,1168,2187
9719,19187,45-49,829,973,1802
9720,19187,50-54,989,1082,2071
9721,19187,55-59,1167,1188,2355
9722,19187,60-64,1344,1369,2713
9723,19187,65+,3690,3203,6893
9724,19189,15-19,377,415,792
9725,19189,20-24,324,376,700
9726,19189,25-29,250,286,536
9727,19189,30-34,253,285,538
9728,19189,35-39,291,318,609
9729,19189,40-44,294,310,604
9730,19189,45-49,267,279,546
9731,19189,50-54,291,299,590
9732,19189,55-59,336,342,678
9733,19189,60-64,393,399,792
9734,19189,65+,1289,1051,2340
9735,19191,15-19,940,887,1827
9736,19191,20-24,964,914,1878
9737,19191,25-29,422,452,874
9738,19191,30-34,454,466,920
9739,19191,35-39,472,522,994
9740,19191,40-44,491,547,1038
9741,19191,45-49,476,491,967
9742,19191,50-54,545,570,1115
9743,19191,55-59,657,716,1373
9744,19191,60-64,783,799,1582
9745,19191,65+,2285,2104,4389
9746,19193,15-19,3885,4138,8023
9747,19193,20-24,3610,3586,7196
9748,19193,25-29,3304,3509,6813
9749,19193,30-34,3139,3410,6549
9750,19193,35-39,3318,3626,6944
9751,19193,40-44,3243,3313,6556
9752,19193,45-49,3018,2917,5935
9753,19193,50-54,2959,3116,6075
9754,19193,55-59,3106,3252,6358
9755,19193,60-64,3163,3065,6228
9756,19193,65+,8733,7377,16110
9757,19195,15-19,180,215,395
9758,19195,20-24,193,174,367
9759,19195,25-29,218,216,434
9760,19195,30-34,196,216,412
9761,19195,35-39,192,253,445
9762,19195,40-44,209,231,440
9763,19195,45-49,200,222,422
9764,19195,50-54,237,234,471
9765,19195,55-59,258,285,543
9766,19195,60-64,249,287,536
9767,19195,65+,850,784,1634
9768,19197,15-19,391,445,836
9769,19197,20-24,287,325,612
9770,19197,25-29,302,310,612
9771,19197,30-34,323,354,677
9772,19197,35-39,355,375,730
9773,19197,40-44,350,341,691
9774,19197,45-49,322,356,678
9775,19197,50-54,301,375,676
9776,19197,55-59,412,390,802
9777,19197,60-64,440,474,914
9778,19197,65+,1543,1420,2963
9779,20001,15-19,445,467,912
9780,20001,20-24,316,391,707
9781,20001,25-29,360,390,750
9782,20001,30-34,335,333,668
9783,20001,35-39,362,377,739
9784,20001,40-44,373,357,730
9785,20001,45-49,329,343,672
9786,20001,50-54,358,354,712
9787,20001,55-59,400,380,780
9788,20001,60-64,455,431,886
9789,20001,65+,1473,1175,2648
9790,20003,15-19,259,275,534
9791,20003,20-24,170,227,397
9792,20003,25-29,177,198,375
9793,20003,30-34,196,215,411
9794,20003,35-39,197,205,402
9795,20003,40-44,220,210,430
9796,20003,45-49,207,210,417
9797,20003,50-54,233,233,466
9798,20003,55-59,258,253,511
9799,20003,60-64,293,280,573
9800,20003,65+,848,779,1627
9801,20005,15-19,757,765,1522
9802,20005,20-24,748,648,1396
9803,20005,25-29,442,475,917
9804,20005,30-34,419,416,835
9805,20005,35-39,456,478,934
9806,20005,40-44,425,438,863
9807,20005,45-49,377,415,792
9808,20005,50-54,472,450,922
9809,20005,55-59,541,535,1076
9810,20005,60-64,555,516,1071
9811,20005,65+,1624,1308,2932
9812,20007,15-19,113,121,234
9813,20007,20-24,91,95,186
9814,20007,25-29,104,98,202
9815,20007,30-34,99,106,205
9816,20007,35-39,115,128,243
9817,20007,40-44,108,106,214
9818,20007,45-49,77,83,160
9819,20007,50-54,118,113,231
9820,20007,55-59,123,124,247
9821,20007,60-64,172,197,369
9822,20007,65+,519,509,1028
9823,20009,15-19,857,900,1757
9824,20009,20-24,699,723,1422
9825,20009,25-29,711,717,1428
9826,20009,30-34,753,697,1450
9827,20009,35-39,761,802,1563
9828,20009,40-44,693,771,1464
9829,20009,45-49,571,570,1141
9830,20009,50-54,654,645,1299
9831,20009,55-59,836,890,1726
9832,20009,60-64,969,931,1900
9833,20009,65+,2732,2343,5075
9834,20011,15-19,523,591,1114
9835,20011,20-24,383,450,833
9836,20011,25-29,403,386,789
9837,20011,30-34,365,407,772
9838,20011,35-39,402,409,811
9839,20011,40-44,405,407,812
9840,20011,45-49,396,370,766
9841,20011,50-54,332,367,699
9842,20011,55-59,451,388,839
9843,20011,60-64,496,453,949
9844,20011,65+,1578,1299,2877
9845,20013,15-19,300,308,608
9846,20013,20-24,197,227,424
9847,20013,25-29,247,224,471
9848,20013,30-34,241,276,517
9849,20013,35-39,284,302,586
9850,20013,40-44,253,278,531
9851,20013,45-49,213,232,445
9852,20013,50-54,275,274,549
9853,20013,55-59,301,305,606
9854,20013,60-64,365,335,700
9855,20013,65+,1073,916,1989
9856,20015,15-19,2459,2600,5059
9857,20015,20-24,1783,2176,3959
9858,20015,25-29,1760,2060,3820
9859,20015,30-34,2013,2227,4240
9860,20015,35-39,2328,2397,4725
9861,20015,40-44,2210,2339,4549
9862,20015,45-49,1924,2078,4002
9863,20015,50-54,1944,1994,3938
9864,20015,55-59,2167,2179,4346
9865,20015,60-64,2329,2277,4606
9866,20015,65+,5833,5052,10885
9867,20017,15-19,77,66,143
9868,20017,20-24,57,76,133
9869,20017,25-29,63,88,151
9870,20017,30-34,74,93,167
9871,20017,35-39,62,71,133
9872,20017,40-44,54,86,140
9873,20017,45-49,67,78,145
9874,20017,50-54,80,63,143
9875,20017,55-59,82,87,169
9876,20017,60-64,96,97,193
9877,20017,65+,343,288,631
9878,20019,15-19,103,93,196
9879,20019,20-24,81,75,156
9880,20019,25-29,81,73,154
9881,20019,30-34,86,99,185
9882,20019,35-39,90,102,192
9883,20019,40-44,84,98,182
9884,20019,45-49,66,81,147
9885,20019,50-54,85,102,187
9886,20019,55-59,114,113,227
9887,20019,60-64,141,159,300
9888,20019,65+,448,418,866
9889,20021,15-19,608,646,1254
9890,20021,20-24,469,539,1008
9891,20021,25-29,510,521,1031
9892,20021,30-34,497,517,1014
9893,20021,35-39,596,568,1164
9894,20021,40-44,557,571,1128
9895,20021,45-49,536,569,1105
9896,20021,50-54,625,640,1265
9897,20021,55-59,696,720,1416
9898,20021,60-64,739,705,1444
9899,20021,65+,1980,1739,3719
9900,20023,15-19,55,62,117
9901,20023,20-24,60,70,130
9902,20023,25-29,63,82,145
9903,20023,30-34,71,66,137
9904,20023,35-39,70,76,146
9905,20023,40-44,67,65,132
9906,20023,45-49,57,78,135
9907,20023,50-54,67,66,133
9908,20023,55-59,68,70,138
9909,20023,60-64,109,98,207
9910,20023,65+,399,329,728
9911,20025,15-19,71,59,130
9912,20025,20-24,53,49,102
9913,20025,25-29,56,57,113
9914,20025,30-34,50,56,106
9915,20025,35-39,49,55,104
9916,20025,40-44,55,74,129
9917,20025,45-49,47,51,98
9918,20025,50-54,54,37,91
9919,20025,55-59,65,71,136
9920,20025,60-64,69,63,132
9921,20025,65+,251,182,433
9922,20027,15-19,235,259,494
9923,20027,20-24,183,197,380
9924,20027,25-29,183,193,376
9925,20027,30-34,187,205,392
9926,20027,35-39,250,255,505
9927,20027,40-44,249,273,522
9928,20027,45-49,207,228,435
9929,20027,50-54,226,229,455
9930,20027,55-59,258,254,512
9931,20027,60-64,284,268,552
9932,20027,65+,1027,872,1899
9933,20029,15-19,332,382,714
9934,20029,20-24,222,279,501
9935,20029,25-29,216,226,442
9936,20029,30-34,257,254,511
9937,20029,35-39,222,288,510
9938,20029,40-44,230,256,486
9939,20029,45-49,201,237,438
9940,20029,50-54,259,239,498
9941,20029,55-59,290,276,566
9942,20029,60-64,310,323,633
9943,20029,65+,1075,829,1904
9944,20031,15-19,252,233,485
9945,20031,20-24,188,216,404
9946,20031,25-29,228,239,467
9947,20031,30-34,232,235,467
9948,20031,35-39,245,259,504
9949,20031,40-44,223,236,459
9950,20031,45-49,239,240,479
9951,20031,50-54,252,253,505
9952,20031,55-59,301,271,572
9953,20031,60-64,343,326,669
9954,20031,65+,969,875,1844
9955,20033,15-19,47,47,94
9956,20033,20-24,49,46,95
9957,20033,25-29,40,29,69
9958,20033,30-34,35,38,73
9959,20033,35-39,41,44,85
9960,20033,40-44,38,44,82
9961,20033,45-49,51,41,92
9962,20033,50-54,40,54,94
9963,20033,55-59,46,56,102
9964,20033,60-64,60,59,119
9965,20033,65+,248,204,452
9966,20035,15-19,1293,1308,2601
9967,20035,20-24,1084,1199,2283
9968,20035,25-29,929,1030,1959
9969,20035,30-34,971,1074,2045
9970,20035,35-39,1030,1135,2165
9971,20035,40-44,999,1062,2061
9972,20035,45-49,897,1014,1911
9973,20035,50-54,990,1012,2002
9974,20035,55-59,1050,1106,2156
9975,20035,60-64,1160,1157,2317
9976,20035,65+,3452,2840,6292
9977,20037,15-19,1533,1662,3195
9978,20037,20-24,2478,2750,5228
9979,20037,25-29,1162,1269,2431
9980,20037,30-34,1033,1050,2083
9981,20037,35-39,1132,1136,2268
9982,20037,40-44,1099,1119,2218
9983,20037,45-49,988,962,1950
9984,20037,50-54,1007,1043,2050
9985,20037,55-59,1030,1112,2142
9986,20037,60-64,1149,1094,2243
9987,20037,65+,3487,2737,6224
9988,20039,15-19,62,68,130
9989,20039,20-24,50,55,105
9990,20039,25-29,60,56,116
9991,20039,30-34,73,87,160
9992,20039,35-39,76,76,152
9993,20039,40-44,64,60,124
9994,20039,45-49,42,57,99
9995,20039,50-54,68,70,138
9996,20039,55-59,92,108,200
9997,20039,60-64,108,132,240
9998,20039,65+,443,356,799
9999,20041,15-19,579,617,1196
10000,20041,20-24,419,473,892
10001,20041,25-29,463,486,949
10002,20041,30-34,553,552,1105
10003,20041,35-39,540,594,1134
10004,20041,40-44,564,564,1128
10005,20041,45-49,466,528,994
10006,20041,50-54,544,595,1139
10007,20041,55-59,640,643,1283
10008,20041,60-64,706,722,1428
10009,20041,65+,1993,1754,3747
10010,20043,15-19,314,349,663
10011,20043,20-24,188,256,444
10012,20043,25-29,185,192,377
10013,20043,30-34,193,216,409
10014,20043,35-39,209,206,415
10015,20043,40-44,220,212,432
10016,20043,45-49,186,234,420
10017,20043,50-54,241,202,443
10018,20043,55-59,245,242,487
10019,20043,60-64,256,300,556
10020,20043,65+,783,729,1512
10021,20045,15-19,5424,5263,10687
10022,20045,20-24,10061,10263,20324
10023,20045,25-29,4237,4497,8734
10024,20045,30-34,3683,4027,7710
10025,20045,35-39,3672,3850,7522
10026,20045,40-44,3530,3743,7273
10027,20045,45-49,2904,2945,5849
10028,20045,50-54,2891,2890,5781
10029,20045,55-59,3008,2840,5848
10030,20045,60-64,3249,2777,6026
10031,20045,65+,8741,7358,16099
10032,20047,15-19,86,93,179
10033,20047,20-24,78,77,155
10034,20047,25-29,62,71,133
10035,20047,30-34,56,60,116
10036,20047,35-39,75,82,157
10037,20047,40-44,70,91,161
10038,20047,45-49,70,85,155
10039,20047,50-54,82,82,164
10040,20047,55-59,103,101,204
10041,20047,60-64,121,129,250
10042,20047,65+,332,307,639
10043,20049,15-19,73,80,153
10044,20049,20-24,43,52,95
10045,20049,25-29,42,53,95
10046,20049,30-34,54,58,112
10047,20049,35-39,52,46,98
10048,20049,40-44,53,65,118
10049,20049,45-49,58,62,120
10050,20049,50-54,74,69,143
10051,20049,55-59,95,77,172
10052,20049,60-64,89,107,196
10053,20049,65+,369,328,697
10054,20051,15-19,1102,1127,2229
10055,20051,20-24,1852,1849,3701
10056,20051,25-29,887,1015,1902
10057,20051,30-34,847,843,1690
10058,20051,35-39,917,956,1873
10059,20051,40-44,778,830,1608
10060,20051,45-49,659,712,1371
10061,20051,50-54,690,735,1425
10062,20051,55-59,777,764,1541
10063,20051,60-64,844,834,1678
10064,20051,65+,2606,2218,4824
10065,20053,15-19,122,183,305
10066,20053,20-24,102,317,419
10067,20053,25-29,134,302,436
10068,20053,30-34,146,275,421
10069,20053,35-39,164,283,447
10070,20053,40-44,150,265,415
10071,20053,45-49,134,241,375
10072,20053,50-54,121,211,332
10073,20053,55-59,197,245,442
10074,20053,60-64,233,236,469
10075,20053,65+,718,640,1358
10076,20055,15-19,1455,1685,3140
10077,20055,20-24,1321,1483,2804
10078,20055,25-29,1272,1429,2701
10079,20055,30-34,1204,1397,2601
10080,20055,35-39,1116,1260,2376
10081,20055,40-44,1031,1229,2260
10082,20055,45-49,1003,1039,2042
10083,20055,50-54,1024,1071,2095
10084,20055,55-59,1051,1105,2156
10085,20055,60-64,953,991,1944
10086,20055,65+,2343,2139,4482
10087,20057,15-19,1245,1459,2704
10088,20057,20-24,1080,1348,2428
10089,20057,25-29,1148,1295,2443
10090,20057,30-34,997,1217,2214
10091,20057,35-39,950,1156,2106
10092,20057,40-44,903,1122,2025
10093,20057,45-49,991,956,1947
10094,20057,50-54,930,1024,1954
10095,20057,55-59,922,975,1897
10096,20057,60-64,890,941,1831
10097,20057,65+,2091,1913,4004
10098,20059,15-19,886,962,1848
10099,20059,20-24,698,814,1512
10100,20059,25-29,795,753,1548
10101,20059,30-34,802,768,1570
10102,20059,35-39,798,824,1622
10103,20059,40-44,705,808,1513
10104,20059,45-49,719,722,1441
10105,20059,50-54,754,847,1601
10106,20059,55-59,940,932,1872
10107,20059,60-64,941,954,1895
10108,20059,65+,2456,2135,4591
10109,20061,15-19,822,1118,1940
10110,20061,20-24,1754,2608,4362
10111,20061,25-29,1835,2360,4195
10112,20061,30-34,1591,1786,3377
10113,20061,35-39,1220,1463,2683
10114,20061,40-44,868,931,1799
10115,20061,45-49,569,626,1195
10116,20061,50-54,534,495,1029
10117,20061,55-59,559,498,1057
10118,20061,60-64,504,453,957
10119,20061,65+,1836,1405,3241
10120,20063,15-19,94,85,179
10121,20063,20-24,64,59,123
10122,20063,25-29,63,71,134
10123,20063,30-34,58,65,123
10124,20063,35-39,80,90,170
10125,20063,40-44,68,69,137
10126,20063,45-49,64,87,151
10127,20063,50-54,60,56,116
10128,20063,55-59,79,85,164
10129,20063,60-64,115,112,227
10130,20063,65+,340,297,637
10131,20065,15-19,68,75,143
10132,20065,20-24,44,48,92
10133,20065,25-29,65,57,122
10134,20065,30-34,53,57,110
10135,20065,35-39,60,74,134
10136,20065,40-44,69,72,141
10137,20065,45-49,47,55,102
10138,20065,50-54,64,65,129
10139,20065,55-59,93,85,178
10140,20065,60-64,108,97,205
10141,20065,65+,333,304,637
10142,20067,15-19,276,315,591
10143,20067,20-24,217,250,467
10144,20067,25-29,206,236,442
10145,20067,30-34,173,224,397
10146,20067,35-39,208,201,409
10147,20067,40-44,233,225,458
10148,20067,45-49,179,239,418
10149,20067,50-54,201,208,409
10150,20067,55-59,186,197,383
10151,20067,60-64,215,231,446
10152,20067,65+,584,508,1092
10153,20069,15-19,200,225,425
10154,20069,20-24,173,175,348
10155,20069,25-29,180,168,348
10156,20069,30-34,147,141,288
10157,20069,35-39,171,177,348
10158,20069,40-44,164,163,327
10159,20069,45-49,156,177,333
10160,20069,50-54,133,161,294
10161,20069,55-59,176,171,347
10162,20069,60-64,178,183,361
10163,20069,65+,460,427,887
10164,20071,15-19,46,40,86
10165,20071,20-24,21,26,47
10166,20071,25-29,32,26,58
10167,20071,30-34,42,32,74
10168,20071,35-39,45,55,100
10169,20071,40-44,40,43,83
10170,20071,45-49,22,34,56
10171,20071,50-54,15,18,33
10172,20071,55-59,47,49,96
10173,20071,60-64,53,58,111
10174,20071,65+,133,119,252
10175,20073,15-19,164,200,364
10176,20073,20-24,115,143,258
10177,20073,25-29,117,133,250
10178,20073,30-34,139,124,263
10179,20073,35-39,149,150,299
10180,20073,40-44,182,139,321
10181,20073,45-49,134,168,302
10182,20073,50-54,154,171,325
10183,20073,55-59,204,219,423
10184,20073,60-64,270,263,533
10185,20073,65+,814,772,1586
10186,20075,15-19,70,98,168
10187,20075,20-24,62,81,143
10188,20075,25-29,61,89,150
10189,20075,30-34,80,80,160
10190,20075,35-39,80,72,152
10191,20075,40-44,84,78,162
10192,20075,45-49,67,68,135
10193,20075,50-54,67,67,134
10194,20075,55-59,84,97,181
10195,20075,60-64,71,75,146
10196,20075,65+,202,192,394
10197,20077,15-19,148,183,331
10198,20077,20-24,87,131,218
10199,20077,25-29,113,123,236
10200,20077,30-34,144,139,283
10201,20077,35-39,145,159,304
10202,20077,40-44,140,165,305
10203,20077,45-49,132,160,292
10204,20077,50-54,142,141,283
10205,20077,55-59,151,146,297
10206,20077,60-64,202,206,408
10207,20077,65+,698,565,1263
10208,20079,15-19,1222,1401,2623
10209,20079,20-24,969,1200,2169
10210,20079,25-29,912,971,1883
10211,20079,30-34,891,950,1841
10212,20079,35-39,1016,1051,2067
10213,20079,40-44,1061,1025,2086
10214,20079,45-49,861,887,1748
10215,20079,50-54,894,860,1754
10216,20079,55-59,1045,1029,2074
10217,20079,60-64,1187,1135,2322
10218,20079,65+,3629,3075,6704
10219,20081,15-19,129,168,297
10220,20081,20-24,120,119,239
10221,20081,25-29,109,117,226
10222,20081,30-34,99,102,201
10223,20081,35-39,97,110,207
10224,20081,40-44,108,105,213
10225,20081,45-49,102,106,208
10226,20081,50-54,101,102,203
10227,20081,55-59,117,106,223
10228,20081,60-64,110,128,238
10229,20081,65+,318,284,602
10230,20083,15-19,59,56,115
10231,20083,20-24,46,36,82
10232,20083,25-29,38,45,83
10233,20083,30-34,48,51,99
10234,20083,35-39,55,51,106
10235,20083,40-44,42,42,84
10236,20083,45-49,36,42,78
10237,20083,50-54,47,47,94
10238,20083,55-59,60,52,112
10239,20083,60-64,71,95,166
10240,20083,65+,179,199,378
10241,20085,15-19,417,502,919
10242,20085,20-24,345,361,706
10243,20085,25-29,322,348,670
10244,20085,30-34,352,371,723
10245,20085,35-39,373,392,765
10246,20085,40-44,376,385,761
10247,20085,45-49,362,357,719
10248,20085,50-54,436,440,876
10249,20085,55-59,455,471,926
10250,20085,60-64,432,472,904
10251,20085,65+,1340,1222,2562
10252,20087,15-19,573,642,1215
10253,20087,20-24,418,467,885
10254,20087,25-29,431,501,932
10255,20087,30-34,481,468,949
10256,20087,35-39,550,548,1098
10257,20087,40-44,539,574,1113
10258,20087,45-49,527,552,1079
10259,20087,50-54,592,626,1218
10260,20087,55-59,714,792,1506
10261,20087,60-64,689,760,1449
10262,20087,65+,1895,1795,3690
10263,20089,15-19,73,85,158
10264,20089,20-24,54,69,123
10265,20089,25-29,57,74,131
10266,20089,30-34,60,66,126
10267,20089,35-39,72,88,160
10268,20089,40-44,48,74,122
10269,20089,45-49,58,65,123
10270,20089,50-54,67,69,136
10271,20089,55-59,105,102,207
10272,20089,60-64,125,114,239
10273,20089,65+,452,456,908
10274,20091,15-19,19026,20691,39717
10275,20091,20-24,17499,17775,35274
10276,20091,25-29,20161,20851,41012
10277,20091,30-34,20517,21167,41684
10278,20091,35-39,22822,22602,45424
10279,20091,40-44,21522,21899,43421
10280,20091,45-49,19207,19240,38447
10281,20091,50-54,19328,19357,38685
10282,20091,55-59,19784,18878,38662
10283,20091,60-64,19279,17486,36765
10284,20091,65+,52526,42589,95115
10285,20093,15-19,128,146,274
10286,20093,20-24,108,107,215
10287,20093,25-29,105,128,233
10288,20093,30-34,129,112,241
10289,20093,35-39,119,145,264
10290,20093,40-44,113,105,218
10291,20093,45-49,102,96,198
10292,20093,50-54,94,101,195
10293,20093,55-59,127,112,239
10294,20093,60-64,104,120,224
10295,20093,65+,354,286,640
10296,20095,15-19,238,232,470
10297,20095,20-24,176,183,359
10298,20095,25-29,197,201,398
10299,20095,30-34,189,197,386
10300,20095,35-39,212,236,448
10301,20095,40-44,204,206,410
10302,20095,45-49,193,194,387
10303,20095,50-54,218,216,434
10304,20095,55-59,278,279,557
10305,20095,60-64,325,330,655
10306,20095,65+,842,734,1576
10307,20097,15-19,112,88,200
10308,20097,20-24,75,66,141
10309,20097,25-29,69,64,133
10310,20097,30-34,62,50,112
10311,20097,35-39,59,56,115
10312,20097,40-44,59,69,128
10313,20097,45-49,52,73,125
10314,20097,50-54,60,51,111
10315,20097,55-59,74,71,145
10316,20097,60-64,73,88,161
10317,20097,65+,294,265,559
10318,20099,15-19,572,686,1258
10319,20099,20-24,505,534,1039
10320,20099,25-29,526,570,1096
10321,20099,30-34,556,605,1161
10322,20099,35-39,580,577,1157
10323,20099,40-44,522,531,1053
10324,20099,45-49,505,523,1028
10325,20099,50-54,586,607,1193
10326,20099,55-59,713,738,1451
10327,20099,60-64,703,738,1441
10328,20099,65+,2190,1801,3991
10329,20101,15-19,49,38,87
10330,20101,20-24,42,32,74
10331,20101,25-29,43,39,82
10332,20101,30-34,40,46,86
10333,20101,35-39,36,35,71
10334,20101,40-44,35,38,73
10335,20101,45-49,37,48,85
10336,20101,50-54,51,48,99
10337,20101,55-59,55,56,111
10338,20101,60-64,65,62,127
10339,20101,65+,194,172,366
10340,20103,15-19,2423,2611,5034
10341,20103,20-24,1917,2721,4638
10342,20103,25-29,2009,3105,5114
10343,20103,30-34,2554,3504,6058
10344,20103,35-39,2701,3599,6300
10345,20103,40-44,2580,3295,5875
10346,20103,45-49,2185,2850,5035
10347,20103,50-54,2232,2776,5008
10348,20103,55-59,2482,2724,5206
10349,20103,60-64,2574,2618,5192
10350,20103,65+,6766,5907,12673
10351,20105,15-19,84,94,178
10352,20105,20-24,73,87,160
10353,20105,25-29,57,56,113
10354,20105,30-34,56,59,115
10355,20105,35-39,84,67,151
10356,20105,40-44,93,95,188
10357,20105,45-49,53,79,132
10358,20105,50-54,81,74,155
10359,20105,55-59,94,107,201
10360,20105,60-64,127,117,244
10361,20105,65+,411,340,751
10362,20107,15-19,313,303,616
10363,20107,20-24,229,248,477
10364,20107,25-29,190,225,415
10365,20107,30-34,233,231,464
10366,20107,35-39,271,250,521
10367,20107,40-44,280,299,579
10368,20107,45-49,275,311,586
10369,20107,50-54,305,302,607
10370,20107,55-59,406,380,786
10371,20107,60-64,357,441,798
10372,20107,65+,1093,1077,2170
10373,20109,15-19,80,86,166
10374,20109,20-24,51,76,127
10375,20109,25-29,87,81,168
10376,20109,30-34,72,89,161
10377,20109,35-39,69,80,149
10378,20109,40-44,74,79,153
10379,20109,45-49,60,75,135
10380,20109,50-54,54,58,112
10381,20109,55-59,87,83,170
10382,20109,60-64,116,108,224
10383,20109,65+,319,282,601
10384,20111,15-19,1400,1220,2620
10385,20111,20-24,2268,1850,4118
10386,20111,25-29,1006,1122,2128
10387,20111,30-34,839,914,1753
10388,20111,35-39,921,895,1816
10389,20111,40-44,830,852,1682
10390,20111,45-49,744,769,1513
10391,20111,50-54,776,835,1611
10392,20111,55-59,869,887,1756
10393,20111,60-64,989,940,1929
10394,20111,65+,2806,2404,5210
10395,20113,15-19,1057,1049,2106
10396,20113,20-24,854,986,1840
10397,20113,25-29,795,910,1705
10398,20113,30-34,834,923,1757
10399,20113,35-39,1013,937,1950
10400,20113,40-44,920,904,1824
10401,20113,45-49,781,800,1581
10402,20113,50-54,753,816,1569
10403,20113,55-59,977,952,1929
10404,20113,60-64,1085,1122,2207
10405,20113,65+,3349,2799,6148
10406,20115,15-19,404,444,848
10407,20115,20-24,395,424,819
10408,20115,25-29,253,290,543
10409,20115,30-34,268,279,547
10410,20115,35-39,313,308,621
10411,20115,40-44,301,324,625
10412,20115,45-49,285,281,566
10413,20115,50-54,321,317,638
10414,20115,55-59,421,419,840
10415,20115,60-64,438,488,926
10416,20115,65+,1478,1283,2761
10417,20117,15-19,297,299,596
10418,20117,20-24,243,244,487
10419,20117,25-29,225,237,462
10420,20117,30-34,238,276,514
10421,20117,35-39,296,305,601
10422,20117,40-44,298,310,608
10423,20117,45-49,226,257,483
10424,20117,50-54,234,252,486
10425,20117,55-59,341,306,647
10426,20117,60-64,396,408,804
10427,20117,65+,1164,1102,2266
10428,20119,15-19,115,142,257
10429,20119,20-24,102,132,234
10430,20119,25-29,122,144,266
10431,20119,30-34,100,106,206
10432,20119,35-39,97,124,221
10433,20119,40-44,106,103,209
10434,20119,45-49,95,89,184
10435,20119,50-54,131,142,273
10436,20119,55-59,123,115,238
10437,20119,60-64,138,154,292
10438,20119,65+,383,381,764
10439,20121,15-19,1184,1225,2409
10440,20121,20-24,868,929,1797
10441,20121,25-29,854,871,1725
10442,20121,30-34,926,963,1889
10443,20121,35-39,1090,1106,2196
10444,20121,40-44,1104,1133,2237
10445,20121,45-49,1034,1066,2100
10446,20121,50-54,1142,1192,2334
10447,20121,55-59,1262,1310,2572
10448,20121,60-64,1214,1282,2496
10449,20121,65+,3306,2855,6161
10450,20123,15-19,197,268,465
10451,20123,20-24,134,169,303
10452,20123,25-29,131,139,270
10453,20123,30-34,128,124,252
10454,20123,35-39,146,177,323
10455,20123,40-44,162,153,315
10456,20123,45-49,156,138,294
10457,20123,50-54,123,157,280
10458,20123,55-59,193,196,389
10459,20123,60-64,196,203,399
10460,20123,65+,701,633,1334
10461,20125,15-19,1121,1346,2467
10462,20125,20-24,740,996,1736
10463,20125,25-29,752,818,1570
10464,20125,30-34,915,873,1788
10465,20125,35-39,937,952,1889
10466,20125,40-44,851,820,1671
10467,20125,45-49,788,848,1636
10468,20125,50-54,887,853,1740
10469,20125,55-59,1044,1003,2047
10470,20125,60-64,1154,1101,2255
10471,20125,65+,3484,2940,6424
10472,20127,15-19,141,147,288
10473,20127,20-24,112,134,246
10474,20127,25-29,134,142,276
10475,20127,30-34,149,126,275
10476,20127,35-39,154,172,326
10477,20127,40-44,127,169,296
10478,20127,45-49,118,113,231
10479,20127,50-54,139,149,288
10480,20127,55-59,191,197,388
10481,20127,60-64,243,227,470
10482,20127,65+,730,637,1367
10483,20129,15-19,96,99,195
10484,20129,20-24,64,78,142
10485,20129,25-29,61,67,128
10486,20129,30-34,45,68,113
10487,20129,35-39,75,80,155
10488,20129,40-44,80,80,160
10489,20129,45-49,77,90,167
10490,20129,50-54,77,68,145
10491,20129,55-59,79,113,192
10492,20129,60-64,93,91,184
10493,20129,65+,305,253,558
10494,20131,15-19,309,354,663
10495,20131,20-24,288,311,599
10496,20131,25-29,248,285,533
10497,20131,30-34,258,266,524
10498,20131,35-39,291,318,609
10499,20131,40-44,253,283,536
10500,20131,45-49,232,251,483
10501,20131,50-54,260,285,545
10502,20131,55-59,323,368,691
10503,20131,60-64,344,368,712
10504,20131,65+,1091,933,2024
10505,20133,15-19,580,598,1178
10506,20133,20-24,414,454,868
10507,20133,25-29,407,439,846
10508,20133,30-34,431,453,884
10509,20133,35-39,447,448,895
10510,20133,40-44,467,425,892
10511,20133,45-49,393,436,829
10512,20133,50-54,425,477,902
10513,20133,55-59,521,495,1016
10514,20133,60-64,547,580,1127
10515,20133,65+,1747,1423,3170
10516,20135,15-19,73,79,152
10517,20135,20-24,65,63,128
10518,20135,25-29,73,62,135
10519,20135,30-34,66,50,116
10520,20135,35-39,76,83,159
10521,20135,40-44,45,74,119
10522,20135,45-49,64,71,135
10523,20135,50-54,57,62,119
10524,20135,55-59,97,95,192
10525,20135,60-64,122,123,245
10526,20135,65+,369,316,685
10527,20137,15-19,129,145,274
10528,20137,20-24,88,215,303
10529,20137,25-29,111,252,363
10530,20137,30-34,148,222,370
10531,20137,35-39,120,250,370
10532,20137,40-44,125,197,322
10533,20137,45-49,109,222,331
10534,20137,50-54,140,202,342
10535,20137,55-59,187,191,378
10536,20137,60-64,160,177,337
10537,20137,65+,599,515,1114
10538,20139,15-19,481,548,1029
10539,20139,20-24,356,424,780
10540,20139,25-29,392,436,828
10541,20139,30-34,422,400,822
10542,20139,35-39,456,465,921
10543,20139,40-44,444,473,917
10544,20139,45-49,458,436,894
10545,20139,50-54,457,477,934
10546,20139,55-59,602,604,1206
10547,20139,60-64,650,648,1298
10548,20139,65+,1668,1560,3228
10549,20141,15-19,89,99,188
10550,20141,20-24,67,71,138
10551,20141,25-29,89,97,186
10552,20141,30-34,89,93,182
10553,20141,35-39,87,105,192
10554,20141,40-44,92,90,182
10555,20141,45-49,64,82,146
10556,20141,50-54,86,86,172
10557,20141,55-59,130,130,260
10558,20141,60-64,147,146,293
10559,20141,65+,485,429,914
10560,20143,15-19,156,215,371
10561,20143,20-24,130,187,317
10562,20143,25-29,150,178,328
10563,20143,30-34,138,132,270
10564,20143,35-39,144,178,322
10565,20143,40-44,164,201,365
10566,20143,45-49,166,172,338
10567,20143,50-54,152,175,327
10568,20143,55-59,225,215,440
10569,20143,60-64,229,224,453
10570,20143,65+,624,581,1205
10571,20145,15-19,91,294,385
10572,20145,20-24,120,201,321
10573,20145,25-29,145,224,369
10574,20145,30-34,154,275,429
10575,20145,35-39,161,249,410
10576,20145,40-44,168,281,449
10577,20145,45-49,156,249,405
10578,20145,50-54,142,243,385
10579,20145,55-59,202,263,465
10580,20145,60-64,226,264,490
10581,20145,65+,758,622,1380
10582,20147,15-19,139,156,295
10583,20147,20-24,130,109,239
10584,20147,25-29,128,117,245
10585,20147,30-34,106,120,226
10586,20147,35-39,131,136,267
10587,20147,40-44,107,132,239
10588,20147,45-49,124,128,252
10589,20147,50-54,133,128,261
10590,20147,55-59,179,158,337
10591,20147,60-64,188,188,376
10592,20147,65+,599,602,1201
10593,20149,15-19,915,1006,1921
10594,20149,20-24,657,720,1377
10595,20149,25-29,702,751,1453
10596,20149,30-34,814,786,1600
10597,20149,35-39,915,932,1847
10598,20149,40-44,838,929,1767
10599,20149,45-49,655,730,1385
10600,20149,50-54,649,657,1306
10601,20149,55-59,730,740,1470
10602,20149,60-64,805,761,1566
10603,20149,65+,2076,1824,3900
10604,20151,15-19,321,405,726
10605,20151,20-24,224,323,547
10606,20151,25-29,240,239,479
10607,20151,30-34,242,269,511
10608,20151,35-39,282,287,569
10609,20151,40-44,251,271,522
10610,20151,45-49,237,205,442
10611,20151,50-54,225,226,451
10612,20151,55-59,265,260,525
10613,20151,60-64,330,325,655
10614,20151,65+,1042,891,1933
10615,20153,15-19,54,70,124
10616,20153,20-24,52,49,101
10617,20153,25-29,68,69,137
10618,20153,30-34,53,67,120
10619,20153,35-39,75,70,145
10620,20153,40-44,54,72,126
10621,20153,45-49,54,57,111
10622,20153,50-54,68,74,142
10623,20153,55-59,77,82,159
10624,20153,60-64,102,92,194
10625,20153,65+,364,341,705
10626,20155,15-19,2039,2220,4259
10627,20155,20-24,1702,2095,3797
10628,20155,25-29,1674,1966,3640
10629,20155,30-34,1617,1996,3613
10630,20155,35-39,1802,2062,3864
10631,20155,40-44,1762,1940,3702
10632,20155,45-49,1625,1781,3406
10633,20155,50-54,1681,1780,3461
10634,20155,55-59,1979,1986,3965
10635,20155,60-64,2209,2147,4356
10636,20155,65+,6923,5567,12490
10637,20157,15-19,121,140,261
10638,20157,20-24,102,96,198
10639,20157,25-29,117,111,228
10640,20157,30-34,102,113,215
10641,20157,35-39,128,138,266
10642,20157,40-44,107,134,241
10643,20157,45-49,111,100,211
10644,20157,50-54,107,108,215
10645,20157,55-59,156,160,316
10646,20157,60-64,199,197,396
10647,20157,65+,686,596,1282
10648,20159,15-19,327,406,733
10649,20159,20-24,375,411,786
10650,20159,25-29,224,293,517
10651,20159,30-34,240,274,514
10652,20159,35-39,254,287,541
10653,20159,40-44,231,280,511
10654,20159,45-49,219,224,443
10655,20159,50-54,225,243,468
10656,20159,55-59,273,258,531
10657,20159,60-64,358,345,703
10658,20159,65+,1033,834,1867
10659,20161,15-19,3552,3664,7216
10660,20161,20-24,7363,9632,16995
10661,20161,25-29,2909,3984,6893
10662,20161,30-34,2234,2674,4908
10663,20161,35-39,2139,2363,4502
10664,20161,40-44,1694,1796,3490
10665,20161,45-49,1293,1315,2608
10666,20161,50-54,1261,1248,2509
10667,20161,55-59,1368,1227,2595
10668,20161,60-64,1487,1382,2869
10669,20161,65+,4034,3458,7492
10670,20163,15-19,147,149,296
10671,20163,20-24,100,120,220
10672,20163,25-29,130,111,241
10673,20163,30-34,130,131,261
10674,20163,35-39,163,135,298
10675,20163,40-44,121,125,246
10676,20163,45-49,120,138,258
10677,20163,50-54,123,145,268
10678,20163,55-59,177,163,340
10679,20163,60-64,196,206,402
10680,20163,65+,621,509,1130
10681,20165,15-19,80,83,163
10682,20165,20-24,58,67,125
10683,20165,25-29,59,86,145
10684,20165,30-34,69,67,136
10685,20165,35-39,72,74,146
10686,20165,40-44,91,74,165
10687,20165,45-49,74,107,181
10688,20165,50-54,84,95,179
10689,20165,55-59,94,122,216
10690,20165,60-64,129,124,253
10691,20165,65+,408,357,765
10692,20167,15-19,167,188,355
10693,20167,20-24,146,144,290
10694,20167,25-29,172,157,329
10695,20167,30-34,193,168,361
10696,20167,35-39,177,196,373
10697,20167,40-44,182,175,357
10698,20167,45-49,172,183,355
10699,20167,50-54,180,164,344
10700,20167,55-59,231,249,480
10701,20167,60-64,263,245,508
10702,20167,65+,880,797,1677
10703,20169,15-19,1645,1924,3569
10704,20169,20-24,1613,1757,3370
10705,20169,25-29,1581,1740,3321
10706,20169,30-34,1603,1674,3277
10707,20169,35-39,1624,1667,3291
10708,20169,40-44,1559,1597,3156
10709,20169,45-49,1446,1371,2817
10710,20169,50-54,1625,1755,3380
10711,20169,55-59,1795,1758,3553
10712,20169,60-64,1895,1902,3797
10713,20169,65+,5561,4619,10180
10714,20171,15-19,171,202,373
10715,20171,20-24,135,142,277
10716,20171,25-29,141,169,310
10717,20171,30-34,140,166,306
10718,20171,35-39,141,147,288
10719,20171,40-44,134,134,268
10720,20171,45-49,134,134,268
10721,20171,50-54,124,158,282
10722,20171,55-59,158,157,315
10723,20171,60-64,179,138,317
10724,20171,65+,519,484,1003
10725,20173,15-19,17387,18353,35740
10726,20173,20-24,17262,18159,35421
10727,20173,25-29,18616,19068,37684
10728,20173,30-34,17990,17596,35586
10729,20173,35-39,17855,17362,35217
10730,20173,40-44,15967,16149,32116
10731,20173,45-49,14483,14156,28639
10732,20173,50-54,14723,14611,29334
10733,20173,55-59,15598,15494,31092
10734,20173,60-64,16741,16025,32766
10735,20173,65+,43831,37095,80926
10736,20175,15-19,926,1000,1926
10737,20175,20-24,751,844,1595
10738,20175,25-29,755,818,1573
10739,20175,30-34,684,773,1457
10740,20175,35-39,638,691,1329
10741,20175,40-44,568,673,1241
10742,20175,45-49,581,634,1215
10743,20175,50-54,594,626,1220
10744,20175,55-59,509,613,1122
10745,20175,60-64,528,536,1064
10746,20175,65+,1293,1098,2391
10747,20177,15-19,5743,6242,11985
10748,20177,20-24,5460,5341,10801
10749,20177,25-29,5444,5319,10763
10750,20177,30-34,5464,5203,10667
10751,20177,35-39,5858,5445,11303
10752,20177,40-44,5510,5492,11002
10753,20177,45-49,4879,4783,9662
10754,20177,50-54,5256,5104,10360
10755,20177,55-59,6050,5581,11631
10756,20177,60-64,6352,5698,12050
10757,20177,65+,18871,15229,34100
10758,20179,15-19,83,87,170
10759,20179,20-24,58,65,123
10760,20179,25-29,61,64,125
10761,20179,30-34,63,51,114
10762,20179,35-39,57,77,134
10763,20179,40-44,68,66,134
10764,20179,45-49,53,55,108
10765,20179,50-54,56,61,117
10766,20179,55-59,82,91,173
10767,20179,60-64,81,98,179
10768,20179,65+,307,278,585
10769,20181,15-19,183,203,386
10770,20181,20-24,169,184,353
10771,20181,25-29,154,163,317
10772,20181,30-34,164,172,336
10773,20181,35-39,186,182,368
10774,20181,40-44,171,187,358
10775,20181,45-49,156,134,290
10776,20181,50-54,127,150,277
10777,20181,55-59,177,172,349
10778,20181,60-64,213,240,453
10779,20181,65+,614,585,1199
10780,20183,15-19,96,114,210
10781,20183,20-24,68,71,139
10782,20183,25-29,70,84,154
10783,20183,30-34,74,79,153
10784,20183,35-39,91,78,169
10785,20183,40-44,99,103,202
10786,20183,45-49,73,101,174
10787,20183,50-54,90,88,178
10788,20183,55-59,133,127,260
10789,20183,60-64,162,148,310
10790,20183,65+,517,513,1030
10791,20185,15-19,110,140,250
10792,20185,20-24,96,126,222
10793,20185,25-29,95,105,200
10794,20185,30-34,102,87,189
10795,20185,35-39,107,136,243
10796,20185,40-44,103,113,216
10797,20185,45-49,108,77,185
10798,20185,50-54,105,105,210
10799,20185,55-59,155,146,301
10800,20185,60-64,153,168,321
10801,20185,65+,446,436,882
10802,20187,15-19,80,76,156
10803,20187,20-24,50,75,125
10804,20187,25-29,39,59,98
10805,20187,30-34,44,61,105
10806,20187,35-39,64,59,123
10807,20187,40-44,63,59,122
10808,20187,45-49,54,53,107
10809,20187,50-54,63,53,116
10810,20187,55-59,64,64,128
10811,20187,60-64,55,62,117
10812,20187,65+,189,171,360
10813,20189,15-19,237,184,421
10814,20189,20-24,142,167,309
10815,20189,25-29,136,150,286
10816,20189,30-34,149,134,283
10817,20189,35-39,166,166,332
10818,20189,40-44,154,155,309
10819,20189,45-49,110,159,269
10820,20189,50-54,155,183,338
10821,20189,55-59,165,177,342
10822,20189,60-64,171,169,340
10823,20189,65+,449,367,816
10824,20191,15-19,716,793,1509
10825,20191,20-24,569,605,1174
10826,20191,25-29,600,610,1210
10827,20191,30-34,612,638,1250
10828,20191,35-39,643,686,1329
10829,20191,40-44,650,701,1351
10830,20191,45-49,583,630,1213
10831,20191,50-54,626,636,1262
10832,20191,55-59,742,739,1481
10833,20191,60-64,843,904,1747
10834,20191,65+,2366,2069,4435
10835,20193,15-19,325,293,618
10836,20193,20-24,348,303,651
10837,20193,25-29,258,245,503
10838,20193,30-34,227,242,469
10839,20193,35-39,240,261,501
10840,20193,40-44,171,192,363
10841,20193,45-49,198,214,412
10842,20193,50-54,162,177,339
10843,20193,55-59,223,196,419
10844,20193,60-64,267,263,530
10845,20193,65+,776,682,1458
10846,20195,15-19,75,61,136
10847,20195,20-24,48,52,100
10848,20195,25-29,64,76,140
10849,20195,30-34,58,83,141
10850,20195,35-39,95,85,180
10851,20195,40-44,72,68,140
10852,20195,45-49,66,80,146
10853,20195,50-54,81,72,153
10854,20195,55-59,108,118,226
10855,20195,60-64,135,133,268
10856,20195,65+,371,367,738
10857,20197,15-19,207,224,431
10858,20197,20-24,190,177,367
10859,20197,25-29,172,160,332
10860,20197,30-34,168,201,369
10861,20197,35-39,180,192,372
10862,20197,40-44,186,211,397
10863,20197,45-49,178,195,373
10864,20197,50-54,199,188,387
10865,20197,55-59,257,277,534
10866,20197,60-64,281,322,603
10867,20197,65+,759,728,1487
10868,20199,15-19,53,41,94
10869,20199,20-24,27,52,79
10870,20199,25-29,33,42,75
10871,20199,30-34,38,43,81
10872,20199,35-39,36,34,70
10873,20199,40-44,38,38,76
10874,20199,45-49,25,31,56
10875,20199,50-54,32,36,68
10876,20199,55-59,46,49,95
10877,20199,60-64,59,57,116
10878,20199,65+,175,177,352
10879,20201,15-19,148,144,292
10880,20201,20-24,131,152,283
10881,20201,25-29,135,139,274
10882,20201,30-34,131,140,271
10883,20201,35-39,137,148,285
10884,20201,40-44,124,163,287
10885,20201,45-49,121,143,264
10886,20201,50-54,136,159,295
10887,20201,55-59,195,195,390
10888,20201,60-64,195,221,416
10889,20201,65+,714,611,1325
10890,20203,15-19,77,81,158
10891,20203,20-24,50,52,102
10892,20203,25-29,44,67,111
10893,20203,30-34,50,52,102
10894,20203,35-39,54,50,104
10895,20203,40-44,57,71,128
10896,20203,45-49,41,56,97
10897,20203,50-54,47,71,118
10898,20203,55-59,58,69,127
10899,20203,60-64,61,83,144
10900,20203,65+,219,229,448
10901,20205,15-19,273,285,558
10902,20205,20-24,193,219,412
10903,20205,25-29,188,192,380
10904,20205,30-34,214,215,429
10905,20205,35-39,264,238,502
10906,20205,40-44,233,270,503
10907,20205,45-49,197,228,425
10908,20205,50-54,246,229,475
10909,20205,55-59,264,273,537
10910,20205,60-64,335,326,661
10911,20205,65+,1054,922,1976
10912,20207,15-19,92,91,183
10913,20207,20-24,61,74,135
10914,20207,25-29,71,61,132
10915,20207,30-34,90,69,159
10916,20207,35-39,90,88,178
10917,20207,40-44,95,92,187
10918,20207,45-49,43,93,136
10919,20207,50-54,71,101,172
10920,20207,55-59,116,125,241
10921,20207,60-64,158,128,286
10922,20207,65+,399,395,794
10923,20209,15-19,5692,6050,11742
10924,20209,20-24,5271,5215,10486
10925,20209,25-29,6056,5972,12028
10926,20209,30-34,5957,6041,11998
10927,20209,35-39,5644,5788,11432
10928,20209,40-44,5276,5469,10745
10929,20209,45-49,4584,4986,9570
10930,20209,50-54,4577,4734,9311
10931,20209,55-59,4805,4883,9688
10932,20209,60-64,4982,4817,9799
10933,20209,65+,12105,9813,21918
10934,21001,15-19,730,849,1579
10935,21001,20-24,715,777,1492
10936,21001,25-29,521,575,1096
10937,21001,30-34,561,529,1090
10938,21001,35-39,481,506,987
10939,21001,40-44,546,459,1005
10940,21001,45-49,553,549,1102
10941,21001,50-54,605,650,1255
10942,21001,55-59,749,635,1384
10943,21001,60-64,713,659,1372
10944,21001,65+,1852,1726,3578
10945,21003,15-19,581,644,1225
10946,21003,20-24,524,582,1106
10947,21003,25-29,656,634,1290
10948,21003,30-34,676,677,1353
10949,21003,35-39,620,592,1212
10950,21003,40-44,615,613,1228
10951,21003,45-49,661,704,1365
10952,21003,50-54,711,717,1428
10953,21003,55-59,777,747,1524
10954,21003,60-64,691,733,1424
10955,21003,65+,1984,1737,3721
10956,21005,15-19,680,782,1462
10957,21005,20-24,635,645,1280
10958,21005,25-29,721,735,1456
10959,21005,30-34,758,705,1463
10960,21005,35-39,750,671,1421
10961,21005,40-44,745,732,1477
10962,21005,45-49,856,842,1698
10963,21005,50-54,876,874,1750
10964,21005,55-59,918,926,1844
10965,21005,60-64,795,793,1588
10966,21005,65+,2180,1804,3984
10967,21007,15-19,217,244,461
10968,21007,20-24,203,222,425
10969,21007,25-29,208,244,452
10970,21007,30-34,196,184,380
10971,21007,35-39,202,212,414
10972,21007,40-44,249,255,504
10973,21007,45-49,237,255,492
10974,21007,50-54,254,265,519
10975,21007,55-59,271,272,543
10976,21007,60-64,288,269,557
10977,21007,65+,892,769,1661
10978,21009,15-19,1355,1398,2753
10979,21009,20-24,1159,1209,2368
10980,21009,25-29,1328,1370,2698
10981,21009,30-34,1362,1317,2679
10982,21009,35-39,1381,1327,2708
10983,21009,40-44,1410,1392,2802
10984,21009,45-49,1373,1369,2742
10985,21009,50-54,1490,1353,2843
10986,21009,55-59,1565,1534,3099
10987,21009,60-64,1633,1471,3104
10988,21009,65+,4533,3496,8029
10989,21011,15-19,395,421,816
10990,21011,20-24,355,359,714
10991,21011,25-29,389,412,801
10992,21011,30-34,361,342,703
10993,21011,35-39,371,329,700
10994,21011,40-44,397,363,760
10995,21011,45-49,380,412,792
10996,21011,50-54,462,413,875
10997,21011,55-59,445,455,900
10998,21011,60-64,410,436,846
10999,21011,65+,1189,1012,2201
11000,21013,15-19,651,724,1375
11001,21013,20-24,639,773,1412
11002,21013,25-29,747,754,1501
11003,21013,30-34,708,770,1478
11004,21013,35-39,700,671,1371
11005,21013,40-44,688,692,1380
11006,21013,45-49,717,743,1460
11007,21013,50-54,801,761,1562
11008,21013,55-59,842,839,1681
11009,21013,60-64,883,822,1705
11010,21013,65+,2642,2071,4713
11011,21015,15-19,4688,5028,9716
11012,21015,20-24,3905,4031,7936
11013,21015,25-29,3885,4168,8053
11014,21015,30-34,4340,4288,8628
11015,21015,35-39,4587,4619,9206
11016,21015,40-44,4803,4803,9606
11017,21015,45-49,4476,4463,8939
11018,21015,50-54,4634,4800,9434
11019,21015,55-59,4507,4551,9058
11020,21015,60-64,4201,4099,8300
11021,21015,65+,10796,8950,19746
11022,21017,15-19,583,638,1221
11023,21017,20-24,529,560,1089
11024,21017,25-29,599,665,1264
11025,21017,30-34,600,583,1183
11026,21017,35-39,535,542,1077
11027,21017,40-44,594,582,1176
11028,21017,45-49,649,593,1242
11029,21017,50-54,697,645,1342
11030,21017,55-59,741,709,1450
11031,21017,60-64,688,700,1388
11032,21017,65+,2219,1820,4039
11033,21019,15-19,1326,1528,2854
11034,21019,20-24,1179,1147,2326
11035,21019,25-29,1270,1474,2744
11036,21019,30-34,1381,1562,2943
11037,21019,35-39,1406,1558,2964
11038,21019,40-44,1456,1623,3079
11039,21019,45-49,1429,1513,2942
11040,21019,50-54,1546,1616,3162
11041,21019,55-59,1621,1705,3326
11042,21019,60-64,1796,1562,3358
11043,21019,65+,5460,4312,9772
11044,21021,15-19,1093,1092,2185
11045,21021,20-24,1229,1268,2497
11046,21021,25-29,853,1075,1928
11047,21021,30-34,836,996,1832
11048,21021,35-39,794,986,1780
11049,21021,40-44,869,928,1797
11050,21021,45-49,833,945,1778
11051,21021,50-54,967,952,1919
11052,21021,55-59,1036,935,1971
11053,21021,60-64,999,949,1948
11054,21021,65+,3360,2564,5924
11055,21023,15-19,269,270,539
11056,21023,20-24,199,228,427
11057,21023,25-29,228,232,460
11058,21023,30-34,254,241,495
11059,21023,35-39,250,263,513
11060,21023,40-44,265,279,544
11061,21023,45-49,257,248,505
11062,21023,50-54,275,304,579
11063,21023,55-59,300,315,615
11064,21023,60-64,317,315,632
11065,21023,65+,792,710,1502
11066,21025,15-19,337,456,793
11067,21025,20-24,315,348,663
11068,21025,25-29,411,417,828
11069,21025,30-34,406,435,841
11070,21025,35-39,396,396,792
11071,21025,40-44,435,447,882
11072,21025,45-49,445,457,902
11073,21025,50-54,477,443,920
11074,21025,55-59,518,550,1068
11075,21025,60-64,519,492,1011
11076,21025,65+,1372,1115,2487
11077,21027,15-19,611,699,1310
11078,21027,20-24,534,588,1122
11079,21027,25-29,545,595,1140
11080,21027,30-34,522,589,1111
11081,21027,35-39,555,562,1117
11082,21027,40-44,632,645,1277
11083,21027,45-49,554,619,1173
11084,21027,50-54,711,657,1368
11085,21027,55-59,761,772,1533
11086,21027,60-64,784,819,1603
11087,21027,65+,2166,1982,4148
11088,21029,15-19,2396,2568,4964
11089,21029,20-24,2144,2303,4447
11090,21029,25-29,2605,2642,5247
11091,21029,30-34,2790,2756,5546
11092,21029,35-39,2713,2687,5400
11093,21029,40-44,2736,2823,5559
11094,21029,45-49,2781,2723,5504
11095,21029,50-54,2928,3040,5968
11096,21029,55-59,3156,3071,6227
11097,21029,60-64,2898,2836,5734
11098,21029,65+,7422,6546,13968
11099,21031,15-19,330,404,734
11100,21031,20-24,298,308,606
11101,21031,25-29,342,337,679
11102,21031,30-34,357,384,741
11103,21031,35-39,400,394,794
11104,21031,40-44,364,429,793
11105,21031,45-49,352,406,758
11106,21031,50-54,383,390,773
11107,21031,55-59,466,450,916
11108,21031,60-64,417,411,828
11109,21031,65+,1243,1126,2369
11110,21033,15-19,365,364,729
11111,21033,20-24,330,316,646
11112,21033,25-29,362,371,733
11113,21033,30-34,393,339,732
11114,21033,35-39,360,354,714
11115,21033,40-44,363,353,716
11116,21033,45-49,384,391,775
11117,21033,50-54,384,418,802
11118,21033,55-59,421,403,824
11119,21033,60-64,453,431,884
11120,21033,65+,1483,1197,2680
11121,21035,15-19,1716,1449,3165
11122,21035,20-24,2660,2519,5179
11123,21035,25-29,1122,1204,2326
11124,21035,30-34,1075,1099,2174
11125,21035,35-39,1001,1009,2010
11126,21035,40-44,977,1028,2005
11127,21035,45-49,906,992,1898
11128,21035,50-54,1066,1019,2085
11129,21035,55-59,1122,1122,2244
11130,21035,60-64,1172,1068,2240
11131,21035,65+,3557,2975,6532
11132,21037,15-19,2980,2909,5889
11133,21037,20-24,3187,3061,6248
11134,21037,25-29,3284,3513,6797
11135,21037,30-34,3336,3312,6648
11136,21037,35-39,3086,3239,6325
11137,21037,40-44,2809,2922,5731
11138,21037,45-49,2568,2492,5060
11139,21037,50-54,2840,3000,5840
11140,21037,55-59,3228,3096,6324
11141,21037,60-64,3366,3271,6637
11142,21037,65+,8539,7132,15671
11143,21039,15-19,128,148,276
11144,21039,20-24,135,122,257
11145,21039,25-29,125,132,257
11146,21039,30-34,138,131,269
11147,21039,35-39,123,141,264
11148,21039,40-44,139,136,275
11149,21039,45-49,141,173,314
11150,21039,50-54,164,133,297
11151,21039,55-59,156,182,338
11152,21039,60-64,161,169,330
11153,21039,65+,536,463,999
11154,21041,15-19,326,339,665
11155,21041,20-24,283,318,601
11156,21041,25-29,331,343,674
11157,21041,30-34,319,362,681
11158,21041,35-39,334,330,664
11159,21041,40-44,310,348,658
11160,21041,45-49,306,349,655
11161,21041,50-54,314,328,642
11162,21041,55-59,365,376,741
11163,21041,60-64,357,370,727
11164,21041,65+,968,783,1751
11165,21043,15-19,762,911,1673
11166,21043,20-24,786,829,1615
11167,21043,25-29,720,764,1484
11168,21043,30-34,804,725,1529
11169,21043,35-39,699,733,1432
11170,21043,40-44,768,802,1570
11171,21043,45-49,818,785,1603
11172,21043,50-54,932,906,1838
11173,21043,55-59,922,865,1787
11174,21043,60-64,914,935,1849
11175,21043,65+,2795,2356,5151
11176,21045,15-19,463,491,954
11177,21045,20-24,424,403,827
11178,21045,25-29,504,481,985
11179,21045,30-34,470,421,891
11180,21045,35-39,426,444,870
11181,21045,40-44,464,467,931
11182,21045,45-49,493,466,959
11183,21045,50-54,475,524,999
11184,21045,55-59,554,561,1115
11185,21045,60-64,532,526,1058
11186,21045,65+,1813,1436,3249
11187,21047,15-19,2016,2906,4922
11188,21047,20-24,2786,6216,9002
11189,21047,25-29,2962,4122,7084
11190,21047,30-34,2475,2673,5148
11191,21047,35-39,1975,2073,4048
11192,21047,40-44,1749,1629,3378
11193,21047,45-49,1526,1508,3034
11194,21047,50-54,1586,1428,3014
11195,21047,55-59,1711,1502,3213
11196,21047,60-64,1604,1472,3076
11197,21047,65+,5175,3952,9127
11198,21049,15-19,1008,1141,2149
11199,21049,20-24,1016,999,2015
11200,21049,25-29,1166,1225,2391
11201,21049,30-34,1169,1103,2272
11202,21049,35-39,1153,1101,2254
11203,21049,40-44,1149,1072,2221
11204,21049,45-49,1226,1161,2387
11205,21049,50-54,1268,1239,2507
11206,21049,55-59,1342,1268,2610
11207,21049,60-64,1320,1190,2510
11208,21049,65+,3740,3004,6744
11209,21051,15-19,573,600,1173
11210,21051,20-24,414,559,973
11211,21051,25-29,620,827,1447
11212,21051,30-34,671,997,1668
11213,21051,35-39,613,799,1412
11214,21051,40-44,600,727,1327
11215,21051,45-49,602,739,1341
11216,21051,50-54,691,740,1431
11217,21051,55-59,678,749,1427
11218,21051,60-64,683,669,1352
11219,21051,65+,1761,1452,3213
11220,21053,15-19,243,320,563
11221,21053,20-24,260,248,508
11222,21053,25-29,261,255,516
11223,21053,30-34,282,275,557
11224,21053,35-39,272,241,513
11225,21053,40-44,272,282,554
11226,21053,45-49,266,273,539
11227,21053,50-54,358,315,673
11228,21053,55-59,322,345,667
11229,21053,60-64,360,335,695
11230,21053,65+,994,845,1839
11231,21055,15-19,255,291,546
11232,21055,20-24,218,244,462
11233,21055,25-29,229,246,475
11234,21055,30-34,219,277,496
11235,21055,35-39,249,248,497
11236,21055,40-44,266,273,539
11237,21055,45-49,252,272,524
11238,21055,50-54,278,300,578
11239,21055,55-59,326,313,639
11240,21055,60-64,331,314,645
11241,21055,65+,1000,904,1904
11242,21057,15-19,146,161,307
11243,21057,20-24,142,128,270
11244,21057,25-29,158,147,305
11245,21057,30-34,174,170,344
11246,21057,35-39,167,171,338
11247,21057,40-44,150,155,305
11248,21057,45-49,152,155,307
11249,21057,50-54,194,175,369
11250,21057,55-59,232,209,441
11251,21057,60-64,228,276,504
11252,21057,65+,693,624,1317
11253,21059,15-19,3346,3420,6766
11254,21059,20-24,2991,3032,6023
11255,21059,25-29,3272,3265,6537
11256,21059,30-34,3361,3309,6670
11257,21059,35-39,3219,3200,6419
11258,21059,40-44,3082,3120,6202
11259,21059,45-49,2928,2856,5784
11260,21059,50-54,3099,3134,6233
11261,21059,55-59,3475,3259,6734
11262,21059,60-64,3581,3284,6865
11263,21059,65+,10011,8007,18018
11264,21061,15-19,339,428,767
11265,21061,20-24,321,358,679
11266,21061,25-29,364,369,733
11267,21061,30-34,384,387,771
11268,21061,35-39,363,332,695
11269,21061,40-44,381,424,805
11270,21061,45-49,417,398,815
11271,21061,50-54,422,389,811
11272,21061,55-59,448,480,928
11273,21061,60-64,456,478,934
11274,21061,65+,1349,1234,2583
11275,21063,15-19,167,169,336
11276,21063,20-24,158,281,439
11277,21063,25-29,157,381,538
11278,21063,30-34,173,327,500
11279,21063,35-39,161,309,470
11280,21063,40-44,195,300,495
11281,21063,45-49,219,319,538
11282,21063,50-54,184,305,489
11283,21063,55-59,221,270,491
11284,21063,60-64,205,255,460
11285,21063,65+,807,751,1558
11286,21065,15-19,408,447,855
11287,21065,20-24,318,353,671
11288,21065,25-29,395,426,821
11289,21065,30-34,413,417,830
11290,21065,35-39,369,410,779
11291,21065,40-44,431,490,921
11292,21065,45-49,449,411,860
11293,21065,50-54,513,537,1050
11294,21065,55-59,570,550,1120
11295,21065,60-64,511,501,1012
11296,21065,65+,1487,1220,2707
11297,21067,15-19,11656,11634,23290
11298,21067,20-24,16861,16143,33004
11299,21067,25-29,12394,12673,25067
11300,21067,30-34,11359,11672,23031
11301,21067,35-39,10699,10754,21453
11302,21067,40-44,10283,10463,20746
11303,21067,45-49,9320,9377,18697
11304,21067,50-54,9016,9312,18328
11305,21067,55-59,9394,9017,18411
11306,21067,60-64,9531,8467,17998
11307,21067,65+,26302,20132,46434
11308,21069,15-19,475,494,969
11309,21069,20-24,443,407,850
11310,21069,25-29,430,474,904
11311,21069,30-34,433,408,841
11312,21069,35-39,425,395,820
11313,21069,40-44,464,436,900
11314,21069,45-49,507,479,986
11315,21069,50-54,520,510,1030
11316,21069,55-59,542,528,1070
11317,21069,60-64,490,486,976
11318,21069,65+,1499,1296,2795
11319,21071,15-19,986,1246,2232
11320,21071,20-24,886,957,1843
11321,21071,25-29,965,1014,1979
11322,21071,30-34,1076,977,2053
11323,21071,35-39,1043,1005,2048
11324,21071,40-44,1156,1142,2298
11325,21071,45-49,1148,1100,2248
11326,21071,50-54,1202,1115,2317
11327,21071,55-59,1319,1185,2504
11328,21071,60-64,1376,1181,2557
11329,21071,65+,3735,2998,6733
11330,21073,15-19,1790,1736,3526
11331,21073,20-24,1571,1506,3077
11332,21073,25-29,1641,1730,3371
11333,21073,30-34,1666,1565,3231
11334,21073,35-39,1582,1593,3175
11335,21073,40-44,1645,1584,3229
11336,21073,45-49,1662,1600,3262
11337,21073,50-54,1677,1770,3447
11338,21073,55-59,1918,1654,3572
11339,21073,60-64,1849,1613,3462
11340,21073,65+,5283,4238,9521
11341,21075,15-19,175,176,351
11342,21075,20-24,154,207,361
11343,21075,25-29,182,242,424
11344,21075,30-34,206,263,469
11345,21075,35-39,178,202,380
11346,21075,40-44,180,187,367
11347,21075,45-49,166,179,345
11348,21075,50-54,171,183,354
11349,21075,55-59,246,188,434
11350,21075,60-64,259,207,466
11351,21075,65+,780,622,1402
11352,21077,15-19,278,284,562
11353,21077,20-24,249,267,516
11354,21077,25-29,276,319,595
11355,21077,30-34,294,280,574
11356,21077,35-39,249,250,499
11357,21077,40-44,255,272,527
11358,21077,45-49,263,292,555
11359,21077,50-54,330,331,661
11360,21077,55-59,351,333,684
11361,21077,60-64,299,322,621
11362,21077,65+,646,628,1274
11363,21079,15-19,456,552,1008
11364,21079,20-24,417,421,838
11365,21079,25-29,478,428,906
11366,21079,30-34,518,501,1019
11367,21079,35-39,503,492,995
11368,21079,40-44,540,531,1071
11369,21079,45-49,523,557,1080
11370,21079,50-54,601,624,1225
11371,21079,55-59,721,709,1430
11372,21079,60-64,673,717,1390
11373,21079,65+,1793,1457,3250
11374,21081,15-19,878,864,1742
11375,21081,20-24,724,851,1575
11376,21081,25-29,776,838,1614
11377,21081,30-34,753,840,1593
11378,21081,35-39,740,716,1456
11379,21081,40-44,783,807,1590
11380,21081,45-49,780,788,1568
11381,21081,50-54,864,889,1753
11382,21081,55-59,823,862,1685
11383,21081,60-64,798,772,1570
11384,21081,65+,1916,1672,3588
11385,21083,15-19,1096,1144,2240
11386,21083,20-24,921,1027,1948
11387,21083,25-29,1044,1061,2105
11388,21083,30-34,1190,1087,2277
11389,21083,35-39,1079,1057,2136
11390,21083,40-44,1135,1063,2198
11391,21083,45-49,991,1091,2082
11392,21083,50-54,1166,1134,2300
11393,21083,55-59,1303,1265,2568
11394,21083,60-64,1295,1160,2455
11395,21083,65+,3757,3177,6934
11396,21085,15-19,777,858,1635
11397,21085,20-24,689,754,1443
11398,21085,25-29,798,851,1649
11399,21085,30-34,808,819,1627
11400,21085,35-39,696,821,1517
11401,21085,40-44,802,854,1656
11402,21085,45-49,828,824,1652
11403,21085,50-54,789,863,1652
11404,21085,55-59,913,985,1898
11405,21085,60-64,967,936,1903
11406,21085,65+,2617,2242,4859
11407,21087,15-19,285,343,628
11408,21087,20-24,246,288,534
11409,21087,25-29,312,339,651
11410,21087,30-34,324,297,621
11411,21087,35-39,299,332,631
11412,21087,40-44,350,328,678
11413,21087,45-49,314,338,652
11414,21087,50-54,414,393,807
11415,21087,55-59,437,446,883
11416,21087,60-64,431,452,883
11417,21087,65+,1237,1101,2338
11418,21089,15-19,1036,1137,2173
11419,21089,20-24,816,940,1756
11420,21089,25-29,974,1016,1990
11421,21089,30-34,991,989,1980
11422,21089,35-39,1021,972,1993
11423,21089,40-44,1107,1108,2215
11424,21089,45-49,1161,1076,2237
11425,21089,50-54,1259,1153,2412
11426,21089,55-59,1221,1189,2410
11427,21089,60-64,1320,1218,2538
11428,21089,65+,4336,3409,7745
11429,21091,15-19,281,346,627
11430,21091,20-24,230,282,512
11431,21091,25-29,262,251,513
11432,21091,30-34,249,257,506
11433,21091,35-39,261,248,509
11434,21091,40-44,288,298,586
11435,21091,45-49,284,278,562
11436,21091,50-54,306,331,637
11437,21091,55-59,297,344,641
11438,21091,60-64,285,288,573
11439,21091,65+,831,779,1610
11440,21093,15-19,3429,3889,7318
11441,21093,20-24,3156,4181,7337
11442,21093,25-29,3458,3901,7359
11443,21093,30-34,3736,3730,7466
11444,21093,35-39,3896,3853,7749
11445,21093,40-44,3637,3686,7323
11446,21093,45-49,3285,3431,6716
11447,21093,50-54,3395,3387,6782
11448,21093,55-59,3708,3647,7355
11449,21093,60-64,3621,3373,6994
11450,21093,65+,9197,7217,16414
11451,21095,15-19,701,796,1497
11452,21095,20-24,649,606,1255
11453,21095,25-29,784,756,1540
11454,21095,30-34,826,829,1655
11455,21095,35-39,809,739,1548
11456,21095,40-44,772,755,1527
11457,21095,45-49,791,806,1597
11458,21095,50-54,852,855,1707
11459,21095,55-59,1017,855,1872
11460,21095,60-64,962,856,1818
11461,21095,65+,2796,2234,5030
11462,21097,15-19,542,611,1153
11463,21097,20-24,475,552,1027
11464,21097,25-29,572,586,1158
11465,21097,30-34,562,598,1160
11466,21097,35-39,534,483,1017
11467,21097,40-44,569,565,1134
11468,21097,45-49,576,590,1166
11469,21097,50-54,671,675,1346
11470,21097,55-59,718,711,1429
11471,21097,60-64,700,695,1395
11472,21097,65+,1890,1518,3408
11473,21099,15-19,619,622,1241
11474,21099,20-24,542,577,1119
11475,21099,25-29,577,607,1184
11476,21099,30-34,577,598,1175
11477,21099,35-39,516,511,1027
11478,21099,40-44,552,571,1123
11479,21099,45-49,550,620,1170
11480,21099,50-54,648,635,1283
11481,21099,55-59,739,724,1463
11482,21099,60-64,736,710,1446
11483,21099,65+,1746,1555,3301
11484,21101,15-19,1378,1364,2742
11485,21101,20-24,1217,1268,2485
11486,21101,25-29,1258,1331,2589
11487,21101,30-34,1412,1318,2730
11488,21101,35-39,1435,1299,2734
11489,21101,40-44,1369,1367,2736
11490,21101,45-49,1367,1257,2624
11491,21101,50-54,1404,1419,2823
11492,21101,55-59,1539,1473,3012
11493,21101,60-64,1707,1547,3254
11494,21101,65+,4673,3667,8340
11495,21103,15-19,485,547,1032
11496,21103,20-24,390,459,849
11497,21103,25-29,449,453,902
11498,21103,30-34,483,462,945
11499,21103,35-39,468,460,928
11500,21103,40-44,465,435,900
11501,21103,45-49,454,493,947
11502,21103,50-54,552,520,1072
11503,21103,55-59,600,581,1181
11504,21103,60-64,583,563,1146
11505,21103,65+,1556,1288,2844
11506,21105,15-19,118,116,234
11507,21105,20-24,96,123,219
11508,21105,25-29,104,98,202
11509,21105,30-34,118,123,241
11510,21105,35-39,117,111,228
11511,21105,40-44,110,127,237
11512,21105,45-49,143,119,262
11513,21105,50-54,142,165,307
11514,21105,55-59,170,174,344
11515,21105,60-64,182,147,329
11516,21105,65+,640,500,1140
11517,21107,15-19,1291,1445,2736
11518,21107,20-24,1186,1222,2408
11519,21107,25-29,1383,1384,2767
11520,21107,30-34,1376,1405,2781
11521,21107,35-39,1349,1316,2665
11522,21107,40-44,1419,1418,2837
11523,21107,45-49,1309,1332,2641
11524,21107,50-54,1427,1473,2900
11525,21107,55-59,1549,1489,3038
11526,21107,60-64,1707,1495,3202
11527,21107,65+,4716,3856,8572
11528,21109,15-19,328,411,739
11529,21109,20-24,303,370,673
11530,21109,25-29,395,365,760
11531,21109,30-34,360,374,734
11532,21109,35-39,376,376,752
11533,21109,40-44,428,441,869
11534,21109,45-49,466,421,887
11535,21109,50-54,435,449,884
11536,21109,55-59,472,443,915
11537,21109,60-64,482,450,932
11538,21109,65+,1240,1094,2334
11539,21111,15-19,23447,24070,47517
11540,21111,20-24,24166,24058,48224
11541,21111,25-29,28089,27988,56077
11542,21111,30-34,29192,28297,57489
11543,21111,35-39,26012,25917,51929
11544,21111,40-44,24792,24101,48893
11545,21111,45-49,23011,22010,45021
11546,21111,50-54,23989,22804,46793
11547,21111,55-59,25931,24161,50092
11548,21111,60-64,27074,24493,51567
11549,21111,65+,74624,57337,131961
11550,21113,15-19,1813,1779,3592
11551,21113,20-24,1769,1797,3566
11552,21113,25-29,1687,1694,3381
11553,21113,30-34,1714,1543,3257
11554,21113,35-39,1739,1635,3374
11555,21113,40-44,1775,1691,3466
11556,21113,45-49,1709,1574,3283
11557,21113,50-54,1750,1683,3433
11558,21113,55-59,1846,1675,3521
11559,21113,60-64,1900,1668,3568
11560,21113,65+,4659,4029,8688
11561,21115,15-19,636,802,1438
11562,21115,20-24,586,649,1235
11563,21115,25-29,584,608,1192
11564,21115,30-34,688,638,1326
11565,21115,35-39,706,700,1406
11566,21115,40-44,708,735,1443
11567,21115,45-49,735,719,1454
11568,21115,50-54,789,723,1512
11569,21115,55-59,832,799,1631
11570,21115,60-64,831,712,1543
11571,21115,65+,2272,2028,4300
11572,21117,15-19,5102,5336,10438
11573,21117,20-24,4913,5074,9987
11574,21117,25-29,6068,6328,12396
11575,21117,30-34,6301,6444,12745
11576,21117,35-39,5697,5811,11508
11577,21117,40-44,5579,5551,11130
11578,21117,45-49,4659,4954,9613
11579,21117,50-54,5286,5206,10492
11580,21117,55-59,5736,5493,11229
11581,21117,60-64,5651,5468,11119
11582,21117,65+,14203,11833,26036
11583,21119,15-19,465,476,941
11584,21119,20-24,415,515,930
11585,21119,25-29,398,375,773
11586,21119,30-34,356,332,688
11587,21119,35-39,360,362,722
11588,21119,40-44,410,395,805
11589,21119,45-49,448,454,902
11590,21119,50-54,492,479,971
11591,21119,55-59,558,518,1076
11592,21119,60-64,526,563,1089
11593,21119,65+,1496,1338,2834
11594,21121,15-19,973,1023,1996
11595,21121,20-24,859,999,1858
11596,21121,25-29,935,992,1927
11597,21121,30-34,962,923,1885
11598,21121,35-39,854,829,1683
11599,21121,40-44,887,907,1794
11600,21121,45-49,967,933,1900
11601,21121,50-54,966,978,1944
11602,21121,55-59,1067,997,2064
11603,21121,60-64,937,888,1825
11604,21121,65+,2955,2262,5217
11605,21123,15-19,428,521,949
11606,21123,20-24,372,433,805
11607,21123,25-29,428,469,897
11608,21123,30-34,446,491,937
11609,21123,35-39,483,436,919
11610,21123,40-44,496,507,1003
11611,21123,45-49,435,432,867
11612,21123,50-54,476,469,945
11613,21123,55-59,580,541,1121
11614,21123,60-64,543,533,1076
11615,21123,65+,1460,1260,2720
11616,21125,15-19,1890,1981,3871
11617,21125,20-24,1745,1828,3573
11618,21125,25-29,1900,1999,3899
11619,21125,30-34,2131,1981,4112
11620,21125,35-39,1966,1930,3896
11621,21125,40-44,2091,1989,4080
11622,21125,45-49,1976,2028,4004
11623,21125,50-54,2024,2198,4222
11624,21125,55-59,2254,2041,4295
11625,21125,60-64,2171,1968,4139
11626,21125,65+,5792,4860,10652
11627,21127,15-19,478,499,977
11628,21127,20-24,385,425,810
11629,21127,25-29,449,452,901
11630,21127,30-34,479,487,966
11631,21127,35-39,460,452,912
11632,21127,40-44,532,513,1045
11633,21127,45-49,479,528,1007
11634,21127,50-54,546,537,1083
11635,21127,55-59,566,566,1132
11636,21127,60-64,588,529,1117
11637,21127,65+,1603,1437,3040
11638,21129,15-19,175,198,373
11639,21129,20-24,145,229,374
11640,21129,25-29,187,385,572
11641,21129,30-34,178,362,540
11642,21129,35-39,194,299,493
11643,21129,40-44,186,322,508
11644,21129,45-49,180,261,441
11645,21129,50-54,245,325,570
11646,21129,55-59,298,314,612
11647,21129,60-64,245,283,528
11648,21129,65+,676,649,1325
11649,21131,15-19,273,269,542
11650,21131,20-24,227,271,498
11651,21131,25-29,296,272,568
11652,21131,30-34,345,360,705
11653,21131,35-39,279,301,580
11654,21131,40-44,321,312,633
11655,21131,45-49,334,323,657
11656,21131,50-54,343,349,692
11657,21131,55-59,388,403,791
11658,21131,60-64,400,411,811
11659,21131,65+,1055,903,1958
11660,21133,15-19,577,658,1235
11661,21133,20-24,494,516,1010
11662,21133,25-29,522,574,1096
11663,21133,30-34,594,620,1214
11664,21133,35-39,642,614,1256
11665,21133,40-44,697,660,1357
11666,21133,45-49,658,622,1280
11667,21133,50-54,704,718,1422
11668,21133,55-59,828,752,1580
11669,21133,60-64,867,770,1637
11670,21133,65+,2331,2015,4346
11671,21135,15-19,402,412,814
11672,21135,20-24,321,341,662
11673,21135,25-29,364,404,768
11674,21135,30-34,335,373,708
11675,21135,35-39,368,315,683
11676,21135,40-44,403,382,785
11677,21135,45-49,385,458,843
11678,21135,50-54,412,437,849
11679,21135,55-59,512,468,980
11680,21135,60-64,488,474,962
11681,21135,65+,1328,1208,2536
11682,21137,15-19,750,766,1516
11683,21137,20-24,644,637,1281
11684,21137,25-29,711,707,1418
11685,21137,30-34,697,737,1434
11686,21137,35-39,655,624,1279
11687,21137,40-44,780,680,1460
11688,21137,45-49,731,705,1436
11689,21137,50-54,885,816,1701
11690,21137,55-59,852,912,1764
11691,21137,60-64,801,798,1599
11692,21137,65+,2481,2040,4521
11693,21139,15-19,245,240,485
11694,21139,20-24,201,205,406
11695,21139,25-29,255,242,497
11696,21139,30-34,259,253,512
11697,21139,35-39,220,218,438
11698,21139,40-44,255,257,512
11699,21139,45-49,263,271,534
11700,21139,50-54,322,321,643
11701,21139,55-59,371,340,711
11702,21139,60-64,353,351,704
11703,21139,65+,1065,927,1992
11704,21141,15-19,815,879,1694
11705,21141,20-24,757,804,1561
11706,21141,25-29,802,883,1685
11707,21141,30-34,802,820,1622
11708,21141,35-39,866,830,1696
11709,21141,40-44,821,807,1628
11710,21141,45-49,776,756,1532
11711,21141,50-54,872,926,1798
11712,21141,55-59,989,918,1907
11713,21141,60-64,959,989,1948
11714,21141,65+,2795,2345,5140
11715,21143,15-19,195,217,412
11716,21143,20-24,156,290,446
11717,21143,25-29,141,350,491
11718,21143,30-34,164,383,547
11719,21143,35-39,158,324,482
11720,21143,40-44,209,359,568
11721,21143,45-49,200,355,555
11722,21143,50-54,266,353,619
11723,21143,55-59,325,359,684
11724,21143,60-64,383,363,746
11725,21143,65+,1186,1070,2256
11726,21145,15-19,1943,2001,3944
11727,21145,20-24,1798,1715,3513
11728,21145,25-29,2021,1995,4016
11729,21145,30-34,2227,1942,4169
11730,21145,35-39,2031,2031,4062
11731,21145,40-44,2090,2022,4112
11732,21145,45-49,2068,1974,4042
11733,21145,50-54,2054,2038,4092
11734,21145,55-59,2349,2122,4471
11735,21145,60-64,2487,2220,4707
11736,21145,65+,7964,6000,13964
11737,21147,15-19,456,646,1102
11738,21147,20-24,403,506,909
11739,21147,25-29,457,643,1100
11740,21147,30-34,472,880,1352
11741,21147,35-39,416,682,1098
11742,21147,40-44,477,781,1258
11743,21147,45-49,508,595,1103
11744,21147,50-54,477,618,1095
11745,21147,55-59,559,586,1145
11746,21147,60-64,480,501,981
11747,21147,65+,1452,1269,2721
11748,21149,15-19,301,318,619
11749,21149,20-24,235,247,482
11750,21149,25-29,254,226,480
11751,21149,30-34,235,251,486
11752,21149,35-39,260,256,516
11753,21149,40-44,267,260,527
11754,21149,45-49,290,276,566
11755,21149,50-54,289,309,598
11756,21149,55-59,308,311,619
11757,21149,60-64,332,321,653
11758,21149,65+,985,839,1824
11759,21151,15-19,4375,3890,8265
11760,21151,20-24,5883,5442,11325
11761,21151,25-29,3223,3393,6616
11762,21151,30-34,2826,2906,5732
11763,21151,35-39,2771,2638,5409
11764,21151,40-44,2819,2866,5685
11765,21151,45-49,2777,2720,5497
11766,21151,50-54,2906,2778,5684
11767,21151,55-59,2856,2673,5529
11768,21151,60-64,2740,2481,5221
11769,21151,65+,7478,5999,13477
11770,21153,15-19,340,326,666
11771,21153,20-24,299,300,599
11772,21153,25-29,301,344,645
11773,21153,30-34,345,338,683
11774,21153,35-39,314,316,630
11775,21153,40-44,354,352,706
11776,21153,45-49,377,405,782
11777,21153,50-54,389,412,801
11778,21153,55-59,411,433,844
11779,21153,60-64,436,437,873
11780,21153,65+,1132,1010,2142
11781,21155,15-19,630,603,1233
11782,21155,20-24,529,620,1149
11783,21155,25-29,601,640,1241
11784,21155,30-34,519,591,1110
11785,21155,35-39,559,595,1154
11786,21155,40-44,652,660,1312
11787,21155,45-49,555,586,1141
11788,21155,50-54,665,609,1274
11789,21155,55-59,694,737,1431
11790,21155,60-64,696,697,1393
11791,21155,65+,1871,1491,3362
11792,21157,15-19,885,947,1832
11793,21157,20-24,761,810,1571
11794,21157,25-29,865,867,1732
11795,21157,30-34,864,880,1744
11796,21157,35-39,921,834,1755
11797,21157,40-44,979,964,1943
11798,21157,45-49,933,967,1900
11799,21157,50-54,1054,1092,2146
11800,21157,55-59,1207,1144,2351
11801,21157,60-64,1231,1183,2414
11802,21157,65+,3813,3322,7135
11803,21159,15-19,264,333,597
11804,21159,20-24,265,334,599
11805,21159,25-29,231,614,845
11806,21159,30-34,265,645,910
11807,21159,35-39,286,538,824
11808,21159,40-44,305,409,714
11809,21159,45-49,315,405,720
11810,21159,50-54,381,377,758
11811,21159,55-59,355,357,712
11812,21159,60-64,393,332,725
11813,21159,65+,1056,905,1961
11814,21161,15-19,461,557,1018
11815,21161,20-24,450,487,937
11816,21161,25-29,504,514,1018
11817,21161,30-34,545,542,1087
11818,21161,35-39,434,442,876
11819,21161,40-44,511,474,985
11820,21161,45-49,509,480,989
11821,21161,50-54,597,571,1168
11822,21161,55-59,617,595,1212
11823,21161,60-64,607,551,1158
11824,21161,65+,1811,1408,3219
11825,21163,15-19,881,939,1820
11826,21163,20-24,820,904,1724
11827,21163,25-29,899,943,1842
11828,21163,30-34,1055,1028,2083
11829,21163,35-39,1106,1095,2201
11830,21163,40-44,1020,1079,2099
11831,21163,45-49,952,1016,1968
11832,21163,50-54,970,1003,1973
11833,21163,55-59,1076,1129,2205
11834,21163,60-64,1015,1021,2036
11835,21163,65+,2362,2281,4643
11836,21165,15-19,169,234,403
11837,21165,20-24,163,216,379
11838,21165,25-29,155,177,332
11839,21165,30-34,138,196,334
11840,21165,35-39,190,152,342
11841,21165,40-44,184,177,361
11842,21165,45-49,217,212,429
11843,21165,50-54,210,228,438
11844,21165,55-59,250,261,511
11845,21165,60-64,252,256,508
11846,21165,65+,696,591,1287
11847,21167,15-19,639,725,1364
11848,21167,20-24,585,575,1160
11849,21167,25-29,699,689,1388
11850,21167,30-34,675,675,1350
11851,21167,35-39,644,636,1280
11852,21167,40-44,657,677,1334
11853,21167,45-49,651,657,1308
11854,21167,50-54,790,771,1561
11855,21167,55-59,948,881,1829
11856,21167,60-64,844,880,1724
11857,21167,65+,2419,1920,4339
11858,21169,15-19,292,338,630
11859,21169,20-24,250,283,533
11860,21169,25-29,304,308,612
11861,21169,30-34,282,320,602
11862,21169,35-39,294,277,571
11863,21169,40-44,313,308,621
11864,21169,45-49,297,301,598
11865,21169,50-54,324,365,689
11866,21169,55-59,382,361,743
11867,21169,60-64,359,358,717
11868,21169,65+,1099,907,2006
11869,21171,15-19,312,367,679
11870,21171,20-24,271,320,591
11871,21171,25-29,318,316,634
11872,21171,30-34,291,332,623
11873,21171,35-39,314,324,638
11874,21171,40-44,343,334,677
11875,21171,45-49,326,338,664
11876,21171,50-54,384,359,743
11877,21171,55-59,383,422,805
11878,21171,60-64,425,420,845
11879,21171,65+,1194,989,2183
11880,21173,15-19,783,880,1663
11881,21173,20-24,793,814,1607
11882,21173,25-29,892,934,1826
11883,21173,30-34,944,921,1865
11884,21173,35-39,826,830,1656
11885,21173,40-44,934,884,1818
11886,21173,45-49,1025,956,1981
11887,21173,50-54,981,972,1953
11888,21173,55-59,1040,951,1991
11889,21173,60-64,904,807,1711
11890,21173,65+,2645,2064,4709
11891,21175,15-19,321,400,721
11892,21175,20-24,259,585,844
11893,21175,25-29,322,713,1035
11894,21175,30-34,342,693,1035
11895,21175,35-39,369,557,926
11896,21175,40-44,390,602,992
11897,21175,45-49,397,625,1022
11898,21175,50-54,444,517,961
11899,21175,55-59,427,477,904
11900,21175,60-64,451,534,985
11901,21175,65+,1201,1190,2391
11902,21177,15-19,894,1029,1923
11903,21177,20-24,844,1115,1959
11904,21177,25-29,828,1055,1883
11905,21177,30-34,851,1026,1877
11906,21177,35-39,827,974,1801
11907,21177,40-44,909,1013,1922
11908,21177,45-49,906,1044,1950
11909,21177,50-54,938,1025,1963
11910,21177,55-59,1052,1045,2097
11911,21177,60-64,1074,1027,2101
11912,21177,65+,3315,2723,6038
11913,21179,15-19,1362,1512,2874
11914,21179,20-24,1267,1304,2571
11915,21179,25-29,1587,1560,3147
11916,21179,30-34,1546,1487,3033
11917,21179,35-39,1408,1385,2793
11918,21179,40-44,1488,1571,3059
11919,21179,45-49,1379,1374,2753
11920,21179,50-54,1669,1573,3242
11921,21179,55-59,1715,1692,3407
11922,21179,60-64,1631,1654,3285
11923,21179,65+,4355,3531,7886
11924,21181,15-19,246,255,501
11925,21181,20-24,202,222,424
11926,21181,25-29,238,224,462
11927,21181,30-34,211,224,435
11928,21181,35-39,236,210,446
11929,21181,40-44,243,247,490
11930,21181,45-49,231,247,478
11931,21181,50-54,264,283,547
11932,21181,55-59,260,308,568
11933,21181,60-64,274,269,543
11934,21181,65+,670,576,1246
11935,21183,15-19,769,861,1630
11936,21183,20-24,592,678,1270
11937,21183,25-29,662,730,1392
11938,21183,30-34,650,715,1365
11939,21183,35-39,718,685,1403
11940,21183,40-44,737,789,1526
11941,21183,45-49,736,713,1449
11942,21183,50-54,722,756,1478
11943,21183,55-59,804,812,1616
11944,21183,60-64,807,769,1576
11945,21183,65+,2353,2041,4394
11946,21185,15-19,2573,2635,5208
11947,21185,20-24,1731,2247,3978
11948,21185,25-29,1307,1911,3218
11949,21185,30-34,1617,2010,3627
11950,21185,35-39,2166,2605,4771
11951,21185,40-44,2493,2946,5439
11952,21185,45-49,2304,2788,5092
11953,21185,50-54,2407,2856,5263
11954,21185,55-59,2215,2453,4668
11955,21185,60-64,1981,2072,4053
11956,21185,65+,5101,4633,9734
11957,21187,15-19,383,361,744
11958,21187,20-24,290,303,593
11959,21187,25-29,300,306,606
11960,21187,30-34,339,332,671
11961,21187,35-39,324,312,636
11962,21187,40-44,338,355,693
11963,21187,45-49,369,359,728
11964,21187,50-54,394,432,826
11965,21187,55-59,416,418,834
11966,21187,60-64,409,418,827
11967,21187,65+,1117,1041,2158
11968,21189,15-19,113,117,230
11969,21189,20-24,98,97,195
11970,21189,25-29,107,111,218
11971,21189,30-34,118,122,240
11972,21189,35-39,123,127,250
11973,21189,40-44,109,105,214
11974,21189,45-49,118,117,235
11975,21189,50-54,144,124,268
11976,21189,55-59,136,152,288
11977,21189,60-64,141,140,281
11978,21189,65+,434,374,808
11979,21191,15-19,431,488,919
11980,21191,20-24,351,389,740
11981,21191,25-29,403,496,899
11982,21191,30-34,445,464,909
11983,21191,35-39,386,377,763
11984,21191,40-44,417,429,846
11985,21191,45-49,419,473,892
11986,21191,50-54,501,526,1027
11987,21191,55-59,561,639,1200
11988,21191,60-64,558,582,1140
11989,21191,65+,1304,1178,2482
11990,21193,15-19,729,872,1601
11991,21193,20-24,669,721,1390
11992,21193,25-29,825,796,1621
11993,21193,30-34,895,859,1754
11994,21193,35-39,852,853,1705
11995,21193,40-44,905,867,1772
11996,21193,45-49,867,848,1715
11997,21193,50-54,996,979,1975
11998,21193,55-59,1047,913,1960
11999,21193,60-64,1040,982,2022
12000,21193,65+,2654,2364,5018
12001,21195,15-19,1706,1838,3544
12002,21195,20-24,1524,1689,3213
12003,21195,25-29,1583,1638,3221
12004,21195,30-34,1553,1655,3208
12005,21195,35-39,1612,1617,3229
12006,21195,40-44,1849,1812,3661
12007,21195,45-49,1908,1935,3843
12008,21195,50-54,2079,1936,4015
12009,21195,55-59,2116,1960,4076
12010,21195,60-64,2190,2130,4320
12011,21195,65+,6315,5101,11416
12012,21197,15-19,397,391,788
12013,21197,20-24,344,383,727
12014,21197,25-29,413,422,835
12015,21197,30-34,412,415,827
12016,21197,35-39,406,434,840
12017,21197,40-44,431,419,850
12018,21197,45-49,418,436,854
12019,21197,50-54,409,441,850
12020,21197,55-59,431,467,898
12021,21197,60-64,461,431,892
12022,21197,65+,1150,990,2140
12023,21199,15-19,1901,2078,3979
12024,21199,20-24,1640,1707,3347
12025,21199,25-29,1885,1961,3846
12026,21199,30-34,2039,1909,3948
12027,21199,35-39,1982,1832,3814
12028,21199,40-44,2059,2042,4101
12029,21199,45-49,2022,2051,4073
12030,21199,50-54,2305,2211,4516
12031,21199,55-59,2413,2230,4643
12032,21199,60-64,2380,2215,4595
12033,21199,65+,6911,5780,12691
12034,21201,15-19,50,67,117
12035,21201,20-24,51,54,105
12036,21201,25-29,67,67,134
12037,21201,30-34,50,49,99
12038,21201,35-39,51,53,104
12039,21201,40-44,72,66,138
12040,21201,45-49,60,74,134
12041,21201,50-54,76,73,149
12042,21201,55-59,80,108,188
12043,21201,60-64,92,73,165
12044,21201,65+,254,260,514
12045,21203,15-19,483,503,986
12046,21203,20-24,374,435,809
12047,21203,25-29,469,461,930
12048,21203,30-34,489,498,987
12049,21203,35-39,470,438,908
12050,21203,40-44,495,469,964
12051,21203,45-49,555,507,1062
12052,21203,50-54,587,625,1212
12053,21203,55-59,625,647,1272
12054,21203,60-64,605,588,1193
12055,21203,65+,1647,1385,3032
12056,21205,15-19,1418,1253,2671
12057,21205,20-24,1843,1818,3661
12058,21205,25-29,799,850,1649
12059,21205,30-34,690,740,1430
12060,21205,35-39,623,599,1222
12061,21205,40-44,646,628,1274
12062,21205,45-49,606,579,1185
12063,21205,50-54,716,671,1387
12064,21205,55-59,755,661,1416
12065,21205,60-64,686,663,1349
12066,21205,65+,2017,1561,3578
12067,21207,15-19,485,531,1016
12068,21207,20-24,452,477,929
12069,21207,25-29,514,506,1020
12070,21207,30-34,531,504,1035
12071,21207,35-39,448,463,911
12072,21207,40-44,517,480,997
12073,21207,45-49,556,541,1097
12074,21207,50-54,631,604,1235
12075,21207,55-59,678,662,1340
12076,21207,60-64,704,652,1356
12077,21207,65+,1995,1744,3739
12078,21209,15-19,2092,2071,4163
12079,21209,20-24,1857,1862,3719
12080,21209,25-29,2033,2104,4137
12081,21209,30-34,2022,2071,4093
12082,21209,35-39,2088,2016,4104
12083,21209,40-44,2069,1993,4062
12084,21209,45-49,2008,2042,4050
12085,21209,50-54,1913,1981,3894
12086,21209,55-59,1814,1823,3637
12087,21209,60-64,1620,1587,3207
12088,21209,65+,4081,3325,7406
12089,21211,15-19,1479,1570,3049
12090,21211,20-24,1472,1433,2905
12091,21211,25-29,1633,1492,3125
12092,21211,30-34,1603,1388,2991
12093,21211,35-39,1681,1543,3224
12094,21211,40-44,1631,1533,3164
12095,21211,45-49,1642,1512,3154
12096,21211,50-54,1716,1633,3349
12097,21211,55-59,1717,1755,3472
12098,21211,60-64,1672,1639,3311
12099,21211,65+,4266,3704,7970
12100,21213,15-19,618,598,1216
12101,21213,20-24,552,595,1147
12102,21213,25-29,643,662,1305
12103,21213,30-34,615,673,1288
12104,21213,35-39,581,529,1110
12105,21213,40-44,632,595,1227
12106,21213,45-49,588,579,1167
12107,21213,50-54,675,632,1307
12108,21213,55-59,725,675,1400
12109,21213,60-64,698,673,1371
12110,21213,65+,1851,1469,3320
12111,21215,15-19,567,663,1230
12112,21215,20-24,467,469,936
12113,21215,25-29,482,488,970
12114,21215,30-34,608,576,1184
12115,21215,35-39,689,663,1352
12116,21215,40-44,679,709,1388
12117,21215,45-49,691,726,1417
12118,21215,50-54,754,826,1580
12119,21215,55-59,840,805,1645
12120,21215,60-64,707,805,1512
12121,21215,65+,1532,1513,3045
12122,21217,15-19,989,1002,1991
12123,21217,20-24,993,986,1979
12124,21217,25-29,776,850,1626
12125,21217,30-34,817,825,1642
12126,21217,35-39,750,776,1526
12127,21217,40-44,725,751,1476
12128,21217,45-49,640,665,1305
12129,21217,50-54,765,731,1496
12130,21217,55-59,872,818,1690
12131,21217,60-64,942,808,1750
12132,21217,65+,2687,2102,4789
12133,21219,15-19,401,469,870
12134,21219,20-24,338,373,711
12135,21219,25-29,332,355,687
12136,21219,30-34,384,348,732
12137,21219,35-39,328,360,688
12138,21219,40-44,373,361,734
12139,21219,45-49,370,371,741
12140,21219,50-54,363,372,735
12141,21219,55-59,408,415,823
12142,21219,60-64,398,406,804
12143,21219,65+,1059,973,2032
12144,21221,15-19,412,466,878
12145,21221,20-24,323,341,664
12146,21221,25-29,308,376,684
12147,21221,30-34,361,359,720
12148,21221,35-39,381,333,714
12149,21221,40-44,396,361,757
12150,21221,45-49,404,438,842
12151,21221,50-54,487,468,955
12152,21221,55-59,581,539,1120
12153,21221,60-64,570,551,1121
12154,21221,65+,1658,1593,3251
12155,21223,15-19,239,250,489
12156,21223,20-24,228,231,459
12157,21223,25-29,253,270,523
12158,21223,30-34,245,248,493
12159,21223,35-39,240,214,454
12160,21223,40-44,247,264,511
12161,21223,45-49,291,260,551
12162,21223,50-54,305,385,690
12163,21223,55-59,324,326,650
12164,21223,60-64,294,339,633
12165,21223,65+,805,717,1522
12166,21225,15-19,429,764,1193
12167,21225,20-24,437,961,1398
12168,21225,25-29,364,432,796
12169,21225,30-34,388,376,764
12170,21225,35-39,395,379,774
12171,21225,40-44,406,413,819
12172,21225,45-49,427,376,803
12173,21225,50-54,412,408,820
12174,21225,55-59,444,431,875
12175,21225,60-64,515,413,928
12176,21225,65+,1306,1161,2467
12177,21227,15-19,5909,5588,11497
12178,21227,20-24,7500,7584,15084
12179,21227,25-29,4696,5170,9866
12180,21227,30-34,4403,4386,8789
12181,21227,35-39,4130,4213,8343
12182,21227,40-44,4367,4141,8508
12183,21227,45-49,3895,3968,7863
12184,21227,50-54,3799,3831,7630
12185,21227,55-59,3917,3878,7795
12186,21227,60-64,3755,3376,7131
12187,21227,65+,10079,8219,18298
12188,21229,15-19,362,355,717
12189,21229,20-24,323,344,667
12190,21229,25-29,347,352,699
12191,21229,30-34,377,317,694
12192,21229,35-39,312,368,680
12193,21229,40-44,364,381,745
12194,21229,45-49,357,356,713
12195,21229,50-54,419,393,812
12196,21229,55-59,457,478,935
12197,21229,60-64,416,412,828
12198,21229,65+,1265,984,2249
12199,21231,15-19,505,570,1075
12200,21231,20-24,522,534,1056
12201,21231,25-29,551,585,1136
12202,21231,30-34,552,591,1143
12203,21231,35-39,502,511,1013
12204,21231,40-44,588,613,1201
12205,21231,45-49,571,584,1155
12206,21231,50-54,653,673,1326
12207,21231,55-59,695,655,1350
12208,21231,60-64,778,706,1484
12209,21231,65+,2302,2026,4328
12210,21233,15-19,382,395,777
12211,21233,20-24,313,339,652
12212,21233,25-29,341,366,707
12213,21233,30-34,363,403,766
12214,21233,35-39,387,421,808
12215,21233,40-44,405,451,856
12216,21233,45-49,363,391,754
12217,21233,50-54,422,438,860
12218,21233,55-59,431,414,845
12219,21233,60-64,476,442,918
12220,21233,65+,1262,1096,2358
12221,21235,15-19,1338,1473,2811
12222,21235,20-24,1370,1456,2826
12223,21235,25-29,1176,1129,2305
12224,21235,30-34,1147,1123,2270
12225,21235,35-39,1015,1006,2021
12226,21235,40-44,1078,1045,2123
12227,21235,45-49,1045,1008,2053
12228,21235,50-54,1141,1059,2200
12229,21235,55-59,1159,1094,2253
12230,21235,60-64,1136,1013,2149
12231,21235,65+,3254,2693,5947
12232,21237,15-19,202,234,436
12233,21237,20-24,164,162,326
12234,21237,25-29,179,168,347
12235,21237,30-34,166,174,340
12236,21237,35-39,212,162,374
12237,21237,40-44,201,218,419
12238,21237,45-49,216,202,418
12239,21237,50-54,191,192,383
12240,21237,55-59,256,228,484
12241,21237,60-64,236,258,494
12242,21237,65+,695,598,1293
12243,21239,15-19,945,816,1761
12244,21239,20-24,916,634,1550
12245,21239,25-29,708,659,1367
12246,21239,30-34,683,703,1386
12247,21239,35-39,798,790,1588
12248,21239,40-44,867,860,1727
12249,21239,45-49,796,838,1634
12250,21239,50-54,881,836,1717
12251,21239,55-59,1016,961,1977
12252,21239,60-64,1069,992,2061
12253,21239,65+,2968,2507,5475
12254,22001,15-19,1844,2095,3939
12255,22001,20-24,1681,1759,3440
12256,22001,25-29,1750,1787,3537
12257,22001,30-34,1925,1907,3832
12258,22001,35-39,1845,1792,3637
12259,22001,40-44,1770,1690,3460
12260,22001,45-49,1643,1474,3117
12261,22001,50-54,1779,1630,3409
12262,22001,55-59,1959,1879,3838
12263,22001,60-64,1871,1834,3705
12264,22001,65+,5102,4164,9266
12265,22003,15-19,619,681,1300
12266,22003,20-24,551,839,1390
12267,22003,25-29,555,1159,1714
12268,22003,30-34,604,1258,1862
12269,22003,35-39,538,1136,1674
12270,22003,40-44,560,1005,1565
12271,22003,45-49,522,960,1482
12272,22003,50-54,598,822,1420
12273,22003,55-59,631,766,1397
12274,22003,60-64,616,703,1319
12275,22003,65+,1858,1544,3402
12276,22005,15-19,4321,4554,8875
12277,22005,20-24,3560,3700,7260
12278,22005,25-29,4078,3890,7968
12279,22005,30-34,4677,4352,9029
12280,22005,35-39,5084,4829,9913
12281,22005,40-44,4688,4418,9106
12282,22005,45-49,4030,3947,7977
12283,22005,50-54,4272,4176,8448
12284,22005,55-59,4071,4066,8137
12285,22005,60-64,3657,3511,7168
12286,22005,65+,8922,7582,16504
12287,22007,15-19,600,622,1222
12288,22007,20-24,555,582,1137
12289,22007,25-29,677,662,1339
12290,22007,30-34,612,599,1211
12291,22007,35-39,634,574,1208
12292,22007,40-44,670,585,1255
12293,22007,45-49,601,578,1179
12294,22007,50-54,741,670,1411
12295,22007,55-59,822,738,1560
12296,22007,60-64,799,772,1571
12297,22007,65+,2168,1952,4120
12298,22009,15-19,1110,1300,2410
12299,22009,20-24,1062,1265,2327
12300,22009,25-29,1173,1425,2598
12301,22009,30-34,1238,1432,2670
12302,22009,35-39,1199,1357,2556
12303,22009,40-44,1146,1334,2480
12304,22009,45-49,1064,1159,2223
12305,22009,50-54,1128,1227,2355
12306,22009,55-59,1286,1264,2550
12307,22009,60-64,1319,1182,2501
12308,22009,65+,3852,3037,6889
12309,22011,15-19,1071,1256,2327
12310,22011,20-24,961,1195,2156
12311,22011,25-29,1099,1308,2407
12312,22011,30-34,1109,1432,2541
12313,22011,35-39,1124,1249,2373
12314,22011,40-44,1108,1147,2255
12315,22011,45-49,1080,1150,2230
12316,22011,50-54,1123,1130,2253
12317,22011,55-59,1151,1097,2248
12318,22011,60-64,1172,1139,2311
12319,22011,65+,3161,2664,5825
12320,22013,15-19,372,393,765
12321,22013,20-24,310,327,637
12322,22013,25-29,341,351,692
12323,22013,30-34,394,364,758
12324,22013,35-39,398,359,757
12325,22013,40-44,376,319,695
12326,22013,45-49,319,325,644
12327,22013,50-54,403,424,827
12328,22013,55-59,498,446,944
12329,22013,60-64,481,471,952
12330,22013,65+,1539,1194,2733
12331,22015,15-19,3905,4511,8416
12332,22015,20-24,3816,4582,8398
12333,22015,25-29,4318,4395,8713
12334,22015,30-34,4898,4551,9449
12335,22015,35-39,4941,4859,9800
12336,22015,40-44,4270,4288,8558
12337,22015,45-49,3706,3647,7353
12338,22015,50-54,3669,3412,7081
12339,22015,55-59,3816,3712,7528
12340,22015,60-64,3927,3696,7623
12341,22015,65+,10952,8737,19689
12342,22017,15-19,7280,7357,14637
12343,22017,20-24,7138,6770,13908
12344,22017,25-29,7588,7140,14728
12345,22017,30-34,8140,7407,15547
12346,22017,35-39,7864,7149,15013
12347,22017,40-44,7505,6858,14363
12348,22017,45-49,6847,6124,12971
12349,22017,50-54,7103,6398,13501
12350,22017,55-59,7594,6918,14512
12351,22017,60-64,8283,7185,15468
12352,22017,65+,24553,18367,42920
12353,22019,15-19,6380,6707,13087
12354,22019,20-24,6014,6184,12198
12355,22019,25-29,6890,6893,13783
12356,22019,30-34,7449,7258,14707
12357,22019,35-39,6874,6711,13585
12358,22019,40-44,6469,6527,12996
12359,22019,45-49,5614,5723,11337
12360,22019,50-54,6121,6040,12161
12361,22019,55-59,6694,6170,12864
12362,22019,60-64,6890,6374,13264
12363,22019,65+,18053,14809,32862
12364,22021,15-19,296,316,612
12365,22021,20-24,225,322,547
12366,22021,25-29,248,376,624
12367,22021,30-34,304,343,647
12368,22021,35-39,269,335,604
12369,22021,40-44,280,306,586
12370,22021,45-49,265,315,580
12371,22021,50-54,290,302,592
12372,22021,55-59,313,296,609
12373,22021,60-64,298,322,620
12374,22021,65+,980,813,1793
12375,22023,15-19,154,154,308
12376,22023,20-24,134,138,272
12377,22023,25-29,139,162,301
12378,22023,30-34,153,177,330
12379,22023,35-39,144,153,297
12380,22023,40-44,156,165,321
12381,22023,45-49,137,128,265
12382,22023,50-54,154,164,318
12383,22023,55-59,205,205,410
12384,22023,60-64,208,198,406
12385,22023,65+,469,442,911
12386,22025,15-19,247,271,518
12387,22025,20-24,166,348,514
12388,22025,25-29,231,375,606
12389,22025,30-34,238,346,584
12390,22025,35-39,239,363,602
12391,22025,40-44,262,326,588
12392,22025,45-49,204,277,481
12393,22025,50-54,209,275,484
12394,22025,55-59,303,285,588
12395,22025,60-64,325,332,657
12396,22025,65+,885,757,1642
12397,22027,15-19,301,345,646
12398,22027,20-24,275,585,860
12399,22027,25-29,323,803,1126
12400,22027,30-34,308,775,1083
12401,22027,35-39,301,604,905
12402,22027,40-44,306,592,898
12403,22027,45-49,301,526,827
12404,22027,50-54,396,511,907
12405,22027,55-59,432,497,929
12406,22027,60-64,456,501,957
12407,22027,65+,1535,1277,2812
12408,22029,15-19,539,599,1138
12409,22029,20-24,462,721,1183
12410,22029,25-29,506,767,1273
12411,22029,30-34,513,705,1218
12412,22029,35-39,536,577,1113
12413,22029,40-44,550,580,1130
12414,22029,45-49,432,521,953
12415,22029,50-54,535,495,1030
12416,22029,55-59,587,515,1102
12417,22029,60-64,642,537,1179
12418,22029,65+,1948,1529,3477
12419,22031,15-19,816,905,1721
12420,22031,20-24,684,727,1411
12421,22031,25-29,798,738,1536
12422,22031,30-34,890,788,1678
12423,22031,35-39,902,833,1735
12424,22031,40-44,901,854,1755
12425,22031,45-49,784,789,1573
12426,22031,50-54,833,812,1645
12427,22031,55-59,925,866,1791
12428,22031,60-64,976,856,1832
12429,22031,65+,2712,2228,4940
12430,22033,15-19,16210,15776,31986
12431,22033,20-24,23937,22264,46201
12432,22033,25-29,16657,16313,32970
12433,22033,30-34,15215,14591,29806
12434,22033,35-39,15334,14469,29803
12435,22033,40-44,14139,13011,27150
12436,22033,45-49,12299,11213,23512
12437,22033,50-54,12675,11416,24091
12438,22033,55-59,13805,12090,25895
12439,22033,60-64,14296,12141,26437
12440,22033,65+,39734,29700,69434
12441,22035,15-19,211,238,449
12442,22035,20-24,158,342,500
12443,22035,25-29,189,446,635
12444,22035,30-34,176,340,516
12445,22035,35-39,174,305,479
12446,22035,40-44,176,258,434
12447,22035,45-49,152,267,419
12448,22035,50-54,182,201,383
12449,22035,55-59,197,253,450
12450,22035,60-64,245,238,483
12451,22035,65+,637,517,1154
12452,22037,15-19,421,549,970
12453,22037,20-24,450,698,1148
12454,22037,25-29,472,752,1224
12455,22037,30-34,475,737,1212
12456,22037,35-39,507,811,1318
12457,22037,40-44,509,744,1253
12458,22037,45-49,498,800,1298
12459,22037,50-54,570,782,1352
12460,22037,55-59,684,796,1480
12461,22037,60-64,786,777,1563
12462,22037,65+,1903,1818,3721
12463,22039,15-19,1004,1155,2159
12464,22039,20-24,902,1195,2097
12465,22039,25-29,921,1259,2180
12466,22039,30-34,1026,1201,2227
12467,22039,35-39,987,1071,2058
12468,22039,40-44,923,948,1871
12469,22039,45-49,813,880,1693
12470,22039,50-54,958,1020,1978
12471,22039,55-59,1103,1013,2116
12472,22039,60-64,1017,991,2008
12473,22039,65+,2750,2318,5068
12474,22041,15-19,636,669,1305
12475,22041,20-24,510,604,1114
12476,22041,25-29,554,619,1173
12477,22041,30-34,626,587,1213
12478,22041,35-39,576,588,1164
12479,22041,40-44,598,626,1224
12480,22041,45-49,546,528,1074
12481,22041,50-54,580,510,1090
12482,22041,55-59,677,611,1288
12483,22041,60-64,672,650,1322
12484,22041,65+,2054,1636,3690
12485,22043,15-19,523,604,1127
12486,22043,20-24,529,778,1307
12487,22043,25-29,599,1211,1810
12488,22043,30-34,627,1347,1974
12489,22043,35-39,599,1171,1770
12490,22043,40-44,609,955,1564
12491,22043,45-49,576,744,1320
12492,22043,50-54,585,742,1327
12493,22043,55-59,643,718,1361
12494,22043,60-64,663,672,1335
12495,22043,65+,1835,1634,3469
12496,22045,15-19,2269,2382,4651
12497,22045,20-24,2056,2140,4196
12498,22045,25-29,2181,2170,4351
12499,22045,30-34,2266,2174,4440
12500,22045,35-39,2135,2101,4236
12501,22045,40-44,2100,2001,4101
12502,22045,45-49,1867,1708,3575
12503,22045,50-54,2169,2016,4185
12504,22045,55-59,2504,2290,4794
12505,22045,60-64,2439,2369,4808
12506,22045,65+,6061,5130,11191
12507,22047,15-19,779,910,1689
12508,22047,20-24,802,979,1781
12509,22047,25-29,1045,1084,2129
12510,22047,30-34,1030,1208,2238
12511,22047,35-39,995,1118,2113
12512,22047,40-44,975,1027,2002
12513,22047,45-49,858,980,1838
12514,22047,50-54,944,1027,1971
12515,22047,55-59,1019,1088,2107
12516,22047,60-64,962,1015,1977
12517,22047,65+,2811,2255,5066
12518,22049,15-19,411,481,892
12519,22049,20-24,346,489,835
12520,22049,25-29,357,509,866
12521,22049,30-34,421,557,978
12522,22049,35-39,481,487,968
12523,22049,40-44,404,494,898
12524,22049,45-49,413,497,910
12525,22049,50-54,430,482,912
12526,22049,55-59,517,528,1045
12527,22049,60-64,531,499,1030
12528,22049,65+,1693,1329,3022
12529,22051,15-19,11708,12387,24095
12530,22051,20-24,11726,11413,23139
12531,22051,25-29,14379,13625,28004
12532,22051,30-34,15847,14614,30461
12533,22051,35-39,15076,14626,29702
12534,22051,40-44,13539,13380,26919
12535,22051,45-49,12562,11858,24420
12536,22051,50-54,13528,13014,26542
12537,22051,55-59,15504,14399,29903
12538,22051,60-64,15738,14347,30085
12539,22051,65+,44294,35364,79658
12540,22053,15-19,1043,1082,2125
12541,22053,20-24,870,952,1822
12542,22053,25-29,1038,1056,2094
12543,22053,30-34,1048,1020,2068
12544,22053,35-39,1059,981,2040
12545,22053,40-44,967,994,1961
12546,22053,45-49,916,844,1760
12547,22053,50-54,941,929,1870
12548,22053,55-59,1117,1026,2143
12549,22053,60-64,1169,1046,2215
12550,22053,65+,2949,2451,5400
12551,22055,15-19,7731,7805,15536
12552,22055,20-24,7934,7591,15525
12553,22055,25-29,8757,8467,17224
12554,22055,30-34,10048,9740,19788
12555,22055,35-39,9146,9038,18184
12556,22055,40-44,8226,8222,16448
12557,22055,45-49,6935,6908,13843
12558,22055,50-54,7289,6876,14165
12559,22055,55-59,7783,7062,14845
12560,22055,60-64,8126,7019,15145
12561,22055,65+,19389,15614,35003
12562,22057,15-19,3113,3170,6283
12563,22057,20-24,2707,2776,5483
12564,22057,25-29,3074,3064,6138
12565,22057,30-34,3610,3391,7001
12566,22057,35-39,3282,3250,6532
12567,22057,40-44,3049,3103,6152
12568,22057,45-49,2735,2729,5464
12569,22057,50-54,3155,3026,6181
12570,22057,55-59,3619,3544,7163
12571,22057,60-64,3299,3278,6577
12572,22057,65+,8670,7288,15958
12573,22059,15-19,409,503,912
12574,22059,20-24,397,544,941
12575,22059,25-29,423,611,1034
12576,22059,30-34,440,575,1015
12577,22059,35-39,450,542,992
12578,22059,40-44,449,573,1022
12579,22059,45-49,378,474,852
12580,22059,50-54,432,468,900
12581,22059,55-59,459,398,857
12582,22059,60-64,438,452,890
12583,22059,65+,1456,1125,2581
12584,22061,15-19,2576,2530,5106
12585,22061,20-24,4308,4327,8635
12586,22061,25-29,1503,1595,3098
12587,22061,30-34,1266,1242,2508
12588,22061,35-39,1320,1290,2610
12589,22061,40-44,1269,1264,2533
12590,22061,45-49,1082,1036,2118
12591,22061,50-54,1087,1088,2175
12592,22061,55-59,1237,1082,2319
12593,22061,60-64,1228,1120,2348
12594,22061,65+,3873,3024,6897
12595,22063,15-19,4799,5031,9830
12596,22063,20-24,4060,4258,8318
12597,22063,25-29,5006,4829,9835
12598,22063,30-34,5444,5214,10658
12599,22063,35-39,5550,5168,10718
12600,22063,40-44,5210,4983,10193
12601,22063,45-49,4564,4507,9071
12602,22063,50-54,4599,4711,9310
12603,22063,55-59,4472,4456,8928
12604,22063,60-64,4225,4147,8372
12605,22063,65+,10868,9108,19976
12606,22065,15-19,273,294,567
12607,22065,20-24,281,349,630
12608,22065,25-29,383,503,886
12609,22065,30-34,346,437,783
12610,22065,35-39,333,276,609
12611,22065,40-44,301,223,524
12612,22065,45-49,319,311,630
12613,22065,50-54,303,269,572
12614,22065,55-59,293,288,581
12615,22065,60-64,319,254,573
12616,22065,65+,831,684,1515
12617,22067,15-19,764,798,1562
12618,22067,20-24,692,720,1412
12619,22067,25-29,673,748,1421
12620,22067,30-34,718,731,1449
12621,22067,35-39,737,670,1407
12622,22067,40-44,777,740,1517
12623,22067,45-49,738,652,1390
12624,22067,50-54,779,767,1546
12625,22067,55-59,879,722,1601
12626,22067,60-64,968,795,1763
12627,22067,65+,2788,2229,5017
12628,22069,15-19,1762,1636,3398
12629,22069,20-24,2226,2087,4313
12630,22069,25-29,1075,1138,2213
12631,22069,30-34,988,960,1948
12632,22069,35-39,1029,928,1957
12633,22069,40-44,974,927,1901
12634,22069,45-49,920,895,1815
12635,22069,50-54,1059,930,1989
12636,22069,55-59,1051,1006,2057
12637,22069,60-64,1120,992,2112
12638,22069,65+,3594,2820,6414
12639,22071,15-19,10818,10332,21150
12640,22071,20-24,11260,10380,21640
12641,22071,25-29,14600,12659,27259
12642,22071,30-34,17327,15228,32555
12643,22071,35-39,16690,14866,31556
12644,22071,40-44,13281,12121,25402
12645,22071,45-49,11226,10408,21634
12646,22071,50-54,11451,10597,22048
12647,22071,55-59,12636,11204,23840
12648,22071,60-64,13279,11631,24910
12649,22071,65+,35289,27376,62665
12650,22073,15-19,5426,5719,11145
12651,22073,20-24,5471,5306,10777
12652,22073,25-29,5414,5073,10487
12653,22073,30-34,5788,5315,11103
12654,22073,35-39,5360,4816,10176
12655,22073,40-44,5198,4885,10083
12656,22073,45-49,4737,4332,9069
12657,22073,50-54,4939,4509,9448
12658,22073,55-59,4978,4565,9543
12659,22073,60-64,5126,4573,9699
12660,22073,65+,14246,10769,25015
12661,22075,15-19,749,823,1572
12662,22075,20-24,627,760,1387
12663,22075,25-29,731,740,1471
12664,22075,30-34,784,715,1499
12665,22075,35-39,825,822,1647
12666,22075,40-44,776,750,1526
12667,22075,45-49,714,708,1422
12668,22075,50-54,784,724,1508
12669,22075,55-59,727,842,1569
12670,22075,60-64,689,742,1431
12671,22075,65+,1827,1538,3365
12672,22077,15-19,566,578,1144
12673,22077,20-24,590,569,1159
12674,22077,25-29,587,593,1180
12675,22077,30-34,541,530,1071
12676,22077,35-39,583,589,1172
12677,22077,40-44,576,577,1153
12678,22077,45-49,539,484,1023
12679,22077,50-54,648,595,1243
12680,22077,55-59,779,747,1526
12681,22077,60-64,833,745,1578
12682,22077,65+,2467,1998,4465
12683,22079,15-19,4177,4489,8666
12684,22079,20-24,3919,3922,7841
12685,22079,25-29,3991,4178,8169
12686,22079,30-34,4169,4076,8245
12687,22079,35-39,4199,4091,8290
12688,22079,40-44,4081,3838,7919
12689,22079,45-49,3667,3446,7113
12690,22079,50-54,3957,3596,7553
12691,22079,55-59,4463,3940,8403
12692,22079,60-64,4322,4054,8376
12693,22079,65+,12307,9504,21811
12694,22081,15-19,229,228,457
12695,22081,20-24,201,201,402
12696,22081,25-29,210,234,444
12697,22081,30-34,212,221,433
12698,22081,35-39,225,205,430
12699,22081,40-44,201,202,403
12700,22081,45-49,231,208,439
12701,22081,50-54,254,236,490
12702,22081,55-59,275,239,514
12703,22081,60-64,320,263,583
12704,22081,65+,854,622,1476
12705,22083,15-19,595,644,1239
12706,22083,20-24,595,594,1189
12707,22083,25-29,593,668,1261
12708,22083,30-34,645,632,1277
12709,22083,35-39,627,575,1202
12710,22083,40-44,690,614,1304
12711,22083,45-49,552,541,1093
12712,22083,50-54,569,551,1120
12713,22083,55-59,676,603,1279
12714,22083,60-64,716,670,1386
12715,22083,65+,1981,1636,3617
12716,22085,15-19,675,748,1423
12717,22085,20-24,596,573,1169
12718,22085,25-29,581,618,1199
12719,22085,30-34,642,606,1248
12720,22085,35-39,668,670,1338
12721,22085,40-44,629,604,1233
12722,22085,45-49,620,578,1198
12723,22085,50-54,646,658,1304
12724,22085,55-59,791,798,1589
12725,22085,60-64,766,730,1496
12726,22085,65+,2495,2259,4754
12727,22087,15-19,1375,1533,2908
12728,22087,20-24,1184,1186,2370
12729,22087,25-29,1492,1384,2876
12730,22087,30-34,1993,1742,3735
12731,22087,35-39,1828,1625,3453
12732,22087,40-44,1587,1466,3053
12733,22087,45-49,1287,1262,2549
12734,22087,50-54,1246,1181,2427
12735,22087,55-59,1384,1433,2817
12736,22087,60-64,1425,1375,2800
12737,22087,65+,2934,2652,5586
12738,22089,15-19,1701,1807,3508
12739,22089,20-24,1474,1537,3011
12740,22089,25-29,1560,1517,3077
12741,22089,30-34,1761,1659,3420
12742,22089,35-39,1929,1721,3650
12743,22089,40-44,1863,1696,3559
12744,22089,45-49,1558,1508,3066
12745,22089,50-54,1754,1598,3352
12746,22089,55-59,1977,1799,3776
12747,22089,60-64,1879,1908,3787
12748,22089,65+,4104,3586,7690
12749,22091,15-19,295,313,608
12750,22091,20-24,327,307,634
12751,22091,25-29,359,370,729
12752,22091,30-34,384,357,741
12753,22091,35-39,343,326,669
12754,22091,40-44,324,285,609
12755,22091,45-49,287,250,537
12756,22091,50-54,382,340,722
12757,22091,55-59,391,367,758
12758,22091,60-64,410,386,796
12759,22091,65+,1241,1034,2275
12760,22093,15-19,580,595,1175
12761,22093,20-24,533,581,1114
12762,22093,25-29,635,639,1274
12763,22093,30-34,648,598,1246
12764,22093,35-39,636,586,1222
12765,22093,40-44,635,567,1202
12766,22093,45-49,484,443,927
12767,22093,50-54,686,560,1246
12768,22093,55-59,772,740,1512
12769,22093,60-64,747,743,1490
12770,22093,65+,2036,1676,3712
12771,22095,15-19,1393,1464,2857
12772,22095,20-24,1264,1331,2595
12773,22095,25-29,1303,1378,2681
12774,22095,30-34,1360,1361,2721
12775,22095,35-39,1443,1277,2720
12776,22095,40-44,1376,1243,2619
12777,22095,45-49,1316,1127,2443
12778,22095,50-54,1398,1194,2592
12779,22095,55-59,1605,1511,3116
12780,22095,60-64,1493,1426,2919
12781,22095,65+,3407,3062,6469
12782,22097,15-19,2703,2940,5643
12783,22097,20-24,2404,2462,4866
12784,22097,25-29,2536,2414,4950
12785,22097,30-34,2651,2464,5115
12786,22097,35-39,2599,2388,4987
12787,22097,40-44,2391,2251,4642
12788,22097,45-49,2205,2045,4250
12789,22097,50-54,2481,2348,4829
12790,22097,55-59,2850,2593,5443
12791,22097,60-64,2819,2562,5381
12792,22097,65+,7677,6171,13848
12793,22099,15-19,1506,1581,3087
12794,22099,20-24,1396,1538,2934
12795,22099,25-29,1658,1679,3337
12796,22099,30-34,1752,1698,3450
12797,22099,35-39,1694,1718,3412
12798,22099,40-44,1569,1594,3163
12799,22099,45-49,1487,1424,2911
12800,22099,50-54,1726,1533,3259
12801,22099,55-59,1847,1730,3577
12802,22099,60-64,1841,1780,3621
12803,22099,65+,4555,3980,8535
12804,22101,15-19,1412,1483,2895
12805,22101,20-24,1292,1321,2613
12806,22101,25-29,1429,1494,2923
12807,22101,30-34,1514,1506,3020
12808,22101,35-39,1422,1349,2771
12809,22101,40-44,1360,1375,2735
12810,22101,45-49,1332,1345,2677
12811,22101,50-54,1540,1473,3013
12812,22101,55-59,1845,1712,3557
12813,22101,60-64,1815,1851,3666
12814,22101,65+,4683,4057,8740
12815,22103,15-19,8705,9287,17992
12816,22103,20-24,7090,7286,14376
12817,22103,25-29,7182,7085,14267
12818,22103,30-34,8420,7493,15913
12819,22103,35-39,9230,8672,17902
12820,22103,40-44,9158,8713,17871
12821,22103,45-49,8282,7838,16120
12822,22103,50-54,8972,8490,17462
12823,22103,55-59,9425,9043,18468
12824,22103,60-64,9750,8954,18704
12825,22103,65+,26280,22211,48491
12826,22105,15-19,4713,4614,9327
12827,22105,20-24,4622,4368,8990
12828,22105,25-29,4754,4766,9520
12829,22105,30-34,5104,4783,9887
12830,22105,35-39,4495,4413,8908
12831,22105,40-44,4343,4259,8602
12832,22105,45-49,3789,3606,7395
12833,22105,50-54,4004,3759,7763
12834,22105,55-59,4275,3946,8221
12835,22105,60-64,4364,3939,8303
12836,22105,65+,11226,9253,20479
12837,22107,15-19,107,128,235
12838,22107,20-24,88,105,193
12839,22107,25-29,80,81,161
12840,22107,30-34,77,102,179
12841,22107,35-39,107,87,194
12842,22107,40-44,105,109,214
12843,22107,45-49,100,95,195
12844,22107,50-54,98,117,215
12845,22107,55-59,169,140,309
12846,22107,60-64,171,176,347
12847,22107,65+,599,473,1072
12848,22109,15-19,3418,3750,7168
12849,22109,20-24,3118,3233,6351
12850,22109,25-29,3304,3405,6709
12851,22109,30-34,3818,3693,7511
12852,22109,35-39,3789,3613,7402
12853,22109,40-44,3563,3494,7057
12854,22109,45-49,3034,3016,6050
12855,22109,50-54,3420,3230,6650
12856,22109,55-59,3704,3652,7356
12857,22109,60-64,3647,3571,7218
12858,22109,65+,9076,7580,16656
12859,22111,15-19,594,673,1267
12860,22111,20-24,536,598,1134
12861,22111,25-29,587,590,1177
12862,22111,30-34,620,614,1234
12863,22111,35-39,584,557,1141
12864,22111,40-44,625,618,1243
12865,22111,45-49,570,570,1140
12866,22111,50-54,660,659,1319
12867,22111,55-59,760,712,1472
12868,22111,60-64,843,814,1657
12869,22111,65+,2375,2170,4545
12870,22113,15-19,1857,1944,3801
12871,22113,20-24,1614,1620,3234
12872,22113,25-29,1677,1588,3265
12873,22113,30-34,1909,1710,3619
12874,22113,35-39,1963,1798,3761
12875,22113,40-44,1922,1837,3759
12876,22113,45-49,1610,1627,3237
12877,22113,50-54,1758,1688,3446
12878,22113,55-59,2035,1856,3891
12879,22113,60-64,2050,1971,4021
12880,22113,65+,5083,4170,9253
12881,22115,15-19,1344,1644,2988
12882,22115,20-24,1861,3504,5365
12883,22115,25-29,1877,2682,4559
12884,22115,30-34,1739,2149,3888
12885,22115,35-39,1616,1698,3314
12886,22115,40-44,1232,1408,2640
12887,22115,45-49,1123,1186,2309
12888,22115,50-54,1072,1146,2218
12889,22115,55-59,1122,1133,2255
12890,22115,60-64,1082,1059,2141
12891,22115,65+,3427,2819,6246
12892,22117,15-19,1359,1527,2886
12893,22117,20-24,1270,1365,2635
12894,22117,25-29,1312,1333,2645
12895,22117,30-34,1359,1397,2756
12896,22117,35-39,1334,1434,2768
12897,22117,40-44,1394,1412,2806
12898,22117,45-49,1262,1352,2614
12899,22117,50-54,1315,1317,2632
12900,22117,55-59,1451,1396,2847
12901,22117,60-64,1633,1492,3125
12902,22117,65+,4718,3870,8588
12903,22119,15-19,1011,1136,2147
12904,22119,20-24,963,1062,2025
12905,22119,25-29,1007,1125,2132
12906,22119,30-34,1090,1084,2174
12907,22119,35-39,1058,1099,2157
12908,22119,40-44,1043,1032,2075
12909,22119,45-49,1017,987,2004
12910,22119,50-54,1138,1120,2258
12911,22119,55-59,1288,1237,2525
12912,22119,60-64,1318,1210,2528
12913,22119,65+,4194,3216,7410
12914,22121,15-19,854,841,1695
12915,22121,20-24,749,802,1551
12916,22121,25-29,963,936,1899
12917,22121,30-34,1082,1052,2134
12918,22121,35-39,1077,1078,2155
12919,22121,40-44,934,927,1861
12920,22121,45-49,704,693,1397
12921,22121,50-54,881,791,1672
12922,22121,55-59,952,871,1823
12923,22121,60-64,924,885,1809
12924,22121,65+,2250,1860,4110
12925,22123,15-19,278,341,619
12926,22123,20-24,246,335,581
12927,22123,25-29,255,315,570
12928,22123,30-34,260,313,573
12929,22123,35-39,278,260,538
12930,22123,40-44,299,330,629
12931,22123,45-49,266,297,563
12932,22123,50-54,277,290,567
12933,22123,55-59,334,301,635
12934,22123,60-64,354,334,688
12935,22123,65+,1054,846,1900
12936,22125,15-19,296,362,658
12937,22125,20-24,266,355,621
12938,22125,25-29,226,602,828
12939,22125,30-34,268,959,1227
12940,22125,35-39,327,1144,1471
12941,22125,40-44,334,1130,1464
12942,22125,45-49,312,1109,1421
12943,22125,50-54,317,968,1285
12944,22125,55-59,344,794,1138
12945,22125,60-64,354,565,919
12946,22125,65+,1193,1257,2450
12947,22127,15-19,395,394,789
12948,22127,20-24,345,446,791
12949,22127,25-29,328,570,898
12950,22127,30-34,323,594,917
12951,22127,35-39,325,497,822
12952,22127,40-44,391,547,938
12953,22127,45-49,330,468,798
12954,22127,50-54,403,544,947
12955,22127,55-59,400,486,886
12956,22127,60-64,396,454,850
12957,22127,65+,1427,1141,2568
12958,23001,15-19,3444,3561,7005
12959,23001,20-24,3301,3386,6687
12960,23001,25-29,3348,3376,6724
12961,23001,30-34,3604,3577,7181
12962,23001,35-39,3563,3420,6983
12963,23001,40-44,3438,3358,6796
12964,23001,45-49,3219,3121,6340
12965,23001,50-54,3685,3682,7367
12966,23001,55-59,4069,4088,8157
12967,23001,60-64,4045,3884,7929
12968,23001,65+,11039,9279,20318
12969,23003,15-19,1746,2029,3775
12970,23003,20-24,1547,1752,3299
12971,23003,25-29,1629,1722,3351
12972,23003,30-34,1677,1656,3333
12973,23003,35-39,1692,1730,3422
12974,23003,40-44,1822,1854,3676
12975,23003,45-49,1904,1889,3793
12976,23003,50-54,2228,2293,4521
12977,23003,55-59,2563,2615,5178
12978,23003,60-64,2766,2885,5651
12979,23003,65+,8952,7802,16754
12980,23005,15-19,8551,9176,17727
12981,23005,20-24,9093,8807,17900
12982,23005,25-29,10297,10157,20454
12983,23005,30-34,10961,10833,21794
12984,23005,35-39,10525,10657,21182
12985,23005,40-44,9475,9615,19090
12986,23005,45-49,9078,8715,17793
12987,23005,50-54,10428,10122,20550
12988,23005,55-59,11229,10556,21785
12989,23005,60-64,11600,10449,22049
12990,23005,65+,32950,26730,59680
12991,23007,15-19,1023,932,1955
12992,23007,20-24,927,885,1812
12993,23007,25-29,755,778,1533
12994,23007,30-34,844,848,1692
12995,23007,35-39,819,805,1624
12996,23007,40-44,815,735,1550
12997,23007,45-49,797,795,1592
12998,23007,50-54,978,892,1870
12999,23007,55-59,1210,1153,2363
13000,23007,60-64,1232,1313,2545
13001,23007,65+,3527,3372,6899
13002,23009,15-19,1340,1460,2800
13003,23009,20-24,1229,1282,2511
13004,23009,25-29,1511,1450,2961
13005,23009,30-34,1729,1610,3339
13006,23009,35-39,1651,1561,3212
13007,23009,40-44,1539,1507,3046
13008,23009,45-49,1575,1558,3133
13009,23009,50-54,1913,1804,3717
13010,23009,55-59,2252,2076,4328
13011,23009,60-64,2588,2333,4921
13012,23009,65+,7807,6886,14693
13013,23011,15-19,3544,3627,7171
13014,23011,20-24,3625,3737,7362
13015,23011,25-29,3591,3654,7245
13016,23011,30-34,3815,3869,7684
13017,23011,35-39,3829,3733,7562
13018,23011,40-44,3700,3625,7325
13019,23011,45-49,3665,3483,7148
13020,23011,50-54,4292,4179,8471
13021,23011,55-59,4835,4574,9409
13022,23011,60-64,5136,4843,9979
13023,23011,65+,13942,11832,25774
13024,23013,15-19,1000,1098,2098
13025,23013,20-24,896,1021,1917
13026,23013,25-29,946,1077,2023
13027,23013,30-34,1034,1159,2193
13028,23013,35-39,1095,1245,2340
13029,23013,40-44,1178,1181,2359
13030,23013,45-49,1127,1230,2357
13031,23013,50-54,1282,1307,2589
13032,23013,55-59,1525,1496,3021
13033,23013,60-64,1836,1571,3407
13034,23013,65+,5946,5154,11100
13035,23015,15-19,763,870,1633
13036,23015,20-24,717,794,1511
13037,23015,25-29,859,928,1787
13038,23015,30-34,939,929,1868
13039,23015,35-39,921,932,1853
13040,23015,40-44,956,902,1858
13041,23015,45-49,987,957,1944
13042,23015,50-54,1165,1147,2312
13043,23015,55-59,1392,1353,2745
13044,23015,60-64,1623,1497,3120
13045,23015,65+,5499,4800,10299
13046,23017,15-19,1504,1754,3258
13047,23017,20-24,1245,1370,2615
13048,23017,25-29,1514,1544,3058
13049,23017,30-34,1656,1654,3310
13050,23017,35-39,1689,1609,3298
13051,23017,40-44,1725,1731,3456
13052,23017,45-49,1738,1734,3472
13053,23017,50-54,2049,1985,4034
13054,23017,55-59,2435,2432,4867
13055,23017,60-64,2753,2717,5470
13056,23017,65+,6897,6492,13389
13057,23019,15-19,4917,5726,10643
13058,23019,20-24,4833,5662,10495
13059,23019,25-29,4635,4753,9388
13060,23019,30-34,5138,5287,10425
13061,23019,35-39,4703,4693,9396
13062,23019,40-44,4526,4376,8902
13063,23019,45-49,4537,4360,8897
13064,23019,50-54,5056,5004,10060
13065,23019,55-59,5783,5600,11383
13066,23019,60-64,5988,5767,11755
13067,23019,65+,15923,13695,29618
13068,23021,15-19,428,480,908
13069,23021,20-24,368,358,726
13070,23021,25-29,363,385,748
13071,23021,30-34,403,359,762
13072,23021,35-39,438,426,864
13073,23021,40-44,476,446,922
13074,23021,45-49,507,510,1017
13075,23021,50-54,574,564,1138
13076,23021,55-59,681,661,1342
13077,23021,60-64,830,857,1687
13078,23021,65+,2259,2346,4605
13079,23023,15-19,966,982,1948
13080,23023,20-24,804,859,1663
13081,23023,25-29,1009,942,1951
13082,23023,30-34,1131,1105,2236
13083,23023,35-39,1197,1181,2378
13084,23023,40-44,1110,1088,2198
13085,23023,45-49,1062,1055,2117
13086,23023,50-54,1241,1225,2466
13087,23023,55-59,1422,1359,2781
13088,23023,60-64,1636,1477,3113
13089,23023,65+,4671,4053,8724
13090,23025,15-19,1389,1439,2828
13091,23025,20-24,1186,1296,2482
13092,23025,25-29,1298,1487,2785
13093,23025,30-34,1362,1406,2768
13094,23025,35-39,1453,1373,2826
13095,23025,40-44,1474,1444,2918
13096,23025,45-49,1507,1582,3089
13097,23025,50-54,1940,1801,3741
13098,23025,55-59,2040,2023,4063
13099,23025,60-64,2142,2166,4308
13100,23025,65+,5810,5483,11293
13101,23027,15-19,1076,1092,2168
13102,23027,20-24,881,1019,1900
13103,23027,25-29,963,1025,1988
13104,23027,30-34,1104,1108,2212
13105,23027,35-39,1171,1121,2292
13106,23027,40-44,1224,1275,2499
13107,23027,45-49,1195,1189,2384
13108,23027,50-54,1302,1295,2597
13109,23027,55-59,1562,1408,2970
13110,23027,60-64,1728,1593,3321
13111,23027,65+,5028,4620,9648
13112,23029,15-19,866,864,1730
13113,23029,20-24,703,721,1424
13114,23029,25-29,806,799,1605
13115,23029,30-34,717,711,1428
13116,23029,35-39,853,805,1658
13117,23029,40-44,865,818,1683
13118,23029,45-49,876,843,1719
13119,23029,50-54,986,980,1966
13120,23029,55-59,1200,1170,2370
13121,23029,60-64,1424,1285,2709
13122,23029,65+,4107,3866,7973
13123,23031,15-19,5693,5947,11640
13124,23031,20-24,5311,5519,10830
13125,23031,25-29,6362,6514,12876
13126,23031,30-34,6975,6935,13910
13127,23031,35-39,6778,6870,13648
13128,23031,40-44,6227,6244,12471
13129,23031,45-49,6088,6045,12133
13130,23031,50-54,7254,7251,14505
13131,23031,55-59,8665,8266,16931
13132,23031,60-64,9177,8492,17669
13133,23031,65+,25306,21092,46398
13134,24001,15-19,2265,2369,4634
13135,24001,20-24,2644,3104,5748
13136,24001,25-29,1774,2543,4317
13137,24001,30-34,1697,2691,4388
13138,24001,35-39,1706,2434,4140
13139,24001,40-44,1642,2305,3947
13140,24001,45-49,1728,2096,3824
13141,24001,50-54,1955,2295,4250
13142,24001,55-59,2153,2187,4340
13143,24001,60-64,2280,2321,4601
13144,24001,65+,7581,6264,13845
13145,24003,15-19,16731,18283,35014
13146,24003,20-24,16348,20061,36409
13147,24003,25-29,18591,19884,38475
13148,24003,30-34,21790,21486,43276
13149,24003,35-39,21628,22006,43634
13150,24003,40-44,19832,19954,39786
13151,24003,45-49,17737,17424,35161
13152,24003,50-54,19752,19012,38764
13153,24003,55-59,21334,20409,41743
13154,24003,60-64,19216,18156,37372
13155,24003,65+,50104,40932,91036
13156,24005,15-19,27781,27742,55523
13157,24005,20-24,25970,25065,51035
13158,24005,25-29,27437,25645,53082
13159,24005,30-34,30683,28038,58721
13160,24005,35-39,29737,26869,56606
13161,24005,40-44,27359,24699,52058
13162,24005,45-49,25786,23098,48884
13163,24005,50-54,28061,25565,53626
13164,24005,55-59,29835,27081,56916
13165,24005,60-64,30608,27233,57841
13166,24005,65+,86972,64979,151951
13167,24009,15-19,3097,3253,6350
13168,24009,20-24,2515,2723,5238
13169,24009,25-29,2497,2669,5166
13170,24009,30-34,2858,2860,5718
13171,24009,35-39,3215,3183,6398
13172,24009,40-44,3033,3002,6035
13173,24009,45-49,2773,2703,5476
13174,24009,50-54,3414,3328,6742
13175,24009,55-59,3854,3828,7682
13176,24009,60-64,3363,3323,6686
13177,24009,65+,7981,6848,14829
13178,24011,15-19,1054,1066,2120
13179,24011,20-24,887,882,1769
13180,24011,25-29,970,979,1949
13181,24011,30-34,1164,1075,2239
13182,24011,35-39,1034,1061,2095
13183,24011,40-44,1039,966,2005
13184,24011,45-49,963,936,1899
13185,24011,50-54,1117,1068,2185
13186,24011,55-59,1275,1209,2484
13187,24011,60-64,1236,1219,2455
13188,24011,65+,3069,2617,5686
13189,24013,15-19,5460,5733,11193
13190,24013,20-24,4785,5068,9853
13191,24013,25-29,4404,4721,9125
13192,24013,30-34,5186,5407,10593
13193,24013,35-39,5651,5944,11595
13194,24013,40-44,5268,5349,10617
13195,24013,45-49,5041,5064,10105
13196,24013,50-54,6365,6337,12702
13197,24013,55-59,7104,7020,14124
13198,24013,60-64,6270,6279,12549
13199,24013,65+,16630,13834,30464
13200,24015,15-19,3125,3322,6447
13201,24015,20-24,2904,3005,5909
13202,24015,25-29,3186,3193,6379
13203,24015,30-34,3435,3409,6844
13204,24015,35-39,3205,3210,6415
13205,24015,40-44,3155,3062,6217
13206,24015,45-49,3126,3047,6173
13207,24015,50-54,3777,3663,7440
13208,24015,55-59,4065,4176,8241
13209,24015,60-64,3807,3823,7630
13210,24015,65+,9117,8192,17309
13211,24017,15-19,5609,5796,11405
13212,24017,20-24,4884,5098,9982
13213,24017,25-29,5156,5153,10309
13214,24017,30-34,5630,5491,11121
13215,24017,35-39,6058,5469,11527
13216,24017,40-44,5866,5179,11045
13217,24017,45-49,5996,5077,11073
13218,24017,50-54,6838,6148,12986
13219,24017,55-59,6819,6364,13183
13220,24017,60-64,5436,5220,10656
13221,24017,65+,12614,9798,22412
13222,24019,15-19,868,960,1828
13223,24019,20-24,762,795,1557
13224,24019,25-29,995,822,1817
13225,24019,30-34,1090,952,2042
13226,24019,35-39,992,839,1831
13227,24019,40-44,924,776,1700
13228,24019,45-49,912,756,1668
13229,24019,50-54,1072,940,2012
13230,24019,55-59,1243,1199,2442
13231,24019,60-64,1418,1235,2653
13232,24019,65+,4002,3313,7315
13233,24021,15-19,9037,9274,18311
13234,24021,20-24,7937,8134,16071
13235,24021,25-29,8041,8215,16256
13236,24021,30-34,9374,9447,18821
13237,24021,35-39,10318,10303,20621
13238,24021,40-44,9595,9768,19363
13239,24021,45-49,8703,8741,17444
13240,24021,50-54,9747,9831,19578
13241,24021,55-59,10072,10050,20122
13242,24021,60-64,8966,8592,17558
13243,24021,65+,23162,19011,42173
13244,24023,15-19,677,881,1558
13245,24023,20-24,663,756,1419
13246,24023,25-29,798,824,1622
13247,24023,30-34,802,826,1628
13248,24023,35-39,763,764,1527
13249,24023,40-44,836,838,1674
13250,24023,45-49,867,815,1682
13251,24023,50-54,1012,965,1977
13252,24023,55-59,1098,1114,2212
13253,24023,60-64,1268,1230,2498
13254,24023,65+,3552,3163,6715
13255,24025,15-19,7721,8604,16325
13256,24025,20-24,7081,7731,14812
13257,24025,25-29,7724,8015,15739
13258,24025,30-34,8496,8346,16842
13259,24025,35-39,9158,9001,18159
13260,24025,40-44,8549,8238,16787
13261,24025,45-49,7893,7695,15588
13262,24025,50-54,9295,8839,18134
13263,24025,55-59,9967,9663,19630
13264,24025,60-64,9514,9011,18525
13265,24025,65+,24621,19790,44411
13266,24027,15-19,11082,11661,22743
13267,24027,20-24,9096,9568,18664
13268,24027,25-29,9228,9687,18915
13269,24027,30-34,10592,10124,20716
13270,24027,35-39,12689,11528,24217
13271,24027,40-44,12676,11957,24633
13272,24027,45-49,11684,11162,22846
13273,24027,50-54,11921,11365,23286
13274,24027,55-59,11834,11450,23284
13275,24027,60-64,10325,10263,20588
13276,24027,65+,26849,22337,49186
13277,24029,15-19,712,642,1354
13278,24029,20-24,726,663,1389
13279,24029,25-29,451,524,975
13280,24029,30-34,509,520,1029
13281,24029,35-39,502,509,1011
13282,24029,40-44,439,451,890
13283,24029,45-49,428,435,863
13284,24029,50-54,561,532,1093
13285,24029,55-59,720,684,1404
13286,24029,60-64,864,745,1609
13287,24029,65+,2875,2323,5198
13288,24031,15-19,32242,33810,66052
13289,24031,20-24,29340,28948,58288
13290,24031,25-29,30824,30297,61121
13291,24031,30-34,33887,32637,66524
13292,24031,35-39,37600,35999,73599
13293,24031,40-44,37681,35959,73640
13294,24031,45-49,35863,33976,69839
13295,24031,50-54,37794,35330,73124
13296,24031,55-59,37525,34836,72361
13297,24031,60-64,34596,32627,67223
13298,24031,65+,97927,77110,175037
13299,24033,15-19,30533,31501,62034
13300,24033,20-24,29995,29847,59842
13301,24033,25-29,33086,31894,64980
13302,24033,30-34,34185,34747,68932
13303,24033,35-39,33042,32474,65516
13304,24033,40-44,32329,32024,64353
13305,24033,45-49,30448,29010,59458
13306,24033,50-54,34550,31564,66114
13307,24033,55-59,35917,31460,67377
13308,24033,60-64,32595,28690,61285
13309,24033,65+,80735,57920,138655
13310,24035,15-19,1531,1602,3133
13311,24035,20-24,1283,1379,2662
13312,24035,25-29,1162,1277,2439
13313,24035,30-34,1452,1387,2839
13314,24035,35-39,1550,1520,3070
13315,24035,40-44,1411,1360,2771
13316,24035,45-49,1471,1482,2953
13317,24035,50-54,1936,1853,3789
13318,24035,55-59,2128,2216,4344
13319,24035,60-64,2009,2028,4037
13320,24035,65+,5281,4754,10035
13321,24037,15-19,3881,3968,7849
13322,24037,20-24,3687,3730,7417
13323,24037,25-29,3768,4139,7907
13324,24037,30-34,4050,4248,8298
13325,24037,35-39,4005,4018,8023
13326,24037,40-44,3524,3585,7109
13327,24037,45-49,3318,3285,6603
13328,24037,50-54,3897,3740,7637
13329,24037,55-59,4107,4215,8322
13330,24037,60-64,3503,3655,7158
13331,24037,65+,8279,7373,15652
13332,24039,15-19,988,955,1943
13333,24039,20-24,1284,1586,2870
13334,24039,25-29,605,1045,1650
13335,24039,30-34,554,934,1488
13336,24039,35-39,563,932,1495
13337,24039,40-44,531,879,1410
13338,24039,45-49,523,807,1330
13339,24039,50-54,625,765,1390
13340,24039,55-59,731,820,1551
13341,24039,60-64,817,849,1666
13342,24039,65+,2310,1974,4284
13343,24041,15-19,928,959,1887
13344,24041,20-24,831,860,1691
13345,24041,25-29,853,845,1698
13346,24041,30-34,1011,926,1937
13347,24041,35-39,937,915,1852
13348,24041,40-44,899,864,1763
13349,24041,45-49,1005,857,1862
13350,24041,50-54,1204,1078,2282
13351,24041,55-59,1528,1288,2816
13352,24041,60-64,1591,1422,3013
13353,24041,65+,6194,5054,11248
13354,24043,15-19,4479,5000,9479
13355,24043,20-24,4090,5137,9227
13356,24043,25-29,4459,5493,9952
13357,24043,30-34,4728,5400,10128
13358,24043,35-39,4633,5407,10040
13359,24043,40-44,4425,5298,9723
13360,24043,45-49,4437,5057,9494
13361,24043,50-54,5243,5579,10822
13362,24043,55-59,5552,5528,11080
13363,24043,60-64,5089,5149,10238
13364,24043,65+,14979,12352,27331
13365,24045,15-19,4833,4267,9100
13366,24045,20-24,5439,4679,10118
13367,24045,25-29,3355,3215,6570
13368,24045,30-34,3127,2868,5995
13369,24045,35-39,3011,2808,5819
13370,24045,40-44,3022,2781,5803
13371,24045,45-49,2861,2477,5338
13372,24045,50-54,3069,2900,5969
13373,24045,55-59,3414,3131,6545
13374,24045,60-64,3421,3046,6467
13375,24045,65+,9627,7521,17148
13376,24047,15-19,1200,1350,2550
13377,24047,20-24,1304,1284,2588
13378,24047,25-29,1378,1440,2818
13379,24047,30-34,1400,1349,2749
13380,24047,35-39,1388,1372,2760
13381,24047,40-44,1323,1318,2641
13382,24047,45-49,1347,1326,2673
13383,24047,50-54,1741,1652,3393
13384,24047,55-59,2200,1973,4173
13385,24047,60-64,2309,2118,4427
13386,24047,65+,7979,6982,14961
13387,24510,15-19,17251,16732,33983
13388,24510,20-24,19965,17784,37749
13389,24510,25-29,26588,24367,50955
13390,24510,30-34,28414,26295,54709
13391,24510,35-39,23035,20861,43896
13392,24510,40-44,18784,16653,35437
13393,24510,45-49,15597,13752,29349
13394,24510,50-54,17200,15463,32663
13395,24510,55-59,19158,16864,36022
13396,24510,60-64,20386,16326,36712
13397,24510,65+,51018,35258,86276
13398,25001,15-19,5094,5806,10900
13399,25001,20-24,5187,6368,11555
13400,25001,25-29,5159,5657,10816
13401,25001,30-34,5313,5401,10714
13402,25001,35-39,5342,5396,10738
13403,25001,40-44,5292,5257,10549
13404,25001,45-49,5381,4968,10349
13405,25001,50-54,7667,6738,14405
13406,25001,55-59,10075,9079,19154
13407,25001,60-64,12032,10543,22575
13408,25001,65+,40650,33214,73864
13409,25003,15-19,3951,3898,7849
13410,25003,20-24,4004,3937,7941
13411,25003,25-29,3452,3536,6988
13412,25003,30-34,3454,3526,6980
13413,25003,35-39,3614,3686,7300
13414,25003,40-44,3517,3586,7103
13415,25003,45-49,3429,3390,6819
13416,25003,50-54,4271,4146,8417
13417,25003,55-59,5170,4928,10098
13418,25003,60-64,5613,5214,10827
13419,25003,65+,17277,14409,31686
13420,25005,15-19,17973,18689,36662
13421,25005,20-24,17839,18126,35965
13422,25005,25-29,18112,18306,36418
13423,25005,30-34,19755,19248,39003
13424,25005,35-39,19110,18610,37720
13425,25005,40-44,18301,17847,36148
13426,25005,45-49,18367,17310,35677
13427,25005,50-54,20778,20265,41043
13428,25005,55-59,21705,21199,42904
13429,25005,60-64,20755,19386,40141
13430,25005,65+,56788,44602,101390
13431,25007,15-19,459,541,1000
13432,25007,20-24,458,449,907
13433,25007,25-29,518,562,1080
13434,25007,30-34,587,603,1190
13435,25007,35-39,577,627,1204
13436,25007,40-44,609,606,1215
13437,25007,45-49,587,580,1167
13438,25007,50-54,697,704,1401
13439,25007,55-59,858,826,1684
13440,25007,60-64,868,932,1800
13441,25007,65+,2931,2460,5391
13442,25009,15-19,25870,26325,52195
13443,25009,20-24,25313,25569,50882
13444,25009,25-29,24364,24810,49174
13445,25009,30-34,26387,25577,51964
13446,25009,35-39,26457,25588,52045
13447,25009,40-44,25405,24224,49629
13448,25009,45-49,24558,23060,47618
13449,25009,50-54,28720,26580,55300
13450,25009,55-59,30674,28492,59166
13451,25009,60-64,29477,27264,56741
13452,25009,65+,81009,63290,144299
13453,25011,15-19,1678,1859,3537
13454,25011,20-24,1658,1823,3481
13455,25011,25-29,1944,1880,3824
13456,25011,30-34,2213,2155,4368
13457,25011,35-39,2263,2321,4584
13458,25011,40-44,2168,2191,4359
13459,25011,45-49,2014,1974,3988
13460,25011,50-54,2431,2269,4700
13461,25011,55-59,2721,2597,5318
13462,25011,60-64,3217,2895,6112
13463,25011,65+,9200,7913,17113
13464,25013,15-19,15541,16467,32008
13465,25013,20-24,15796,15998,31794
13466,25013,25-29,15250,15470,30720
13467,25013,30-34,15761,15542,31303
13468,25013,35-39,15169,14330,29499
13469,25013,40-44,14211,12977,27188
13470,25013,45-49,13766,12285,26051
13471,25013,50-54,15393,14133,29526
13472,25013,55-59,16481,15261,31742
13473,25013,60-64,16197,15235,31432
13474,25013,65+,45725,36079,81804
13475,25015,15-19,10238,7651,17889
13476,25015,20-24,13374,10730,24104
13477,25015,25-29,4360,4264,8624
13478,25015,30-34,4093,4029,8122
13479,25015,35-39,4207,4183,8390
13480,25015,40-44,4327,3817,8144
13481,25015,45-49,3927,3778,7705
13482,25015,50-54,4688,4444,9132
13483,25015,55-59,5393,4875,10268
13484,25015,60-64,5632,4939,10571
13485,25015,65+,16860,13440,30300
13486,25017,15-19,50323,51751,102074
13487,25017,20-24,54075,54592,108667
13488,25017,25-29,58971,62013,120984
13489,25017,30-34,60068,62105,122173
13490,25017,35-39,58534,59078,117612
13491,25017,40-44,53448,52948,106396
13492,25017,45-49,49911,49523,99434
13493,25017,50-54,54172,53056,107228
13494,25017,55-59,55743,54667,110410
13495,25017,60-64,52026,50235,102261
13496,25017,65+,143606,113821,257427
13497,25019,15-19,386,353,739
13498,25019,20-24,341,365,706
13499,25019,25-29,501,431,932
13500,25019,30-34,482,553,1035
13501,25019,35-39,484,580,1064
13502,25019,40-44,516,590,1106
13503,25019,45-49,473,622,1095
13504,25019,50-54,478,580,1058
13505,25019,55-59,479,557,1036
13506,25019,60-64,478,463,941
13507,25019,65+,1210,1096,2306
13508,25021,15-19,23065,23194,46259
13509,25021,20-24,22982,21509,44491
13510,25021,25-29,22665,22270,44935
13511,25021,30-34,24702,23973,48675
13512,25021,35-39,25093,24686,49779
13513,25021,40-44,23430,22815,46245
13514,25021,45-49,23027,22188,45215
13515,25021,50-54,25780,24691,50471
13516,25021,55-59,26890,25860,52750
13517,25021,60-64,25348,23738,49086
13518,25021,65+,70792,54688,125480
13519,25023,15-19,16678,17544,34222
13520,25023,20-24,15961,15964,31925
13521,25023,25-29,14349,14815,29164
13522,25023,30-34,15364,15400,30764
13523,25023,35-39,16634,15993,32627
13524,25023,40-44,15743,15704,31447
13525,25023,45-49,16084,15800,31884
13526,25023,50-54,19977,18915,38892
13527,25023,55-59,21100,20119,41219
13528,25023,60-64,20294,19042,39336
13529,25023,65+,56565,45342,101907
13530,25025,15-19,28230,25217,53447
13531,25025,20-24,37714,32961,70675
13532,25025,25-29,45432,43349,88781
13533,25025,30-34,41423,41411,82834
13534,25025,35-39,29546,29988,59534
13535,25025,40-44,22853,22821,45674
13536,25025,45-49,20587,19942,40529
13537,25025,50-54,21494,20780,42274
13538,25025,55-59,21887,21030,42917
13539,25025,60-64,20781,19316,40097
13540,25025,65+,57010,42434,99444
13541,25027,15-19,28421,29686,58107
13542,25027,20-24,27584,28080,55664
13543,25027,25-29,26633,27713,54346
13544,25027,30-34,28748,29434,58182
13545,25027,35-39,28505,28734,57239
13546,25027,40-44,26360,26374,52734
13547,25027,45-49,26751,26430,53181
13548,25027,50-54,30428,30109,60537
13549,25027,55-59,32293,31971,64264
13550,25027,60-64,30243,30319,60562
13551,25027,65+,77795,64487,142282
13552,26001,15-19,191,204,395
13553,26001,20-24,151,192,343
13554,26001,25-29,207,226,433
13555,26001,30-34,175,210,385
13556,26001,35-39,191,189,380
13557,26001,40-44,209,215,424
13558,26001,45-49,233,197,430
13559,26001,50-54,327,340,667
13560,26001,55-59,453,427,880
13561,26001,60-64,620,614,1234
13562,26001,65+,1778,1857,3635
13563,26003,15-19,182,236,418
13564,26003,20-24,176,325,501
13565,26003,25-29,136,365,501
13566,26003,30-34,178,344,522
13567,26003,35-39,181,354,535
13568,26003,40-44,203,291,494
13569,26003,45-49,195,267,462
13570,26003,50-54,242,283,525
13571,26003,55-59,313,354,667
13572,26003,60-64,398,396,794
13573,26003,65+,1158,1193,2351
13574,26005,15-19,3796,3954,7750
13575,26005,20-24,3197,3485,6682
13576,26005,25-29,3482,3600,7082
13577,26005,30-34,3683,3700,7383
13578,26005,35-39,3791,3798,7589
13579,26005,40-44,3602,3785,7387
13580,26005,45-49,3367,3564,6931
13581,26005,50-54,3950,3996,7946
13582,26005,55-59,4202,4429,8631
13583,26005,60-64,4372,4518,8890
13584,26005,65+,11215,10098,21313
13585,26007,15-19,743,812,1555
13586,26007,20-24,666,727,1393
13587,26007,25-29,725,822,1547
13588,26007,30-34,760,796,1556
13589,26007,35-39,753,857,1610
13590,26007,40-44,780,867,1647
13591,26007,45-49,773,788,1561
13592,26007,50-54,880,810,1690
13593,26007,55-59,1150,1083,2233
13594,26007,60-64,1308,1299,2607
13595,26007,65+,3814,3285,7099
13596,26009,15-19,637,623,1260
13597,26009,20-24,508,535,1043
13598,26009,25-29,553,635,1188
13599,26009,30-34,546,560,1106
13600,26009,35-39,576,618,1194
13601,26009,40-44,588,621,1209
13602,26009,45-49,550,579,1129
13603,26009,50-54,732,723,1455
13604,26009,55-59,998,940,1938
13605,26009,60-64,1170,1144,2314
13606,26009,65+,3454,3252,6706
13607,26011,15-19,383,377,760
13608,26011,20-24,304,333,637
13609,26011,25-29,324,378,702
13610,26011,30-34,403,394,797
13611,26011,35-39,370,371,741
13612,26011,40-44,388,409,797
13613,26011,45-49,361,397,758
13614,26011,50-54,454,464,918
13615,26011,55-59,578,571,1149
13616,26011,60-64,715,773,1488
13617,26011,65+,1959,2010,3969
13618,26013,15-19,225,239,464
13619,26013,20-24,170,324,494
13620,26013,25-29,177,364,541
13621,26013,30-34,157,334,491
13622,26013,35-39,177,318,495
13623,26013,40-44,172,297,469
13624,26013,45-49,202,263,465
13625,26013,50-54,283,285,568
13626,26013,55-59,280,332,612
13627,26013,60-64,307,318,625
13628,26013,65+,978,913,1891
13629,26015,15-19,1846,2078,3924
13630,26015,20-24,1582,1733,3315
13631,26015,25-29,1701,1758,3459
13632,26015,30-34,1960,1919,3879
13633,26015,35-39,1822,1950,3772
13634,26015,40-44,1767,1955,3722
13635,26015,45-49,1761,1839,3600
13636,26015,50-54,2053,2158,4211
13637,26015,55-59,2390,2486,4876
13638,26015,60-64,2413,2520,4933
13639,26015,65+,6304,5783,12087
13640,26017,15-19,2898,3127,6025
13641,26017,20-24,2832,2942,5774
13642,26017,25-29,3066,3209,6275
13643,26017,30-34,3144,3226,6370
13644,26017,35-39,2977,3098,6075
13645,26017,40-44,3034,3047,6081
13646,26017,45-49,2903,2927,5830
13647,26017,50-54,3263,3367,6630
13648,26017,55-59,3802,3680,7482
13649,26017,60-64,4151,3906,8057
13650,26017,65+,12086,10008,22094
13651,26019,15-19,439,491,930
13652,26019,20-24,380,406,786
13653,26019,25-29,405,454,859
13654,26019,30-34,480,498,978
13655,26019,35-39,484,550,1034
13656,26019,40-44,501,491,992
13657,26019,45-49,451,441,892
13658,26019,50-54,532,529,1061
13659,26019,55-59,741,704,1445
13660,26019,60-64,813,835,1648
13661,26019,65+,2566,2402,4968
13662,26021,15-19,4604,4959,9563
13663,26021,20-24,4324,4423,8747
13664,26021,25-29,4264,4414,8678
13665,26021,30-34,4432,4457,8889
13666,26021,35-39,4645,4486,9131
13667,26021,40-44,4456,4459,8915
13668,26021,45-49,4237,4347,8584
13669,26021,50-54,4994,4821,9815
13670,26021,55-59,5365,5344,10709
13671,26021,60-64,5777,5558,11335
13672,26021,65+,17356,14450,31806
13673,26023,15-19,1362,1460,2822
13674,26023,20-24,1117,1343,2460
13675,26023,25-29,1222,1422,2644
13676,26023,30-34,1188,1408,2596
13677,26023,35-39,1290,1559,2849
13678,26023,40-44,1176,1546,2722
13679,26023,45-49,1098,1493,2591
13680,26023,50-54,1289,1531,2820
13681,26023,55-59,1463,1604,3067
13682,26023,60-64,1669,1693,3362
13683,26023,65+,4482,3953,8435
13684,26025,15-19,4179,4661,8840
13685,26025,20-24,4085,4181,8266
13686,26025,25-29,4242,4109,8351
13687,26025,30-34,4204,4059,8263
13688,26025,35-39,4096,3997,8093
13689,26025,40-44,4131,4037,8168
13690,26025,45-49,3881,3809,7690
13691,26025,50-54,4237,4254,8491
13692,26025,55-59,4412,4453,8865
13693,26025,60-64,4717,4525,9242
13694,26025,65+,13531,11026,24557
13695,26027,15-19,1504,1649,3153
13696,26027,20-24,1249,1328,2577
13697,26027,25-29,1258,1383,2641
13698,26027,30-34,1321,1373,2694
13699,26027,35-39,1433,1464,2897
13700,26027,40-44,1487,1522,3009
13701,26027,45-49,1473,1512,2985
13702,26027,50-54,1743,1828,3571
13703,26027,55-59,1999,2017,4016
13704,26027,60-64,1979,2033,4012
13705,26027,65+,5926,5463,11389
13706,26029,15-19,677,763,1440
13707,26029,20-24,621,656,1277
13708,26029,25-29,632,706,1338
13709,26029,30-34,657,694,1351
13710,26029,35-39,694,718,1412
13711,26029,40-44,641,706,1347
13712,26029,45-49,624,620,1244
13713,26029,50-54,854,835,1689
13714,26029,55-59,977,1065,2042
13715,26029,60-64,1279,1153,2432
13716,26029,65+,3517,3269,6786
13717,26031,15-19,591,706,1297
13718,26031,20-24,562,642,1204
13719,26031,25-29,596,678,1274
13720,26031,30-34,611,616,1227
13721,26031,35-39,622,653,1275
13722,26031,40-44,635,684,1319
13723,26031,45-49,717,673,1390
13724,26031,50-54,865,896,1761
13725,26031,55-59,1008,959,1967
13726,26031,60-64,1248,1231,2479
13727,26031,65+,3736,3579,7315
13728,26033,15-19,1045,1146,2191
13729,26033,20-24,1425,1721,3146
13730,26033,25-29,880,1589,2469
13731,26033,30-34,853,1545,2398
13732,26033,35-39,897,1575,2472
13733,26033,40-44,923,1487,2410
13734,26033,45-49,823,1335,2158
13735,26033,50-54,913,1328,2241
13736,26033,55-59,1124,1300,2424
13737,26033,60-64,1230,1307,2537
13738,26033,65+,3576,3383,6959
13739,26035,15-19,789,840,1629
13740,26035,20-24,658,776,1434
13741,26035,25-29,791,804,1595
13742,26035,30-34,831,854,1685
13743,26035,35-39,759,765,1524
13744,26035,40-44,789,795,1584
13745,26035,45-49,817,861,1678
13746,26035,50-54,995,1011,2006
13747,26035,55-59,1204,1190,2394
13748,26035,60-64,1393,1370,2763
13749,26035,65+,3942,3735,7677
13750,26037,15-19,2428,2619,5047
13751,26037,20-24,2358,2386,4744
13752,26037,25-29,2214,2394,4608
13753,26037,30-34,2480,2412,4892
13754,26037,35-39,2535,2561,5096
13755,26037,40-44,2564,2575,5139
13756,26037,45-49,2392,2287,4679
13757,26037,50-54,2798,2715,5513
13758,26037,55-59,2906,2855,5761
13759,26037,60-64,2685,2770,5455
13760,26037,65+,7729,6802,14531
13761,26039,15-19,306,347,653
13762,26039,20-24,279,282,561
13763,26039,25-29,319,337,656
13764,26039,30-34,311,349,660
13765,26039,35-39,336,343,679
13766,26039,40-44,330,345,675
13767,26039,45-49,327,315,642
13768,26039,50-54,437,482,919
13769,26039,55-59,542,570,1112
13770,26039,60-64,635,684,1319
13771,26039,65+,1697,1729,3426
13772,26041,15-19,1019,1093,2112
13773,26041,20-24,877,958,1835
13774,26041,25-29,887,938,1825
13775,26041,30-34,896,925,1821
13776,26041,35-39,958,997,1955
13777,26041,40-44,997,1103,2100
13778,26041,45-49,983,1025,2008
13779,26041,50-54,1114,1181,2295
13780,26041,55-59,1330,1332,2662
13781,26041,60-64,1537,1565,3102
13782,26041,65+,4940,4391,9331
13783,26043,15-19,657,758,1415
13784,26043,20-24,596,684,1280
13785,26043,25-29,645,720,1365
13786,26043,30-34,640,712,1352
13787,26043,35-39,740,776,1516
13788,26043,40-44,719,714,1433
13789,26043,45-49,657,682,1339
13790,26043,50-54,775,822,1597
13791,26043,55-59,955,997,1952
13792,26043,60-64,1110,1080,2190
13793,26043,65+,3189,2991,6180
13794,26045,15-19,3162,3371,6533
13795,26045,20-24,3219,3353,6572
13796,26045,25-29,3478,3515,6993
13797,26045,30-34,3478,3532,7010
13798,26045,35-39,3414,3577,6991
13799,26045,40-44,3327,3413,6740
13800,26045,45-49,3056,3045,6101
13801,26045,50-54,3482,3427,6909
13802,26045,55-59,3954,3662,7616
13803,26045,60-64,4079,3837,7916
13804,26045,65+,11446,9776,21222
13805,26047,15-19,920,1011,1931
13806,26047,20-24,873,966,1839
13807,26047,25-29,902,948,1850
13808,26047,30-34,958,1000,1958
13809,26047,35-39,1027,971,1998
13810,26047,40-44,981,951,1932
13811,26047,45-49,942,971,1913
13812,26047,50-54,1044,1115,2159
13813,26047,55-59,1228,1158,2386
13814,26047,60-64,1533,1402,2935
13815,26047,65+,4296,3922,8218
13816,26049,15-19,12307,13131,25438
13817,26049,20-24,12132,12350,24482
13818,26049,25-29,13453,13055,26508
13819,26049,30-34,12918,12143,25061
13820,26049,35-39,11889,11110,22999
13821,26049,40-44,12618,11652,24270
13822,26049,45-49,12395,11576,23971
13823,26049,50-54,13671,13025,26696
13824,26049,55-59,14572,13639,28211
13825,26049,60-64,15128,13725,28853
13826,26049,65+,41120,32630,73750
13827,26051,15-19,577,669,1246
13828,26051,20-24,543,565,1108
13829,26051,25-29,552,583,1135
13830,26051,30-34,612,627,1239
13831,26051,35-39,603,631,1234
13832,26051,40-44,619,642,1261
13833,26051,45-49,630,663,1293
13834,26051,50-54,839,834,1673
13835,26051,55-59,950,996,1946
13836,26051,60-64,1218,1238,2456
13837,26051,65+,3567,3362,6929
13838,26053,15-19,335,381,716
13839,26053,20-24,287,327,614
13840,26053,25-29,307,375,682
13841,26053,30-34,365,350,715
13842,26053,35-39,338,387,725
13843,26053,40-44,366,373,739
13844,26053,45-49,336,389,725
13845,26053,50-54,445,470,915
13846,26053,55-59,543,553,1096
13847,26053,60-64,641,670,1311
13848,26053,65+,2081,2053,4134
13849,26055,15-19,2710,2842,5552
13850,26055,20-24,2479,2568,5047
13851,26055,25-29,2766,2947,5713
13852,26055,30-34,3035,3033,6068
13853,26055,35-39,3120,3226,6346
13854,26055,40-44,2906,2917,5823
13855,26055,45-49,2637,2666,5303
13856,26055,50-54,2948,2996,5944
13857,26055,55-59,3418,3219,6637
13858,26055,60-64,3962,3620,7582
13859,26055,65+,11082,9367,20449
13860,26057,15-19,1404,1476,2880
13861,26057,20-24,1350,1881,3231
13862,26057,25-29,1078,1721,2799
13863,26057,30-34,1059,1662,2721
13864,26057,35-39,1105,1608,2713
13865,26057,40-44,1109,1633,2742
13866,26057,45-49,985,1454,2439
13867,26057,50-54,1167,1462,2629
13868,26057,55-59,1320,1481,2801
13869,26057,60-64,1275,1393,2668
13870,26057,65+,3953,3335,7288
13871,26059,15-19,1586,1621,3207
13872,26059,20-24,1476,1446,2922
13873,26059,25-29,1150,1255,2405
13874,26059,30-34,1200,1264,2464
13875,26059,35-39,1242,1234,2476
13876,26059,40-44,1261,1271,2532
13877,26059,45-49,1239,1305,2544
13878,26059,50-54,1381,1467,2848
13879,26059,55-59,1546,1628,3174
13880,26059,60-64,1858,1782,3640
13881,26059,65+,4942,4497,9439
13882,26061,15-19,1490,2253,3743
13883,26061,20-24,1884,3565,5449
13884,26061,25-29,894,1116,2010
13885,26061,30-34,840,963,1803
13886,26061,35-39,899,965,1864
13887,26061,40-44,880,890,1770
13888,26061,45-49,823,874,1697
13889,26061,50-54,826,961,1787
13890,26061,55-59,1027,1047,2074
13891,26061,60-64,1074,1099,2173
13892,26061,65+,3499,3213,6712
13893,26063,15-19,803,876,1679
13894,26063,20-24,721,794,1515
13895,26063,25-29,703,816,1519
13896,26063,30-34,742,746,1488
13897,26063,35-39,741,831,1572
13898,26063,40-44,784,837,1621
13899,26063,45-49,759,783,1542
13900,26063,50-54,1023,1012,2035
13901,26063,55-59,1193,1190,2383
13902,26063,60-64,1385,1406,2791
13903,26063,65+,4364,3908,8272
13904,26065,15-19,12597,11968,24565
13905,26065,20-24,18839,18661,37500
13906,26065,25-29,10632,10975,21607
13907,26065,30-34,9352,9552,18904
13908,26065,35-39,8524,8631,17155
13909,26065,40-44,8155,8024,16179
13910,26065,45-49,7422,6959,14381
13911,26065,50-54,7693,7517,15210
13912,26065,55-59,7913,7466,15379
13913,26065,60-64,8409,7406,15815
13914,26065,65+,22855,18159,41014
13915,26067,15-19,1912,2310,4222
13916,26067,20-24,1700,2770,4470
13917,26067,25-29,2021,2861,4882
13918,26067,30-34,1924,2675,4599
13919,26067,35-39,1923,2537,4460
13920,26067,40-44,1858,2518,4376
13921,26067,45-49,1869,2356,4225
13922,26067,50-54,2076,2499,4575
13923,26067,55-59,2173,2384,4557
13924,26067,60-64,2146,2339,4485
13925,26067,65+,5479,4974,10453
13926,26069,15-19,548,580,1128
13927,26069,20-24,500,567,1067
13928,26069,25-29,565,637,1202
13929,26069,30-34,575,607,1182
13930,26069,35-39,575,620,1195
13931,26069,40-44,608,601,1209
13932,26069,45-49,539,558,1097
13933,26069,50-54,738,807,1545
13934,26069,55-59,1004,954,1958
13935,26069,60-64,1279,1278,2557
13936,26069,65+,3913,3725,7638
13937,26071,15-19,261,282,543
13938,26071,20-24,220,234,454
13939,26071,25-29,199,252,451
13940,26071,30-34,246,263,509
13941,26071,35-39,307,258,565
13942,26071,40-44,279,314,593
13943,26071,45-49,249,290,539
13944,26071,50-54,298,345,643
13945,26071,55-59,456,451,907
13946,26071,60-64,585,561,1146
13947,26071,65+,1814,1801,3615
13948,26073,15-19,3627,3046,6673
13949,26073,20-24,6468,5622,12090
13950,26073,25-29,1917,2183,4100
13951,26073,30-34,1769,1884,3653
13952,26073,35-39,1675,1746,3421
13953,26073,40-44,1634,1707,3341
13954,26073,45-49,1414,1501,2915
13955,26073,50-54,1608,1620,3228
13956,26073,55-59,1740,1764,3504
13957,26073,60-64,1851,1724,3575
13958,26073,65+,4766,4133,8899
13959,26075,15-19,4690,5129,9819
13960,26075,20-24,4372,5208,9580
13961,26075,25-29,4703,5544,10247
13962,26075,30-34,4920,5556,10476
13963,26075,35-39,4411,5133,9544
13964,26075,40-44,4344,5186,9530
13965,26075,45-49,4240,5053,9293
13966,26075,50-54,5173,5544,10717
13967,26075,55-59,5592,5696,11288
13968,26075,60-64,5772,5926,11698
13969,26075,65+,16126,13803,29929
13970,26077,15-19,9077,9362,18439
13971,26077,20-24,15566,14714,30280
13972,26077,25-29,9378,9415,18793
13973,26077,30-34,8372,8541,16913
13974,26077,35-39,7924,8153,16077
13975,26077,40-44,7798,7778,15576
13976,26077,45-49,6779,6787,13566
13977,26077,50-54,7186,7165,14351
13978,26077,55-59,7453,6989,14442
13979,26077,60-64,7687,7274,14961
13980,26077,65+,22951,18311,41262
13981,26079,15-19,484,523,1007
13982,26079,20-24,407,435,842
13983,26079,25-29,488,529,1017
13984,26079,30-34,539,552,1091
13985,26079,35-39,519,562,1081
13986,26079,40-44,510,515,1025
13987,26079,45-49,504,529,1033
13988,26079,50-54,551,607,1158
13989,26079,55-59,667,709,1376
13990,26079,60-64,796,766,1562
13991,26079,65+,1834,1934,3768
13992,26081,15-19,21212,22206,43418
13993,26081,20-24,22119,21623,43742
13994,26081,25-29,25874,26339,52213
13995,26081,30-34,25649,25966,51615
13996,26081,35-39,23122,23301,46423
13997,26081,40-44,20557,20828,41385
13998,26081,45-49,18000,18102,36102
13999,26081,50-54,19279,19447,38726
14000,26081,55-59,20140,19895,40035
14001,26081,60-64,20262,19452,39714
14002,26081,65+,52551,43213,95764
14003,26083,15-19,57,42,99
14004,26083,20-24,45,36,81
14005,26083,25-29,35,50,85
14006,26083,30-34,39,43,82
14007,26083,35-39,44,47,91
14008,26083,40-44,36,51,87
14009,26083,45-49,62,51,113
14010,26083,50-54,53,50,103
14011,26083,55-59,73,73,146
14012,26083,60-64,98,92,190
14013,26083,65+,362,400,762
14014,26085,15-19,246,254,500
14015,26085,20-24,220,228,448
14016,26085,25-29,222,216,438
14017,26085,30-34,234,235,469
14018,26085,35-39,300,270,570
14019,26085,40-44,286,301,587
14020,26085,45-49,300,333,633
14021,26085,50-54,404,454,858
14022,26085,55-59,539,532,1071
14023,26085,60-64,648,646,1294
14024,26085,65+,1806,1970,3776
14025,26087,15-19,2538,2977,5515
14026,26087,20-24,2250,2580,4830
14027,26087,25-29,2354,2596,4950
14028,26087,30-34,2337,2652,4989
14029,26087,35-39,2351,2621,4972
14030,26087,40-44,2483,2684,5167
14031,26087,45-49,2541,2653,5194
14032,26087,50-54,3202,3376,6578
14033,26087,55-59,3658,3756,7414
14034,26087,60-64,3599,3773,7372
14035,26087,65+,8983,8294,17277
14036,26089,15-19,488,546,1034
14037,26089,20-24,451,499,950
14038,26089,25-29,454,430,884
14039,26089,30-34,496,491,987
14040,26089,35-39,593,542,1135
14041,26089,40-44,532,610,1142
14042,26089,45-49,468,520,988
14043,26089,50-54,628,625,1253
14044,26089,55-59,916,806,1722
14045,26089,60-64,1141,1069,2210
14046,26089,65+,3848,3623,7471
14047,26091,15-19,3156,3532,6688
14048,26091,20-24,2822,3320,6142
14049,26091,25-29,2658,3057,5715
14050,26091,30-34,2772,3053,5825
14051,26091,35-39,2776,3114,5890
14052,26091,40-44,2804,3151,5955
14053,26091,45-49,2784,3102,5886
14054,26091,50-54,3220,3437,6657
14055,26091,55-59,3438,3415,6853
14056,26091,60-64,3616,3556,7172
14057,26091,65+,10543,8973,19516
14058,26093,15-19,5748,6309,12057
14059,26093,20-24,5223,5816,11039
14060,26093,25-29,5044,5672,10716
14061,26093,30-34,5440,5594,11034
14062,26093,35-39,5725,5882,11607
14063,26093,40-44,5699,5980,11679
14064,26093,45-49,5788,5828,11616
14065,26093,50-54,7450,7407,14857
14066,26093,55-59,8009,8034,16043
14067,26093,60-64,7632,7824,15456
14068,26093,65+,19193,17553,36746
14069,26095,15-19,108,134,242
14070,26095,20-24,89,222,311
14071,26095,25-29,114,223,337
14072,26095,30-34,110,264,374
14073,26095,35-39,109,252,361
14074,26095,40-44,105,236,341
14075,26095,45-49,120,230,350
14076,26095,50-54,126,208,334
14077,26095,55-59,161,203,364
14078,26095,60-64,181,210,391
14079,26095,65+,589,583,1172
14080,26097,15-19,259,304,563
14081,26097,20-24,213,272,485
14082,26097,25-29,251,270,521
14083,26097,30-34,252,271,523
14084,26097,35-39,222,280,502
14085,26097,40-44,268,281,549
14086,26097,45-49,320,306,626
14087,26097,50-54,329,394,723
14088,26097,55-59,413,446,859
14089,26097,60-64,517,513,1030
14090,26097,65+,1609,1545,3154
14091,26099,15-19,24633,26625,51258
14092,26099,20-24,25193,25618,50811
14093,26099,25-29,30285,30449,60734
14094,26099,30-34,29950,30366,60316
14095,26099,35-39,26755,26684,53439
14096,26099,40-44,26787,26007,52794
14097,26099,45-49,27416,26513,53929
14098,26099,50-54,31250,30019,61269
14099,26099,55-59,32617,31767,64384
14100,26099,60-64,32197,30443,62640
14101,26099,65+,87463,69146,156609
14102,26101,15-19,664,707,1371
14103,26101,20-24,571,805,1376
14104,26101,25-29,507,862,1369
14105,26101,30-34,566,773,1339
14106,26101,35-39,590,720,1310
14107,26101,40-44,588,736,1324
14108,26101,45-49,605,676,1281
14109,26101,50-54,714,882,1596
14110,26101,55-59,938,915,1853
14111,26101,60-64,1186,1099,2285
14112,26101,65+,3530,3302,6832
14113,26103,15-19,2350,2218,4568
14114,26103,20-24,3642,3700,7342
14115,26103,25-29,1898,2153,4051
14116,26103,30-34,1739,1925,3664
14117,26103,35-39,1847,2082,3929
14118,26103,40-44,1847,2041,3888
14119,26103,45-49,1541,1742,3283
14120,26103,50-54,1726,1897,3623
14121,26103,55-59,2010,2034,4044
14122,26103,60-64,2345,2229,4574
14123,26103,65+,6883,6555,13438
14124,26105,15-19,778,844,1622
14125,26105,20-24,653,755,1408
14126,26105,25-29,760,811,1571
14127,26105,30-34,780,771,1551
14128,26105,35-39,772,803,1575
14129,26105,40-44,813,797,1610
14130,26105,45-49,750,748,1498
14131,26105,50-54,882,832,1714
14132,26105,55-59,1057,1037,2094
14133,26105,60-64,1230,1222,2452
14134,26105,65+,3951,3502,7453
14135,26107,15-19,1910,1924,3834
14136,26107,20-24,2185,2622,4807
14137,26107,25-29,1010,1175,2185
14138,26107,30-34,1021,1080,2101
14139,26107,35-39,942,955,1897
14140,26107,40-44,946,1018,1964
14141,26107,45-49,945,899,1844
14142,26107,50-54,1089,1100,2189
14143,26107,55-59,1276,1290,2566
14144,26107,60-64,1483,1504,2987
14145,26107,65+,4019,3596,7615
14146,26109,15-19,579,695,1274
14147,26109,20-24,521,567,1088
14148,26109,25-29,531,588,1119
14149,26109,30-34,569,623,1192
14150,26109,35-39,554,654,1208
14151,26109,40-44,610,696,1306
14152,26109,45-49,585,642,1227
14153,26109,50-54,756,786,1542
14154,26109,55-59,876,985,1861
14155,26109,60-64,996,1072,2068
14156,26109,65+,3130,2970,6100
14157,26111,15-19,2582,2754,5336
14158,26111,20-24,2356,2480,4836
14159,26111,25-29,2433,2535,4968
14160,26111,30-34,2621,2738,5359
14161,26111,35-39,2594,2739,5333
14162,26111,40-44,2506,2516,5022
14163,26111,45-49,2378,2377,4755
14164,26111,50-54,2703,2666,5369
14165,26111,55-59,2982,3053,6035
14166,26111,60-64,2979,2913,5892
14167,26111,65+,8919,7293,16212
14168,26113,15-19,436,463,899
14169,26113,20-24,328,393,721
14170,26113,25-29,429,469,898
14171,26113,30-34,442,437,879
14172,26113,35-39,412,462,874
14173,26113,40-44,420,388,808
14174,26113,45-49,357,390,747
14175,26113,50-54,467,458,925
14176,26113,55-59,572,612,1184
14177,26113,60-64,574,622,1196
14178,26113,65+,1635,1583,3218
14179,26115,15-19,4614,4692,9306
14180,26115,20-24,4176,4458,8634
14181,26115,25-29,4446,4724,9170
14182,26115,30-34,4620,4840,9460
14183,26115,35-39,4624,4579,9203
14184,26115,40-44,4715,4597,9312
14185,26115,45-49,4678,4799,9477
14186,26115,50-54,5256,5366,10622
14187,26115,55-59,5881,5779,11660
14188,26115,60-64,5886,5991,11877
14189,26115,65+,16103,13794,29897
14190,26117,15-19,1951,2143,4094
14191,26117,20-24,1656,2073,3729
14192,26117,25-29,1878,2404,4282
14193,26117,30-34,1973,2267,4240
14194,26117,35-39,1889,2337,4226
14195,26117,40-44,1926,2256,4182
14196,26117,45-49,1805,2215,4020
14197,26117,50-54,2069,2372,4441
14198,26117,55-59,2318,2485,4803
14199,26117,60-64,2353,2538,4891
14200,26117,65+,6525,5825,12350
14201,26119,15-19,175,214,389
14202,26119,20-24,161,178,339
14203,26119,25-29,172,184,356
14204,26119,30-34,170,195,365
14205,26119,35-39,188,187,375
14206,26119,40-44,222,209,431
14207,26119,45-49,200,223,423
14208,26119,50-54,272,305,577
14209,26119,55-59,393,372,765
14210,26119,60-64,474,529,1003
14211,26119,65+,1514,1597,3111
14212,26121,15-19,5247,5608,10855
14213,26121,20-24,4968,5261,10229
14214,26121,25-29,5601,5950,11551
14215,26121,30-34,5689,5937,11626
14216,26121,35-39,5513,5686,11199
14217,26121,40-44,5358,5495,10853
14218,26121,45-49,4828,5080,9908
14219,26121,50-54,5335,5484,10819
14220,26121,55-59,5984,5946,11930
14221,26121,60-64,6461,6166,12627
14222,26121,65+,17346,14410,31756
14223,26123,15-19,1546,1606,3152
14224,26123,20-24,1239,1358,2597
14225,26123,25-29,1294,1495,2789
14226,26123,30-34,1530,1579,3109
14227,26123,35-39,1398,1426,2824
14228,26123,40-44,1393,1458,2851
14229,26123,45-49,1272,1398,2670
14230,26123,50-54,1618,1595,3213
14231,26123,55-59,1917,1968,3885
14232,26123,60-64,1959,2083,4042
14233,26123,65+,5179,4987,10166
14234,26125,15-19,36872,38845,75717
14235,26125,20-24,35704,37201,72905
14236,26125,25-29,40898,44464,85362
14237,26125,30-34,41525,43975,85500
14238,26125,35-39,40562,42186,82748
14239,26125,40-44,39907,39822,79729
14240,26125,45-49,40362,39188,79550
14241,26125,50-54,45290,44364,89654
14242,26125,55-59,46347,45189,91536
14243,26125,60-64,46177,43282,89459
14244,26125,65+,125621,100951,226572
14245,26127,15-19,766,930,1696
14246,26127,20-24,688,755,1443
14247,26127,25-29,677,820,1497
14248,26127,30-34,683,739,1422
14249,26127,35-39,716,795,1511
14250,26127,40-44,788,745,1533
14251,26127,45-49,650,691,1341
14252,26127,50-54,795,834,1629
14253,26127,55-59,980,1053,2033
14254,26127,60-64,1103,1138,2241
14255,26127,65+,2934,2857,5791
14256,26129,15-19,511,578,1089
14257,26129,20-24,447,457,904
14258,26129,25-29,492,499,991
14259,26129,30-34,507,507,1014
14260,26129,35-39,545,566,1111
14261,26129,40-44,482,525,1007
14262,26129,45-49,507,527,1034
14263,26129,50-54,612,604,1216
14264,26129,55-59,833,828,1661
14265,26129,60-64,1041,1008,2049
14266,26129,65+,2850,2759,5609
14267,26131,15-19,127,125,252
14268,26131,20-24,91,107,198
14269,26131,25-29,97,92,189
14270,26131,30-34,83,97,180
14271,26131,35-39,95,116,211
14272,26131,40-44,123,135,258
14273,26131,45-49,136,143,279
14274,26131,50-54,188,178,366
14275,26131,55-59,272,262,534
14276,26131,60-64,326,335,661
14277,26131,65+,1043,1143,2186
14278,26133,15-19,706,819,1525
14279,26133,20-24,548,587,1135
14280,26133,25-29,628,657,1285
14281,26133,30-34,641,662,1303
14282,26133,35-39,635,613,1248
14283,26133,40-44,661,659,1320
14284,26133,45-49,597,619,1216
14285,26133,50-54,690,736,1426
14286,26133,55-59,815,892,1707
14287,26133,60-64,914,932,1846
14288,26133,65+,2582,2387,4969
14289,26135,15-19,177,239,416
14290,26135,20-24,156,175,331
14291,26135,25-29,186,170,356
14292,26135,30-34,199,175,374
14293,26135,35-39,182,218,400
14294,26135,40-44,186,173,359
14295,26135,45-49,183,193,376
14296,26135,50-54,220,224,444
14297,26135,55-59,306,305,611
14298,26135,60-64,470,452,922
14299,26135,65+,1154,1231,2385
14300,26137,15-19,733,740,1473
14301,26137,20-24,639,677,1316
14302,26137,25-29,677,693,1370
14303,26137,30-34,764,769,1533
14304,26137,35-39,692,725,1417
14305,26137,40-44,713,660,1373
14306,26137,45-49,666,675,1341
14307,26137,50-54,841,856,1697
14308,26137,55-59,943,952,1895
14309,26137,60-64,1008,1018,2026
14310,26137,65+,2843,2674,5517
14311,26139,15-19,12834,11905,24739
14312,26139,20-24,13225,13372,26597
14313,26139,25-29,8969,9468,18437
14314,26139,30-34,9106,9077,18183
14315,26139,35-39,9261,9473,18734
14316,26139,40-44,8916,9136,18052
14317,26139,45-49,7904,8116,16020
14318,26139,50-54,8465,8614,17079
14319,26139,55-59,9093,9092,18185
14320,26139,60-64,9031,8835,17866
14321,26139,65+,25546,22037,47583
14322,26141,15-19,298,305,603
14323,26141,20-24,274,269,543
14324,26141,25-29,261,278,539
14325,26141,30-34,275,248,523
14326,26141,35-39,271,296,567
14327,26141,40-44,315,331,646
14328,26141,45-49,305,319,624
14329,26141,50-54,356,371,727
14330,26141,55-59,540,491,1031
14331,26141,60-64,702,674,1376
14332,26141,65+,2163,2181,4344
14333,26143,15-19,470,518,988
14334,26143,20-24,400,433,833
14335,26143,25-29,496,505,1001
14336,26143,30-34,501,480,981
14337,26143,35-39,505,508,1013
14338,26143,40-44,496,505,1001
14339,26143,45-49,531,537,1068
14340,26143,50-54,730,736,1466
14341,26143,55-59,1014,931,1945
14342,26143,60-64,1260,1295,2555
14343,26143,65+,3922,4006,7928
14344,26145,15-19,6221,6501,12722
14345,26145,20-24,6022,6003,12025
14346,26145,25-29,6057,6217,12274
14347,26145,30-34,5979,5889,11868
14348,26145,35-39,5190,5309,10499
14349,26145,40-44,5359,5361,10720
14350,26145,45-49,5342,5035,10377
14351,26145,50-54,5936,5773,11709
14352,26145,55-59,6486,6333,12819
14353,26145,60-64,6954,6362,13316
14354,26145,65+,20985,16728,37713
14355,26147,15-19,4680,5099,9779
14356,26147,20-24,4247,4543,8790
14357,26147,25-29,4458,4917,9375
14358,26147,30-34,4438,4578,9016
14359,26147,35-39,4479,4515,8994
14360,26147,40-44,4617,4503,9120
14361,26147,45-49,4790,4765,9555
14362,26147,50-54,5785,5834,11619
14363,26147,55-59,6354,6555,12909
14364,26147,60-64,6353,6382,12735
14365,26147,65+,16944,14812,31756
14366,26149,15-19,1902,2062,3964
14367,26149,20-24,1637,1749,3386
14368,26149,25-29,1756,1852,3608
14369,26149,30-34,1742,1911,3653
14370,26149,35-39,1822,1848,3670
14371,26149,40-44,1759,1761,3520
14372,26149,45-49,1666,1685,3351
14373,26149,50-54,1659,1917,3576
14374,26149,55-59,2068,2087,4155
14375,26149,60-64,2173,2174,4347
14376,26149,65+,6084,5281,11365
14377,26151,15-19,1198,1255,2453
14378,26151,20-24,1006,1065,2071
14379,26151,25-29,1003,1089,2092
14380,26151,30-34,1008,1075,2083
14381,26151,35-39,1054,1109,2163
14382,26151,40-44,1084,1126,2210
14383,26151,45-49,1111,1109,2220
14384,26151,50-54,1307,1306,2613
14385,26151,55-59,1469,1602,3071
14386,26151,60-64,1695,1688,3383
14387,26151,65+,4792,4401,9193
14388,26153,15-19,168,225,393
14389,26153,20-24,174,160,334
14390,26153,25-29,172,193,365
14391,26153,30-34,148,176,324
14392,26153,35-39,180,183,363
14393,26153,40-44,194,192,386
14394,26153,45-49,216,201,417
14395,26153,50-54,255,276,531
14396,26153,55-59,333,322,655
14397,26153,60-64,447,400,847
14398,26153,65+,1150,1121,2271
14399,26155,15-19,2100,2188,4288
14400,26155,20-24,1864,1966,3830
14401,26155,25-29,2025,2163,4188
14402,26155,30-34,2022,2081,4103
14403,26155,35-39,1917,1963,3880
14404,26155,40-44,1966,1958,3924
14405,26155,45-49,1921,2007,3928
14406,26155,50-54,2307,2441,4748
14407,26155,55-59,2628,2610,5238
14408,26155,60-64,2602,2564,5166
14409,26155,65+,7146,6025,13171
14410,26157,15-19,1444,1736,3180
14411,26157,20-24,1326,1370,2696
14412,26157,25-29,1442,1599,3041
14413,26157,30-34,1416,1515,2931
14414,26157,35-39,1443,1547,2990
14415,26157,40-44,1497,1560,3057
14416,26157,45-49,1484,1561,3045
14417,26157,50-54,1820,1797,3617
14418,26157,55-59,2005,2112,4117
14419,26157,60-64,2109,2223,4332
14420,26157,65+,6028,5358,11386
14421,26159,15-19,2335,2374,4709
14422,26159,20-24,1983,2075,4058
14423,26159,25-29,2063,2198,4261
14424,26159,30-34,2129,2217,4346
14425,26159,35-39,2241,2285,4526
14426,26159,40-44,2251,2253,4504
14427,26159,45-49,2212,2076,4288
14428,26159,50-54,2422,2404,4826
14429,26159,55-59,2708,2674,5382
14430,26159,60-64,2962,2842,5804
14431,26159,65+,7615,6913,14528
14432,26161,15-19,16458,16401,32859
14433,26161,20-24,22795,23004,45799
14434,26161,25-29,13450,14379,27829
14435,26161,30-34,11609,12543,24152
14436,26161,35-39,10961,11493,22454
14437,26161,40-44,10593,10640,21233
14438,26161,45-49,10067,9871,19938
14439,26161,50-54,10847,10796,21643
14440,26161,55-59,10876,10669,21545
14441,26161,60-64,10610,10055,20665
14442,26161,65+,30486,25439,55925
14443,26163,15-19,54993,57161,112154
14444,26163,20-24,53948,53037,106985
14445,26163,25-29,64664,62488,127152
14446,26163,30-34,66228,62759,128987
14447,26163,35-39,55350,51869,107219
14448,26163,40-44,54689,49848,104537
14449,26163,45-49,54969,49781,104750
14450,26163,50-54,58333,56450,114783
14451,26163,55-59,59335,56974,116309
14452,26163,60-64,59956,55700,115656
14453,26163,65+,163264,124643,287907
14454,26165,15-19,1043,1050,2093
14455,26165,20-24,789,875,1664
14456,26165,25-29,961,1044,2005
14457,26165,30-34,968,983,1951
14458,26165,35-39,1032,1024,2056
14459,26165,40-44,970,979,1949
14460,26165,45-49,904,930,1834
14461,26165,50-54,1018,1115,2133
14462,26165,55-59,1188,1212,2400
14463,26165,60-64,1291,1311,2602
14464,26165,65+,3543,3249,6792
14465,27001,15-19,375,411,786
14466,27001,20-24,301,282,583
14467,27001,25-29,311,256,567
14468,27001,30-34,275,312,587
14469,27001,35-39,369,335,704
14470,27001,40-44,346,377,723
14471,27001,45-49,337,354,691
14472,27001,50-54,438,464,902
14473,27001,55-59,654,654,1308
14474,27001,60-64,816,888,1704
14475,27001,65+,2636,2670,5306
14476,27003,15-19,11512,12114,23626
14477,27003,20-24,9720,10355,20075
14478,27003,25-29,10998,11658,22656
14479,27003,30-34,12172,12560,24732
14480,27003,35-39,13101,13664,26765
14481,27003,40-44,11934,12777,24711
14482,27003,45-49,10932,11395,22327
14483,27003,50-54,12017,12388,24405
14484,27003,55-59,13108,13346,26454
14485,27003,60-64,12334,12643,24977
14486,27003,65+,29360,25338,54698
14487,27005,15-19,1131,1180,2311
14488,27005,20-24,871,908,1779
14489,27005,25-29,851,834,1685
14490,27005,30-34,931,926,1857
14491,27005,35-39,1016,1015,2031
14492,27005,40-44,1017,1075,2092
14493,27005,45-49,835,944,1779
14494,27005,50-54,966,994,1960
14495,27005,55-59,1180,1199,2379
14496,27005,60-64,1348,1394,2742
14497,27005,65+,3954,3768,7722
14498,27007,15-19,1761,1895,3656
14499,27007,20-24,2026,2148,4174
14500,27007,25-29,1400,1442,2842
14501,27007,30-34,1330,1402,2732
14502,27007,35-39,1401,1413,2814
14503,27007,40-44,1291,1300,2591
14504,27007,45-49,1063,1085,2148
14505,27007,50-54,1169,1103,2272
14506,27007,55-59,1346,1293,2639
14507,27007,60-64,1491,1413,2904
14508,27007,65+,4099,3674,7773
14509,27009,15-19,1336,1377,2713
14510,27009,20-24,1203,1193,2396
14511,27009,25-29,1416,1441,2857
14512,27009,30-34,1487,1535,3022
14513,27009,35-39,1505,1680,3185
14514,27009,40-44,1386,1483,2869
14515,27009,45-49,1116,1251,2367
14516,27009,50-54,1204,1250,2454
14517,27009,55-59,1279,1314,2593
14518,27009,60-64,1175,1267,2442
14519,27009,65+,3208,2630,5838
14520,27011,15-19,139,152,291
14521,27011,20-24,105,107,212
14522,27011,25-29,113,112,225
14523,27011,30-34,128,135,263
14524,27011,35-39,141,146,287
14525,27011,40-44,125,131,256
14526,27011,45-49,111,103,214
14527,27011,50-54,125,128,253
14528,27011,55-59,177,181,358
14529,27011,60-64,216,256,472
14530,27011,65+,731,624,1355
14531,27013,15-19,3147,2991,6138
14532,27013,20-24,5486,5443,10929
14533,27013,25-29,2201,2560,4761
14534,27013,30-34,1947,2147,4094
14535,27013,35-39,2024,2217,4241
14536,27013,40-44,1860,2063,3923
14537,27013,45-49,1593,1601,3194
14538,27013,50-54,1536,1658,3194
14539,27013,55-59,1723,1724,3447
14540,27013,60-64,1888,1777,3665
14541,27013,65+,5487,4713,10200
14542,27015,15-19,836,914,1750
14543,27015,20-24,845,878,1723
14544,27015,25-29,631,697,1328
14545,27015,30-34,661,672,1333
14546,27015,35-39,775,825,1600
14547,27015,40-44,721,743,1464
14548,27015,45-49,617,655,1272
14549,27015,50-54,691,689,1380
14550,27015,55-59,895,884,1779
14551,27015,60-64,989,974,1963
14552,27015,65+,3002,2560,5562
14553,27017,15-19,1076,1290,2366
14554,27017,20-24,777,1112,1889
14555,27017,25-29,900,1174,2074
14556,27017,30-34,981,1266,2247
14557,27017,35-39,1123,1365,2488
14558,27017,40-44,1063,1336,2399
14559,27017,45-49,1020,1228,2248
14560,27017,50-54,1065,1338,2403
14561,27017,55-59,1218,1321,2539
14562,27017,60-64,1287,1366,2653
14563,27017,65+,3448,3099,6547
14564,27019,15-19,3833,4057,7890
14565,27019,20-24,2944,2992,5936
14566,27019,25-29,2678,2658,5336
14567,27019,30-34,3176,3041,6217
14568,27019,35-39,4031,4087,8118
14569,27019,40-44,4000,4101,8101
14570,27019,45-49,3515,3592,7107
14571,27019,50-54,3832,3840,7672
14572,27019,55-59,3893,4025,7918
14573,27019,60-64,3438,3570,7008
14574,27019,65+,7825,6831,14656
14575,27021,15-19,806,901,1707
14576,27021,20-24,593,652,1245
14577,27021,25-29,673,691,1364
14578,27021,30-34,729,669,1398
14579,27021,35-39,786,849,1635
14580,27021,40-44,736,811,1547
14581,27021,45-49,683,745,1428
14582,27021,50-54,873,906,1779
14583,27021,55-59,1135,1162,2297
14584,27021,60-64,1418,1475,2893
14585,27021,65+,3978,4187,8165
14586,27023,15-19,355,396,751
14587,27023,20-24,281,326,607
14588,27023,25-29,333,345,678
14589,27023,30-34,346,367,713
14590,27023,35-39,356,399,755
14591,27023,40-44,332,378,710
14592,27023,45-49,283,299,582
14593,27023,50-54,330,315,645
14594,27023,55-59,424,410,834
14595,27023,60-64,438,442,880
14596,27023,65+,1374,1274,2648
14597,27025,15-19,1703,1837,3540
14598,27025,20-24,1375,1708,3083
14599,27025,25-29,1495,1773,3268
14600,27025,30-34,1672,1944,3616
14601,27025,35-39,1853,2101,3954
14602,27025,40-44,1734,2034,3768
14603,27025,45-49,1657,1790,3447
14604,27025,50-54,1900,2185,4085
14605,27025,55-59,2151,2340,4491
14606,27025,60-64,2085,2154,4239
14607,27025,65+,4788,4639,9427
14608,27027,15-19,2828,2589,5417
14609,27027,20-24,3476,2916,6392
14610,27027,25-29,2012,2041,4053
14611,27027,30-34,2222,2320,4542
14612,27027,35-39,2245,2360,4605
14613,27027,40-44,2136,2240,4376
14614,27027,45-49,1574,1787,3361
14615,27027,50-54,1593,1687,3280
14616,27027,55-59,1650,1633,3283
14617,27027,60-64,1725,1721,3446
14618,27027,65+,4812,4147,8959
14619,27029,15-19,269,292,561
14620,27029,20-24,192,216,408
14621,27029,25-29,201,225,426
14622,27029,30-34,227,228,455
14623,27029,35-39,233,242,475
14624,27029,40-44,247,277,524
14625,27029,45-49,220,238,458
14626,27029,50-54,225,246,471
14627,27029,55-59,280,295,575
14628,27029,60-64,338,319,657
14629,27029,65+,893,856,1749
14630,27031,15-19,98,114,212
14631,27031,20-24,99,126,225
14632,27031,25-29,155,138,293
14633,27031,30-34,169,132,301
14634,27031,35-39,150,160,310
14635,27031,40-44,147,158,305
14636,27031,45-49,129,148,277
14637,27031,50-54,182,178,360
14638,27031,55-59,208,190,398
14639,27031,60-64,291,278,569
14640,27031,65+,840,838,1678
14641,27033,15-19,359,396,755
14642,27033,20-24,248,318,566
14643,27033,25-29,309,291,600
14644,27033,30-34,271,330,601
14645,27033,35-39,294,349,643
14646,27033,40-44,306,338,644
14647,27033,45-49,286,259,545
14648,27033,50-54,321,321,642
14649,27033,55-59,362,365,727
14650,27033,60-64,359,414,773
14651,27033,65+,1385,1208,2593
14652,27035,15-19,1854,2035,3889
14653,27035,20-24,1540,1604,3144
14654,27035,25-29,1782,1767,3549
14655,27035,30-34,1763,1889,3652
14656,27035,35-39,2018,2042,4060
14657,27035,40-44,1919,2071,3990
14658,27035,45-49,1623,1719,3342
14659,27035,50-54,1917,1964,3881
14660,27035,55-59,2422,2492,4914
14661,27035,60-64,2881,2713,5594
14662,27035,65+,8138,7581,15719
14663,27037,15-19,13742,14747,28489
14664,27037,20-24,11803,12355,24158
14665,27037,25-29,13453,13752,27205
14666,27037,30-34,14568,14798,29366
14667,27037,35-39,16156,16228,32384
14668,27037,40-44,15117,15352,30469
14669,27037,45-49,13061,13201,26262
14670,27037,50-54,14322,14481,28803
14671,27037,55-59,15570,14902,30472
14672,27037,60-64,14799,14296,29095
14673,27037,65+,37268,30281,67549
14674,27039,15-19,721,750,1471
14675,27039,20-24,582,576,1158
14676,27039,25-29,632,601,1233
14677,27039,30-34,629,670,1299
14678,27039,35-39,713,719,1432
14679,27039,40-44,699,735,1434
14680,27039,45-49,649,693,1342
14681,27039,50-54,628,681,1309
14682,27039,55-59,664,686,1350
14683,27039,60-64,673,676,1349
14684,27039,65+,1698,1536,3234
14685,27041,15-19,1080,1200,2280
14686,27041,20-24,898,1010,1908
14687,27041,25-29,987,1075,2062
14688,27041,30-34,1049,1132,2181
14689,27041,35-39,1168,1281,2449
14690,27041,40-44,1087,1177,2264
14691,27041,45-49,972,989,1961
14692,27041,50-54,1100,1121,2221
14693,27041,55-59,1324,1332,2656
14694,27041,60-64,1587,1530,3117
14695,27041,65+,4779,4376,9155
14696,27043,15-19,420,446,866
14697,27043,20-24,337,350,687
14698,27043,25-29,325,345,670
14699,27043,30-34,329,363,692
14700,27043,35-39,391,424,815
14701,27043,40-44,423,437,860
14702,27043,45-49,312,357,669
14703,27043,50-54,372,396,768
14704,27043,55-59,477,491,968
14705,27043,60-64,556,557,1113
14706,27043,65+,1751,1546,3297
14707,27045,15-19,638,691,1329
14708,27045,20-24,497,499,996
14709,27045,25-29,523,526,1049
14710,27045,30-34,518,560,1078
14711,27045,35-39,644,631,1275
14712,27045,40-44,621,690,1311
14713,27045,45-49,521,588,1109
14714,27045,50-54,541,640,1181
14715,27045,55-59,723,709,1432
14716,27045,60-64,781,795,1576
14717,27045,65+,2441,2155,4596
14718,27047,15-19,913,989,1902
14719,27047,20-24,747,767,1514
14720,27047,25-29,847,816,1663
14721,27047,30-34,846,847,1693
14722,27047,35-39,902,946,1848
14723,27047,40-44,801,910,1711
14724,27047,45-49,779,830,1609
14725,27047,50-54,821,875,1696
14726,27047,55-59,1073,1088,2161
14727,27047,60-64,1181,1260,2441
14728,27047,65+,3770,3240,7010
14729,27049,15-19,1346,1533,2879
14730,27049,20-24,1162,1218,2380
14731,27049,25-29,1303,1360,2663
14732,27049,30-34,1310,1406,2716
14733,27049,35-39,1535,1542,3077
14734,27049,40-44,1442,1463,2905
14735,27049,45-49,1308,1349,2657
14736,27049,50-54,1422,1465,2887
14737,27049,55-59,1791,1779,3570
14738,27049,60-64,1847,1870,3717
14739,27049,65+,5270,4570,9840
14740,27051,15-19,185,184,369
14741,27051,20-24,105,141,246
14742,27051,25-29,171,143,314
14743,27051,30-34,166,203,369
14744,27051,35-39,192,180,372
14745,27051,40-44,169,197,366
14746,27051,45-49,147,171,318
14747,27051,50-54,148,151,299
14748,27051,55-59,207,206,413
14749,27051,60-64,232,237,469
14750,27051,65+,745,711,1456
14751,27053,15-19,37133,38089,75222
14752,27053,20-24,38404,37184,75588
14753,27053,25-29,50032,51388,101420
14754,27053,30-34,49966,52961,102927
14755,27053,35-39,48588,50543,99131
14756,27053,40-44,42487,43819,86306
14757,27053,45-49,35262,36501,71763
14758,27053,50-54,37635,38573,76208
14759,27053,55-59,39459,39572,79031
14760,27053,60-64,40112,38808,78920
14761,27053,65+,105184,85741,190925
14762,27055,15-19,539,587,1126
14763,27055,20-24,405,451,856
14764,27055,25-29,421,451,872
14765,27055,30-34,477,485,962
14766,27055,35-39,531,569,1100
14767,27055,40-44,578,614,1192
14768,27055,45-49,482,480,962
14769,27055,50-54,568,565,1133
14770,27055,55-59,687,635,1322
14771,27055,60-64,811,812,1623
14772,27055,65+,2222,2056,4278
14773,27057,15-19,591,605,1196
14774,27057,20-24,398,474,872
14775,27057,25-29,447,490,937
14776,27057,30-34,495,509,1004
14777,27057,35-39,573,644,1217
14778,27057,40-44,578,607,1185
14779,27057,45-49,564,542,1106
14780,27057,50-54,565,597,1162
14781,27057,55-59,842,833,1675
14782,27057,60-64,950,982,1932
14783,27057,65+,2766,2848,5614
14784,27059,15-19,1240,1353,2593
14785,27059,20-24,1025,1104,2129
14786,27059,25-29,1203,1245,2448
14787,27059,30-34,1400,1481,2881
14788,27059,35-39,1431,1480,2911
14789,27059,40-44,1261,1381,2642
14790,27059,45-49,1143,1222,2365
14791,27059,50-54,1325,1364,2689
14792,27059,55-59,1512,1651,3163
14793,27059,60-64,1454,1568,3022
14794,27059,65+,3767,3269,7036
14795,27061,15-19,1303,1400,2703
14796,27061,20-24,989,1119,2108
14797,27061,25-29,1032,1054,2086
14798,27061,30-34,1064,1163,2227
14799,27061,35-39,1265,1253,2518
14800,27061,40-44,1253,1379,2632
14801,27061,45-49,1169,1219,2388
14802,27061,50-54,1330,1346,2676
14803,27061,55-59,1600,1609,3209
14804,27061,60-64,1888,1904,3792
14805,27061,65+,5728,5519,11247
14806,27063,15-19,270,331,601
14807,27063,20-24,218,268,486
14808,27063,25-29,221,290,511
14809,27063,30-34,243,280,523
14810,27063,35-39,282,306,588
14811,27063,40-44,279,338,617
14812,27063,45-49,264,266,530
14813,27063,50-54,272,308,580
14814,27063,55-59,310,359,669
14815,27063,60-64,380,460,840
14816,27063,65+,1186,1098,2284
14817,27065,15-19,477,536,1013
14818,27065,20-24,358,424,782
14819,27065,25-29,387,433,820
14820,27065,30-34,392,437,829
14821,27065,35-39,463,498,961
14822,27065,40-44,480,484,964
14823,27065,45-49,491,451,942
14824,27065,50-54,498,550,1048
14825,27065,55-59,569,579,1148
14826,27065,60-64,656,722,1378
14827,27065,65+,1758,1703,3461
14828,27067,15-19,1363,1538,2901
14829,27067,20-24,1156,1292,2448
14830,27067,25-29,1282,1394,2676
14831,27067,30-34,1250,1329,2579
14832,27067,35-39,1257,1377,2634
14833,27067,40-44,1202,1340,2542
14834,27067,45-49,1114,1140,2254
14835,27067,50-54,1175,1167,2342
14836,27067,55-59,1386,1415,2801
14837,27067,60-64,1595,1583,3178
14838,27067,65+,4517,4064,8581
14839,27069,15-19,120,117,237
14840,27069,20-24,107,114,221
14841,27069,25-29,84,103,187
14842,27069,30-34,99,98,197
14843,27069,35-39,95,98,193
14844,27069,40-44,102,106,208
14845,27069,45-49,110,93,203
14846,27069,50-54,132,137,269
14847,27069,55-59,139,150,289
14848,27069,60-64,162,184,346
14849,27069,65+,537,488,1025
14850,27071,15-19,331,341,672
14851,27071,20-24,264,269,533
14852,27071,25-29,271,281,552
14853,27071,30-34,278,299,577
14854,27071,35-39,289,307,596
14855,27071,40-44,299,324,623
14856,27071,45-49,312,290,602
14857,27071,50-54,362,391,753
14858,27071,55-59,461,490,951
14859,27071,60-64,530,553,1083
14860,27071,65+,1657,1649,3306
14861,27073,15-19,192,195,387
14862,27073,20-24,140,154,294
14863,27073,25-29,154,160,314
14864,27073,30-34,123,136,259
14865,27073,35-39,174,187,361
14866,27073,40-44,180,169,349
14867,27073,45-49,153,174,327
14868,27073,50-54,157,182,339
14869,27073,55-59,219,231,450
14870,27073,60-64,276,299,575
14871,27073,65+,951,898,1849
14872,27075,15-19,245,300,545
14873,27075,20-24,227,228,455
14874,27075,25-29,238,234,472
14875,27075,30-34,262,265,527
14876,27075,35-39,291,322,613
14877,27075,40-44,319,349,668
14878,27075,45-49,274,321,595
14879,27075,50-54,307,290,597
14880,27075,55-59,367,396,763
14881,27075,60-64,500,524,1024
14882,27075,65+,1482,1482,2964
14883,27077,15-19,99,115,214
14884,27077,20-24,71,68,139
14885,27077,25-29,81,110,191
14886,27077,30-34,79,87,166
14887,27077,35-39,100,106,206
14888,27077,40-44,104,116,220
14889,27077,45-49,88,101,189
14890,27077,50-54,111,108,219
14891,27077,55-59,124,177,301
14892,27077,60-64,172,201,373
14893,27077,65+,499,503,1002
14894,27079,15-19,931,982,1913
14895,27079,20-24,747,780,1527
14896,27079,25-29,777,803,1580
14897,27079,30-34,775,805,1580
14898,27079,35-39,877,932,1809
14899,27079,40-44,904,971,1875
14900,27079,45-49,792,852,1644
14901,27079,50-54,915,1055,1970
14902,27079,55-59,1032,1127,2159
14903,27079,60-64,992,1095,2087
14904,27079,65+,2722,2508,5230
14905,27081,15-19,154,175,329
14906,27081,20-24,125,121,246
14907,27081,25-29,133,122,255
14908,27081,30-34,124,150,274
14909,27081,35-39,145,151,296
14910,27081,40-44,155,167,322
14911,27081,45-49,129,146,275
14912,27081,50-54,147,168,315
14913,27081,55-59,174,195,369
14914,27081,60-64,204,228,432
14915,27081,65+,733,646,1379
14916,27083,15-19,933,927,1860
14917,27083,20-24,788,782,1570
14918,27083,25-29,703,742,1445
14919,27083,30-34,781,758,1539
14920,27083,35-39,813,798,1611
14921,27083,40-44,767,828,1595
14922,27083,45-49,647,700,1347
14923,27083,50-54,640,677,1317
14924,27083,55-59,744,749,1493
14925,27083,60-64,828,791,1619
14926,27083,65+,2316,1964,4280
14927,27085,15-19,1172,1261,2433
14928,27085,20-24,992,1031,2023
14929,27085,25-29,1016,1127,2143
14930,27085,30-34,1062,1113,2175
14931,27085,35-39,1110,1181,2291
14932,27085,40-44,1079,1203,2282
14933,27085,45-49,1056,1104,2160
14934,27085,50-54,1130,1249,2379
14935,27085,55-59,1294,1309,2603
14936,27085,60-64,1280,1311,2591
14937,27085,65+,3809,3223,7032
14938,27087,15-19,173,218,391
14939,27087,20-24,151,155,306
14940,27087,25-29,136,128,264
14941,27087,30-34,144,130,274
14942,27087,35-39,147,142,289
14943,27087,40-44,147,139,286
14944,27087,45-49,121,138,259
14945,27087,50-54,130,134,264
14946,27087,55-59,156,154,310
14947,27087,60-64,172,185,357
14948,27087,65+,493,450,943
14949,27089,15-19,254,275,529
14950,27089,20-24,190,212,402
14951,27089,25-29,235,246,481
14952,27089,30-34,241,229,470
14953,27089,35-39,238,290,528
14954,27089,40-44,250,281,531
14955,27089,45-49,220,242,462
14956,27089,50-54,244,257,501
14957,27089,55-59,302,332,634
14958,27089,60-64,311,354,665
14959,27089,65+,1055,977,2032
14960,27091,15-19,602,604,1206
14961,27091,20-24,481,490,971
14962,27091,25-29,504,503,1007
14963,27091,30-34,449,504,953
14964,27091,35-39,578,606,1184
14965,27091,40-44,482,567,1049
14966,27091,45-49,495,501,996
14967,27091,50-54,537,547,1084
14968,27091,55-59,660,671,1331
14969,27091,60-64,780,799,1579
14970,27091,65+,2573,2290,4863
14971,27093,15-19,763,824,1587
14972,27093,20-24,543,629,1172
14973,27093,25-29,574,644,1218
14974,27093,30-34,575,609,1184
14975,27093,35-39,608,703,1311
14976,27093,40-44,708,681,1389
14977,27093,45-49,621,651,1272
14978,27093,50-54,659,729,1388
14979,27093,55-59,786,844,1630
14980,27093,60-64,844,931,1775
14981,27093,65+,2480,2395,4875
14982,27095,15-19,748,897,1645
14983,27095,20-24,628,728,1356
14984,27095,25-29,732,771,1503
14985,27095,30-34,824,852,1676
14986,27095,35-39,824,854,1678
14987,27095,40-44,814,888,1702
14988,27095,45-49,725,783,1508
14989,27095,50-54,854,896,1750
14990,27095,55-59,970,1024,1994
14991,27095,60-64,949,1035,1984
14992,27095,65+,2607,2282,4889
14993,27097,15-19,990,1107,2097
14994,27097,20-24,778,912,1690
14995,27097,25-29,883,873,1756
14996,27097,30-34,853,941,1794
14997,27097,35-39,1019,1087,2106
14998,27097,40-44,1053,1122,2175
14999,27097,45-49,830,921,1751
15000,27097,50-54,996,1079,2075
15001,27097,55-59,1201,1275,2476
15002,27097,60-64,1325,1307,2632
15003,27097,65+,3620,3392,7012
15004,27099,15-19,1229,1469,2698
15005,27099,20-24,1097,1232,2329
15006,27099,25-29,1087,1178,2265
15007,27099,30-34,1177,1282,2459
15008,27099,35-39,1221,1315,2536
15009,27099,40-44,1177,1277,2454
15010,27099,45-49,1081,1132,2213
15011,27099,50-54,1092,1180,2272
15012,27099,55-59,1233,1295,2528
15013,27099,60-64,1273,1313,2586
15014,27099,65+,3970,3378,7348
15015,27101,15-19,240,231,471
15016,27101,20-24,194,192,386
15017,27101,25-29,177,179,356
15018,27101,30-34,162,195,357
15019,27101,35-39,219,230,449
15020,27101,40-44,219,235,454
15021,27101,45-49,192,195,387
15022,27101,50-54,226,208,434
15023,27101,55-59,267,292,559
15024,27101,60-64,322,336,658
15025,27101,65+,1117,1060,2177
15026,27103,15-19,1535,1372,2907
15027,27103,20-24,1427,1428,2855
15028,27103,25-29,875,1045,1920
15029,27103,30-34,1021,1101,2122
15030,27103,35-39,1218,1218,2436
15031,27103,40-44,1115,1221,2336
15032,27103,45-49,876,970,1846
15033,27103,50-54,850,1006,1856
15034,27103,55-59,903,1084,1987
15035,27103,60-64,1069,1050,2119
15036,27103,65+,3047,2719,5766
15037,27105,15-19,739,785,1524
15038,27105,20-24,576,683,1259
15039,27105,25-29,568,684,1252
15040,27105,30-34,583,680,1263
15041,27105,35-39,600,751,1351
15042,27105,40-44,598,673,1271
15043,27105,45-49,533,628,1161
15044,27105,50-54,531,720,1251
15045,27105,55-59,627,733,1360
15046,27105,60-64,641,698,1339
15047,27105,65+,1934,1787,3721
15048,27107,15-19,207,215,422
15049,27107,20-24,149,173,322
15050,27107,25-29,132,170,302
15051,27107,30-34,156,167,323
15052,27107,35-39,158,173,331
15053,27107,40-44,197,178,375
15054,27107,45-49,186,200,386
15055,27107,50-54,192,187,379
15056,27107,55-59,224,252,476
15057,27107,60-64,237,235,472
15058,27107,65+,701,669,1370
15059,27109,15-19,5052,5307,10359
15060,27109,20-24,4794,4459,9253
15061,27109,25-29,6214,5504,11718
15062,27109,30-34,5862,5687,11549
15063,27109,35-39,5951,6045,11996
15064,27109,40-44,5324,5447,10771
15065,27109,45-49,4411,4529,8940
15066,27109,50-54,4555,4616,9171
15067,27109,55-59,5086,4907,9993
15068,27109,60-64,5436,5077,10513
15069,27109,65+,14505,11795,26300
15070,27111,15-19,1654,1767,3421
15071,27111,20-24,1341,1456,2797
15072,27111,25-29,1412,1447,2859
15073,27111,30-34,1349,1508,2857
15074,27111,35-39,1650,1671,3321
15075,27111,40-44,1589,1776,3365
15076,27111,45-49,1389,1411,2800
15077,27111,50-54,1679,1724,3403
15078,27111,55-59,2134,2143,4277
15079,27111,60-64,2556,2613,5169
15080,27111,65+,7677,7206,14883
15081,27113,15-19,402,407,809
15082,27113,20-24,368,381,749
15083,27113,25-29,378,449,827
15084,27113,30-34,409,489,898
15085,27113,35-39,432,473,905
15086,27113,40-44,394,427,821
15087,27113,45-49,404,417,821
15088,27113,50-54,391,413,804
15089,27113,55-59,420,453,873
15090,27113,60-64,518,491,1009
15091,27113,65+,1467,1229,2696
15092,27115,15-19,742,901,1643
15093,27115,20-24,570,761,1331
15094,27115,25-29,604,901,1505
15095,27115,30-34,669,1004,1673
15096,27115,35-39,808,1069,1877
15097,27115,40-44,786,1092,1878
15098,27115,45-49,737,914,1651
15099,27115,50-54,875,1028,1903
15100,27115,55-59,1073,1246,2319
15101,27115,60-64,1214,1319,2533
15102,27115,65+,3234,3213,6447
15103,27117,15-19,294,310,604
15104,27117,20-24,235,223,458
15105,27117,25-29,250,243,493
15106,27117,30-34,225,218,443
15107,27117,35-39,235,294,529
15108,27117,40-44,252,251,503
15109,27117,45-49,231,227,458
15110,27117,50-54,261,269,530
15111,27117,55-59,307,314,621
15112,27117,60-64,312,326,638
15113,27117,65+,1091,877,1968
15114,27119,15-19,1049,1096,2145
15115,27119,20-24,859,882,1741
15116,27119,25-29,759,850,1609
15117,27119,30-34,905,943,1848
15118,27119,35-39,974,1043,2017
15119,27119,40-44,855,973,1828
15120,27119,45-49,742,836,1578
15121,27119,50-54,828,871,1699
15122,27119,55-59,979,1072,2051
15123,27119,60-64,1095,1048,2143
15124,27119,65+,3089,2697,5786
15125,27121,15-19,276,325,601
15126,27121,20-24,231,256,487
15127,27121,25-29,278,271,549
15128,27121,30-34,315,312,627
15129,27121,35-39,334,401,735
15130,27121,40-44,299,333,632
15131,27121,45-49,244,294,538
15132,27121,50-54,299,319,618
15133,27121,55-59,367,402,769
15134,27121,60-64,492,464,956
15135,27121,65+,1427,1388,2815
15136,27123,15-19,17776,17833,35609
15137,27123,20-24,18676,17337,36013
15138,27123,25-29,21645,21477,43122
15139,27123,30-34,21759,22271,44030
15140,27123,35-39,20128,19914,40042
15141,27123,40-44,16500,16740,33240
15142,27123,45-49,14061,14320,28381
15143,27123,50-54,14935,14919,29854
15144,27123,55-59,15886,15691,31577
15145,27123,60-64,16937,15565,32502
15146,27123,65+,46743,36380,83123
15147,27125,15-19,126,111,237
15148,27125,20-24,87,93,180
15149,27125,25-29,87,85,172
15150,27125,30-34,84,108,192
15151,27125,35-39,108,122,230
15152,27125,40-44,142,129,271
15153,27125,45-49,103,106,209
15154,27125,50-54,103,118,221
15155,27125,55-59,126,125,251
15156,27125,60-64,139,160,299
15157,27125,65+,434,445,879
15158,27127,15-19,496,553,1049
15159,27127,20-24,374,416,790
15160,27127,25-29,415,408,823
15161,27127,30-34,408,396,804
15162,27127,35-39,441,491,932
15163,27127,40-44,392,429,821
15164,27127,45-49,367,360,727
15165,27127,50-54,402,469,871
15166,27127,55-59,479,507,986
15167,27127,60-64,520,586,1106
15168,27127,65+,1765,1516,3281
15169,27129,15-19,443,467,910
15170,27129,20-24,355,397,752
15171,27129,25-29,361,409,770
15172,27129,30-34,362,393,755
15173,27129,35-39,394,454,848
15174,27129,40-44,425,415,840
15175,27129,45-49,351,413,764
15176,27129,50-54,406,448,854
15177,27129,55-59,516,492,1008
15178,27129,60-64,544,641,1185
15179,27129,65+,1588,1524,3112
15180,27131,15-19,2979,2813,5792
15181,27131,20-24,3092,3372,6464
15182,27131,25-29,1628,2063,3691
15183,27131,30-34,1775,2206,3981
15184,27131,35-39,1819,2359,4178
15185,27131,40-44,1862,2216,4078
15186,27131,45-49,1673,2010,3683
15187,27131,50-54,1928,2165,4093
15188,27131,55-59,2036,2236,4272
15189,27131,60-64,2143,2183,4326
15190,27131,65+,5780,5130,10910
15191,27133,15-19,343,385,728
15192,27133,20-24,247,264,511
15193,27133,25-29,235,279,514
15194,27133,30-34,250,256,506
15195,27133,35-39,272,287,559
15196,27133,40-44,293,300,593
15197,27133,45-49,279,300,579
15198,27133,50-54,269,269,538
15199,27133,55-59,321,306,627
15200,27133,60-64,334,349,683
15201,27133,65+,1049,902,1951
15202,27135,15-19,484,526,1010
15203,27135,20-24,370,422,792
15204,27135,25-29,370,426,796
15205,27135,30-34,368,415,783
15206,27135,35-39,418,443,861
15207,27135,40-44,395,492,887
15208,27135,45-49,426,455,881
15209,27135,50-54,469,550,1019
15210,27135,55-59,536,657,1193
15211,27135,60-64,582,623,1205
15212,27135,65+,1480,1391,2871
15213,27137,15-19,6932,7052,13984
15214,27137,20-24,8734,8841,17575
15215,27137,25-29,5656,5922,11578
15216,27137,30-34,5344,5908,11252
15217,27137,35-39,5722,6246,11968
15218,27137,40-44,5626,6136,11762
15219,27137,45-49,4864,5263,10127
15220,27137,50-54,5394,5710,11104
15221,27137,55-59,6572,6497,13069
15222,27137,60-64,7580,7434,15014
15223,27137,65+,21674,19390,41064
15224,27139,15-19,5574,5744,11318
15225,27139,20-24,4274,4452,8726
15226,27139,25-29,4255,4242,8497
15227,27139,30-34,4841,4751,9592
15228,27139,35-39,5621,5619,11240
15229,27139,40-44,5631,5697,11328
15230,27139,45-49,5182,5224,10406
15231,27139,50-54,5532,5833,11365
15232,27139,55-59,5254,5541,10795
15233,27139,60-64,4421,4648,9069
15234,27139,65+,9709,8520,18229
15235,27141,15-19,3463,3639,7102
15236,27141,20-24,2691,3168,5859
15237,27141,25-29,2745,3158,5903
15238,27141,30-34,3309,3544,6853
15239,27141,35-39,3476,3878,7354
15240,27141,40-44,3330,3696,7026
15241,27141,45-49,3065,3305,6370
15242,27141,50-54,3341,3546,6887
15243,27141,55-59,3223,3572,6795
15244,27141,60-64,2802,3008,5810
15245,27141,65+,6370,5698,12068
15246,27143,15-19,469,497,966
15247,27143,20-24,379,414,793
15248,27143,25-29,382,420,802
15249,27143,30-34,407,449,856
15250,27143,35-39,452,495,947
15251,27143,40-44,420,489,909
15252,27143,45-49,389,434,823
15253,27143,50-54,446,478,924
15254,27143,55-59,577,560,1137
15255,27143,60-64,546,654,1200
15256,27143,65+,1490,1324,2814
15257,27145,15-19,6444,6286,12730
15258,27145,20-24,7964,8346,16310
15259,27145,25-29,4635,5225,9860
15260,27145,30-34,4357,4769,9126
15261,27145,35-39,4544,5028,9572
15262,27145,40-44,4391,4726,9117
15263,27145,45-49,3777,3990,7767
15264,27145,50-54,4356,4479,8835
15265,27145,55-59,4835,5034,9869
15266,27145,60-64,4795,4815,9610
15267,27145,65+,13257,11867,25124
15268,27147,15-19,1241,1339,2580
15269,27147,20-24,932,1019,1951
15270,27147,25-29,977,1079,2056
15271,27147,30-34,1045,1122,2167
15272,27147,35-39,1222,1282,2504
15273,27147,40-44,1112,1140,2252
15274,27147,45-49,1034,1080,2114
15275,27147,50-54,1130,1225,2355
15276,27147,55-59,1241,1286,2527
15277,27147,60-64,1239,1230,2469
15278,27147,65+,3702,3208,6910
15279,27149,15-19,560,478,1038
15280,27149,20-24,609,589,1198
15281,27149,25-29,231,321,552
15282,27149,30-34,249,304,553
15283,27149,35-39,266,299,565
15284,27149,40-44,231,296,527
15285,27149,45-49,190,227,417
15286,27149,50-54,202,201,403
15287,27149,55-59,228,237,465
15288,27149,60-64,256,255,511
15289,27149,65+,920,771,1691
15290,27151,15-19,286,322,608
15291,27151,20-24,211,236,447
15292,27151,25-29,255,248,503
15293,27151,30-34,232,300,532
15294,27151,35-39,259,303,562
15295,27151,40-44,286,322,608
15296,27151,45-49,228,253,481
15297,27151,50-54,263,290,553
15298,27151,55-59,317,354,671
15299,27151,60-64,337,384,721
15300,27151,65+,1157,1037,2194
15301,27153,15-19,642,824,1466
15302,27153,20-24,585,634,1219
15303,27153,25-29,580,656,1236
15304,27153,30-34,574,647,1221
15305,27153,35-39,667,694,1361
15306,27153,40-44,629,732,1361
15307,27153,45-49,570,639,1209
15308,27153,50-54,679,735,1414
15309,27153,55-59,930,938,1868
15310,27153,60-64,965,1080,2045
15311,27153,65+,2848,2883,5731
15312,27155,15-19,94,89,183
15313,27155,20-24,73,84,157
15314,27155,25-29,75,82,157
15315,27155,30-34,66,81,147
15316,27155,35-39,80,96,176
15317,27155,40-44,77,100,177
15318,27155,45-49,81,89,170
15319,27155,50-54,75,91,166
15320,27155,55-59,131,125,256
15321,27155,60-64,132,129,261
15322,27155,65+,456,407,863
15323,27157,15-19,617,638,1255
15324,27157,20-24,481,474,955
15325,27157,25-29,552,512,1064
15326,27157,30-34,559,555,1114
15327,27157,35-39,645,644,1289
15328,27157,40-44,554,624,1178
15329,27157,45-49,549,602,1151
15330,27157,50-54,684,683,1367
15331,27157,55-59,826,846,1672
15332,27157,60-64,838,866,1704
15333,27157,65+,2500,2366,4866
15334,27159,15-19,469,475,944
15335,27159,20-24,342,351,693
15336,27159,25-29,369,371,740
15337,27159,30-34,370,387,757
15338,27159,35-39,382,395,777
15339,27159,40-44,405,402,807
15340,27159,45-49,372,384,756
15341,27159,50-54,354,416,770
15342,27159,55-59,435,442,877
15343,27159,60-64,483,488,971
15344,27159,65+,1624,1353,2977
15345,27161,15-19,631,630,1261
15346,27161,20-24,576,523,1099
15347,27161,25-29,597,507,1104
15348,27161,30-34,631,510,1141
15349,27161,35-39,705,607,1312
15350,27161,40-44,679,602,1281
15351,27161,45-49,568,493,1061
15352,27161,50-54,567,563,1130
15353,27161,55-59,608,633,1241
15354,27161,60-64,642,649,1291
15355,27161,65+,1854,1704,3558
15356,27163,15-19,8891,9430,18321
15357,27163,20-24,7185,7691,14876
15358,27163,25-29,7193,7657,14850
15359,27163,30-34,8001,8194,16195
15360,27163,35-39,9634,9591,19225
15361,27163,40-44,9254,9469,18723
15362,27163,45-49,8221,8541,16762
15363,27163,50-54,9341,9165,18506
15364,27163,55-59,9774,9475,19249
15365,27163,60-64,9367,9172,18539
15366,27163,65+,23263,20034,43297
15367,27165,15-19,355,337,692
15368,27165,20-24,292,323,615
15369,27165,25-29,330,329,659
15370,27165,30-34,227,285,512
15371,27165,35-39,319,295,614
15372,27165,40-44,296,345,641
15373,27165,45-49,295,311,606
15374,27165,50-54,297,303,600
15375,27165,55-59,343,367,710
15376,27165,60-64,430,407,837
15377,27165,65+,1193,1114,2307
15378,27167,15-19,156,214,370
15379,27167,20-24,149,197,346
15380,27167,25-29,151,187,338
15381,27167,30-34,165,164,329
15382,27167,35-39,179,190,369
15383,27167,40-44,193,222,415
15384,27167,45-49,170,189,359
15385,27167,50-54,184,217,401
15386,27167,55-59,225,249,474
15387,27167,60-64,238,281,519
15388,27167,65+,656,625,1281
15389,27169,15-19,2444,2028,4472
15390,27169,20-24,3487,3433,6920
15391,27169,25-29,1316,1529,2845
15392,27169,30-34,1245,1337,2582
15393,27169,35-39,1350,1355,2705
15394,27169,40-44,1252,1399,2651
15395,27169,45-49,1167,1257,2424
15396,27169,50-54,1262,1336,2598
15397,27169,55-59,1436,1465,2901
15398,27169,60-64,1655,1624,3279
15399,27169,65+,4749,4291,9040
15400,27171,15-19,5129,5579,10708
15401,27171,20-24,3589,3798,7387
15402,27171,25-29,3842,4046,7888
15403,27171,30-34,4436,4446,8882
15404,27171,35-39,5183,5364,10547
15405,27171,40-44,5149,5398,10547
15406,27171,45-49,4479,4882,9361
15407,27171,50-54,4600,5001,9601
15408,27171,55-59,4676,4867,9543
15409,27171,60-64,4180,4452,8632
15410,27171,65+,10198,9137,19335
15411,27173,15-19,276,329,605
15412,27173,20-24,241,268,509
15413,27173,25-29,237,258,495
15414,27173,30-34,224,250,474
15415,27173,35-39,281,325,606
15416,27173,40-44,219,264,483
15417,27173,45-49,242,241,483
15418,27173,50-54,264,284,548
15419,27173,55-59,316,307,623
15420,27173,60-64,360,372,732
15421,27173,65+,1091,1000,2091
15422,28001,15-19,788,811,1599
15423,28001,20-24,706,823,1529
15424,28001,25-29,738,1004,1742
15425,28001,30-34,742,1065,1807
15426,28001,35-39,748,1202,1950
15427,28001,40-44,744,1149,1893
15428,28001,45-49,728,988,1716
15429,28001,50-54,768,902,1670
15430,28001,55-59,959,1078,2037
15431,28001,60-64,1196,1098,2294
15432,28001,65+,3309,2463,5772
15433,28003,15-19,1060,1140,2200
15434,28003,20-24,952,1075,2027
15435,28003,25-29,1070,1026,2096
15436,28003,30-34,1066,1087,2153
15437,28003,35-39,1026,1047,2073
15438,28003,40-44,1057,1075,2132
15439,28003,45-49,1081,1054,2135
15440,28003,50-54,1138,1118,2256
15441,28003,55-59,1131,1197,2328
15442,28003,60-64,1201,1028,2229
15443,28003,65+,3686,2776,6462
15444,28005,15-19,340,336,676
15445,28005,20-24,276,306,582
15446,28005,25-29,315,335,650
15447,28005,30-34,308,325,633
15448,28005,35-39,342,313,655
15449,28005,40-44,309,331,640
15450,28005,45-49,336,325,661
15451,28005,50-54,377,350,727
15452,28005,55-59,530,444,974
15453,28005,60-64,575,538,1113
15454,28005,65+,1702,1493,3195
15455,28007,15-19,625,562,1187
15456,28007,20-24,476,535,1011
15457,28007,25-29,499,534,1033
15458,28007,30-34,561,443,1004
15459,28007,35-39,534,479,1013
15460,28007,40-44,538,492,1030
15461,28007,45-49,493,451,944
15462,28007,50-54,586,523,1109
15463,28007,55-59,600,546,1146
15464,28007,60-64,580,564,1144
15465,28007,65+,1919,1517,3436
15466,28009,15-19,226,229,455
15467,28009,20-24,223,229,452
15468,28009,25-29,233,242,475
15469,28009,30-34,229,213,442
15470,28009,35-39,213,204,417
15471,28009,40-44,234,206,440
15472,28009,45-49,221,253,474
15473,28009,50-54,281,242,523
15474,28009,55-59,266,305,571
15475,28009,60-64,289,294,583
15476,28009,65+,782,676,1458
15477,28011,15-19,1066,983,2049
15478,28011,20-24,1120,1051,2171
15479,28011,25-29,935,912,1847
15480,28011,30-34,1042,991,2033
15481,28011,35-39,988,900,1888
15482,28011,40-44,899,808,1707
15483,28011,45-49,893,733,1626
15484,28011,50-54,965,811,1776
15485,28011,55-59,1012,841,1853
15486,28011,60-64,1039,832,1871
15487,28011,65+,3044,2127,5171
15488,28013,15-19,406,476,882
15489,28013,20-24,357,374,731
15490,28013,25-29,362,345,707
15491,28013,30-34,354,347,701
15492,28013,35-39,338,369,707
15493,28013,40-44,379,362,741
15494,28013,45-49,410,396,806
15495,28013,50-54,487,448,935
15496,28013,55-59,477,417,894
15497,28013,60-64,474,418,892
15498,28013,65+,1470,1161,2631
15499,28015,15-19,272,262,534
15500,28015,20-24,225,295,520
15501,28015,25-29,222,286,508
15502,28015,30-34,229,311,540
15503,28015,35-39,243,263,506
15504,28015,40-44,291,328,619
15505,28015,45-49,291,295,586
15506,28015,50-54,317,337,654
15507,28015,55-59,366,346,712
15508,28015,60-64,384,389,773
15509,28015,65+,1281,1213,2494
15510,28017,15-19,534,541,1075
15511,28017,20-24,465,575,1040
15512,28017,25-29,542,577,1119
15513,28017,30-34,541,546,1087
15514,28017,35-39,486,510,996
15515,28017,40-44,463,521,984
15516,28017,45-49,442,450,892
15517,28017,50-54,518,499,1017
15518,28017,55-59,585,522,1107
15519,28017,60-64,556,476,1032
15520,28017,65+,1759,1368,3127
15521,28019,15-19,216,253,469
15522,28019,20-24,211,220,431
15523,28019,25-29,236,208,444
15524,28019,30-34,240,246,486
15525,28019,35-39,227,210,437
15526,28019,40-44,238,224,462
15527,28019,45-49,230,240,470
15528,28019,50-54,253,249,502
15529,28019,55-59,268,292,560
15530,28019,60-64,307,297,604
15531,28019,65+,1017,802,1819
15532,28021,15-19,479,459,938
15533,28021,20-24,665,591,1256
15534,28021,25-29,245,261,506
15535,28021,30-34,243,214,457
15536,28021,35-39,215,215,430
15537,28021,40-44,253,215,468
15538,28021,45-49,199,191,390
15539,28021,50-54,220,181,401
15540,28021,55-59,255,211,466
15541,28021,60-64,273,253,526
15542,28021,65+,872,648,1520
15543,28023,15-19,447,459,906
15544,28023,20-24,452,440,892
15545,28023,25-29,476,445,921
15546,28023,30-34,466,424,890
15547,28023,35-39,460,411,871
15548,28023,40-44,451,351,802
15549,28023,45-49,453,415,868
15550,28023,50-54,517,468,985
15551,28023,55-59,529,531,1060
15552,28023,60-64,637,505,1142
15553,28023,65+,1848,1477,3325
15554,28025,15-19,603,593,1196
15555,28025,20-24,563,546,1109
15556,28025,25-29,614,556,1170
15557,28025,30-34,608,558,1166
15558,28025,35-39,578,554,1132
15559,28025,40-44,593,474,1067
15560,28025,45-49,562,510,1072
15561,28025,50-54,585,528,1113
15562,28025,55-59,635,531,1166
15563,28025,60-64,709,621,1330
15564,28025,65+,2051,1547,3598
15565,28027,15-19,716,816,1532
15566,28027,20-24,711,681,1392
15567,28027,25-29,723,591,1314
15568,28027,30-34,653,546,1199
15569,28027,35-39,641,505,1146
15570,28027,40-44,663,503,1166
15571,28027,45-49,594,477,1071
15572,28027,50-54,645,496,1141
15573,28027,55-59,692,592,1284
15574,28027,60-64,752,638,1390
15575,28027,65+,1926,1480,3406
15576,28029,15-19,1076,1152,2228
15577,28029,20-24,872,928,1800
15578,28029,25-29,811,774,1585
15579,28029,30-34,820,788,1608
15580,28029,35-39,817,718,1535
15581,28029,40-44,872,784,1656
15582,28029,45-49,809,750,1559
15583,28029,50-54,866,740,1606
15584,28029,55-59,1020,907,1927
15585,28029,60-64,1059,1011,2070
15586,28029,65+,2906,2400,5306
15587,28031,15-19,540,615,1155
15588,28031,20-24,532,531,1063
15589,28031,25-29,593,551,1144
15590,28031,30-34,582,555,1137
15591,28031,35-39,604,557,1161
15592,28031,40-44,580,557,1137
15593,28031,45-49,524,483,1007
15594,28031,50-54,632,545,1177
15595,28031,55-59,642,591,1233
15596,28031,60-64,648,574,1222
15597,28031,65+,1665,1405,3070
15598,28033,15-19,6742,7147,13889
15599,28033,20-24,5862,5903,11765
15600,28033,25-29,5979,5887,11866
15601,28033,30-34,6581,5838,12419
15602,28033,35-39,7075,5953,13028
15603,28033,40-44,7319,6311,13630
15604,28033,45-49,6908,5971,12879
15605,28033,50-54,6672,6300,12972
15606,28033,55-59,6202,5904,12106
15607,28033,60-64,5413,5064,10477
15608,28033,65+,14092,11220,25312
15609,28035,15-19,2970,2556,5526
15610,28035,20-24,4503,3669,8172
15611,28035,25-29,3121,2868,5989
15612,28035,30-34,2793,2547,5340
15613,28035,35-39,2530,2321,4851
15614,28035,40-44,2355,2281,4636
15615,28035,45-49,2054,1966,4020
15616,28035,50-54,2221,2015,4236
15617,28035,55-59,2308,2064,4372
15618,28035,60-64,2338,2048,4386
15619,28035,65+,6250,4747,10997
15620,28037,15-19,255,253,508
15621,28037,20-24,198,236,434
15622,28037,25-29,203,184,387
15623,28037,30-34,196,194,390
15624,28037,35-39,239,226,465
15625,28037,40-44,236,201,437
15626,28037,45-49,235,189,424
15627,28037,50-54,223,255,478
15628,28037,55-59,273,226,499
15629,28037,60-64,295,314,609
15630,28037,65+,853,780,1633
15631,28039,15-19,806,794,1600
15632,28039,20-24,708,758,1466
15633,28039,25-29,801,937,1738
15634,28039,30-34,824,862,1686
15635,28039,35-39,705,814,1519
15636,28039,40-44,694,790,1484
15637,28039,45-49,691,731,1422
15638,28039,50-54,767,796,1563
15639,28039,55-59,798,843,1641
15640,28039,60-64,725,770,1495
15641,28039,65+,1957,1673,3630
15642,28041,15-19,348,385,733
15643,28041,20-24,293,644,937
15644,28041,25-29,370,795,1165
15645,28041,30-34,343,772,1115
15646,28041,35-39,319,647,966
15647,28041,40-44,347,609,956
15648,28041,45-49,352,638,990
15649,28041,50-54,372,558,930
15650,28041,55-59,384,432,816
15651,28041,60-64,394,411,805
15652,28041,65+,1146,980,2126
15653,28043,15-19,675,718,1393
15654,28043,20-24,591,576,1167
15655,28043,25-29,702,674,1376
15656,28043,30-34,737,611,1348
15657,28043,35-39,633,575,1208
15658,28043,40-44,657,596,1253
15659,28043,45-49,657,572,1229
15660,28043,50-54,736,660,1396
15661,28043,55-59,735,688,1423
15662,28043,60-64,724,680,1404
15663,28043,65+,2230,1664,3894
15664,28045,15-19,1239,1370,2609
15665,28045,20-24,1160,1176,2336
15666,28045,25-29,1332,1243,2575
15667,28045,30-34,1432,1387,2819
15668,28045,35-39,1326,1217,2543
15669,28045,40-44,1430,1276,2706
15670,28045,45-49,1331,1308,2639
15671,28045,50-54,1648,1580,3228
15672,28045,55-59,1823,1766,3589
15673,28045,60-64,2011,1890,3901
15674,28045,65+,5279,4559,9838
15675,28047,15-19,6515,7652,14167
15676,28047,20-24,6298,7189,13487
15677,28047,25-29,7102,6940,14042
15678,28047,30-34,7596,6787,14383
15679,28047,35-39,7242,6508,13750
15680,28047,40-44,6781,6252,13033
15681,28047,45-49,6267,5627,11894
15682,28047,50-54,6538,6057,12595
15683,28047,55-59,7095,6592,13687
15684,28047,60-64,7124,6729,13853
15685,28047,65+,18194,15209,33403
15686,28049,15-19,8309,8000,16309
15687,28049,20-24,8531,7672,16203
15688,28049,25-29,8386,7573,15959
15689,28049,30-34,7963,7136,15099
15690,28049,35-39,7556,6506,14062
15691,28049,40-44,7273,6278,13551
15692,28049,45-49,6798,5590,12388
15693,28049,50-54,6831,5963,12794
15694,28049,55-59,7444,6324,13768
15695,28049,60-64,7739,6344,14083
15696,28049,65+,20299,14681,34980
15697,28051,15-19,629,700,1329
15698,28051,20-24,574,624,1198
15699,28051,25-29,573,538,1111
15700,28051,30-34,498,510,1008
15701,28051,35-39,466,439,905
15702,28051,40-44,488,440,928
15703,28051,45-49,462,385,847
15704,28051,50-54,526,426,952
15705,28051,55-59,584,482,1066
15706,28051,60-64,620,513,1133
15707,28051,65+,1558,1172,2730
15708,28053,15-19,269,280,549
15709,28053,20-24,224,225,449
15710,28053,25-29,226,200,426
15711,28053,30-34,202,198,400
15712,28053,35-39,245,227,472
15713,28053,40-44,218,195,413
15714,28053,45-49,207,172,379
15715,28053,50-54,264,186,450
15716,28053,55-59,277,238,515
15717,28053,60-64,319,272,591
15718,28053,65+,787,568,1355
15719,28055,15-19,17,66,83
15720,28055,20-24,26,92,118
15721,28055,25-29,36,107,143
15722,28055,30-34,30,48,78
15723,28055,35-39,35,55,90
15724,28055,40-44,39,29,68
15725,28055,45-49,20,56,76
15726,28055,50-54,34,41,75
15727,28055,55-59,59,66,125
15728,28055,60-64,50,65,115
15729,28055,65+,126,109,235
15730,28057,15-19,832,947,1779
15731,28057,20-24,777,795,1572
15732,28057,25-29,742,753,1495
15733,28057,30-34,757,790,1547
15734,28057,35-39,672,678,1350
15735,28057,40-44,672,663,1335
15736,28057,45-49,798,747,1545
15737,28057,50-54,789,833,1622
15738,28057,55-59,754,825,1579
15739,28057,60-64,738,732,1470
15740,28057,65+,2400,1873,4273
15741,28059,15-19,4572,4790,9362
15742,28059,20-24,3983,4173,8156
15743,28059,25-29,4591,4433,9024
15744,28059,30-34,4957,4548,9505
15745,28059,35-39,4824,4632,9456
15746,28059,40-44,4897,4534,9431
15747,28059,45-49,4567,4350,8917
15748,28059,50-54,4670,4700,9370
15749,28059,55-59,5034,4890,9924
15750,28059,60-64,4997,4848,9845
15751,28059,65+,12972,10990,23962
15752,28061,15-19,447,466,913
15753,28061,20-24,472,430,902
15754,28061,25-29,504,475,979
15755,28061,30-34,473,450,923
15756,28061,35-39,423,460,883
15757,28061,40-44,494,462,956
15758,28061,45-49,451,464,915
15759,28061,50-54,503,508,1011
15760,28061,55-59,538,519,1057
15761,28061,60-64,614,573,1187
15762,28061,65+,1843,1566,3409
15763,28063,15-19,178,205,383
15764,28063,20-24,214,240,454
15765,28063,25-29,207,253,460
15766,28063,30-34,201,268,469
15767,28063,35-39,201,222,423
15768,28063,40-44,231,260,491
15769,28063,45-49,179,211,390
15770,28063,50-54,218,197,415
15771,28063,55-59,263,239,502
15772,28063,60-64,256,267,523
15773,28063,65+,804,572,1376
15774,28065,15-19,267,282,549
15775,28065,20-24,321,293,614
15776,28065,25-29,347,341,688
15777,28065,30-34,318,275,593
15778,28065,35-39,304,276,580
15779,28065,40-44,349,318,667
15780,28065,45-49,332,293,625
15781,28065,50-54,364,342,706
15782,28065,55-59,403,352,755
15783,28065,60-64,449,380,829
15784,28065,65+,1490,1187,2677
15785,28067,15-19,2396,2475,4871
15786,28067,20-24,1981,2045,4026
15787,28067,25-29,1902,1918,3820
15788,28067,30-34,2111,1898,4009
15789,28067,35-39,2227,1956,4183
15790,28067,40-44,2035,1930,3965
15791,28067,45-49,1853,1777,3630
15792,28067,50-54,1987,2038,4025
15793,28067,55-59,2097,1991,4088
15794,28067,60-64,2299,2193,4492
15795,28067,65+,6604,5261,11865
15796,28069,15-19,293,363,656
15797,28069,20-24,310,357,667
15798,28069,25-29,242,333,575
15799,28069,30-34,242,289,531
15800,28069,35-39,197,256,453
15801,28069,40-44,216,254,470
15802,28069,45-49,287,270,557
15803,28069,50-54,271,252,523
15804,28069,55-59,292,245,537
15805,28069,60-64,309,271,580
15806,28069,65+,1067,886,1953
15807,28071,15-19,2791,2585,5376
15808,28071,20-24,4158,4050,8208
15809,28071,25-29,1898,2087,3985
15810,28071,30-34,1861,1771,3632
15811,28071,35-39,1826,1828,3654
15812,28071,40-44,1724,1683,3407
15813,28071,45-49,1496,1457,2953
15814,28071,50-54,1579,1462,3041
15815,28071,55-59,1512,1363,2875
15816,28071,60-64,1598,1446,3044
15817,28071,65+,4415,3508,7923
15818,28073,15-19,2105,2134,4239
15819,28073,20-24,2091,1892,3983
15820,28073,25-29,2255,2054,4309
15821,28073,30-34,2563,2255,4818
15822,28073,35-39,2573,2260,4833
15823,28073,40-44,2400,2121,4521
15824,28073,45-49,2098,1988,4086
15825,28073,50-54,2017,1993,4010
15826,28073,55-59,2015,1866,3881
15827,28073,60-64,1971,1817,3788
15828,28073,65+,5345,4386,9731
15829,28075,15-19,2381,2553,4934
15830,28075,20-24,2060,2385,4445
15831,28075,25-29,2266,2348,4614
15832,28075,30-34,2357,2388,4745
15833,28075,35-39,2163,2111,4274
15834,28075,40-44,2166,2189,4355
15835,28075,45-49,2147,2030,4177
15836,28075,50-54,2315,2057,4372
15837,28075,55-59,2381,2261,4642
15838,28075,60-64,2462,2204,4666
15839,28075,65+,7384,5673,13057
15840,28077,15-19,380,378,758
15841,28077,20-24,302,304,606
15842,28077,25-29,354,298,652
15843,28077,30-34,327,323,650
15844,28077,35-39,347,356,703
15845,28077,40-44,363,359,722
15846,28077,45-49,374,340,714
15847,28077,50-54,336,349,685
15848,28077,55-59,431,392,823
15849,28077,60-64,454,400,854
15850,28077,65+,1206,1068,2274
15851,28079,15-19,582,1114,1696
15852,28079,20-24,554,698,1252
15853,28079,25-29,611,701,1312
15854,28079,30-34,671,669,1340
15855,28079,35-39,614,680,1294
15856,28079,40-44,692,651,1343
15857,28079,45-49,650,615,1265
15858,28079,50-54,670,617,1287
15859,28079,55-59,625,665,1290
15860,28079,60-64,681,662,1343
15861,28079,65+,2000,1586,3586
15862,28081,15-19,2668,2971,5639
15863,28081,20-24,2494,2463,4957
15864,28081,25-29,2806,2594,5400
15865,28081,30-34,2909,2585,5494
15866,28081,35-39,2797,2560,5357
15867,28081,40-44,2800,2528,5328
15868,28081,45-49,2633,2514,5147
15869,28081,50-54,2669,2583,5252
15870,28081,55-59,2865,2661,5526
15871,28081,60-64,2688,2353,5041
15872,28081,65+,7308,5418,12726
15873,28083,15-19,1105,1097,2202
15874,28083,20-24,1018,997,2015
15875,28083,25-29,920,846,1766
15876,28083,30-34,851,788,1639
15877,28083,35-39,823,747,1570
15878,28083,40-44,885,766,1651
15879,28083,45-49,820,633,1453
15880,28083,50-54,822,629,1451
15881,28083,55-59,862,790,1652
15882,28083,60-64,957,695,1652
15883,28083,65+,2461,1753,4214
15884,28085,15-19,1088,1143,2231
15885,28085,20-24,1035,947,1982
15886,28085,25-29,1056,1078,2134
15887,28085,30-34,1101,975,2076
15888,28085,35-39,1123,1033,2156
15889,28085,40-44,1212,1163,2375
15890,28085,45-49,1170,1090,2260
15891,28085,50-54,1163,1140,2303
15892,28085,55-59,1161,1107,2268
15893,28085,60-64,1254,1114,2368
15894,28085,65+,3558,2675,6233
15895,28087,15-19,1858,1889,3747
15896,28087,20-24,1973,1837,3810
15897,28087,25-29,2066,1987,4053
15898,28087,30-34,2078,1888,3966
15899,28087,35-39,1886,1765,3651
15900,28087,40-44,1754,1611,3365
15901,28087,45-49,1674,1440,3114
15902,28087,50-54,1828,1610,3438
15903,28087,55-59,1953,1787,3740
15904,28087,60-64,2008,1801,3809
15905,28087,65+,5532,4205,9737
15906,28089,15-19,3779,3929,7708
15907,28089,20-24,3434,3205,6639
15908,28089,25-29,3474,3212,6686
15909,28089,30-34,3670,3287,6957
15910,28089,35-39,3990,3441,7431
15911,28089,40-44,3971,3712,7683
15912,28089,45-49,3667,3368,7035
15913,28089,50-54,3812,3546,7358
15914,28089,55-59,3790,3599,7389
15915,28089,60-64,3780,3374,7154
15916,28089,65+,8673,6999,15672
15917,28091,15-19,757,805,1562
15918,28091,20-24,663,669,1332
15919,28091,25-29,731,746,1477
15920,28091,30-34,710,762,1472
15921,28091,35-39,787,790,1577
15922,28091,40-44,774,781,1555
15923,28091,45-49,725,742,1467
15924,28091,50-54,756,729,1485
15925,28091,55-59,830,802,1632
15926,28091,60-64,841,756,1597
15927,28091,65+,2590,2000,4590
15928,28093,15-19,1069,1015,2084
15929,28093,20-24,1107,1101,2208
15930,28093,25-29,1053,1214,2267
15931,28093,30-34,967,1072,2039
15932,28093,35-39,865,928,1793
15933,28093,40-44,965,1079,2044
15934,28093,45-49,982,1073,2055
15935,28093,50-54,1082,1158,2240
15936,28093,55-59,1241,1249,2490
15937,28093,60-64,1276,1246,2522
15938,28093,65+,3459,2765,6224
15939,28095,15-19,1057,1073,2130
15940,28095,20-24,914,912,1826
15941,28095,25-29,1048,993,2041
15942,28095,30-34,1033,1034,2067
15943,28095,35-39,992,947,1939
15944,28095,40-44,1028,969,1997
15945,28095,45-49,1065,974,2039
15946,28095,50-54,1125,1126,2251
15947,28095,55-59,1200,1091,2291
15948,28095,60-64,1259,1103,2362
15949,28095,65+,3804,2949,6753
15950,28097,15-19,283,305,588
15951,28097,20-24,267,250,517
15952,28097,25-29,263,269,532
15953,28097,30-34,283,252,535
15954,28097,35-39,265,232,497
15955,28097,40-44,270,259,529
15956,28097,45-49,271,238,509
15957,28097,50-54,295,277,572
15958,28097,55-59,392,329,721
15959,28097,60-64,361,360,721
15960,28097,65+,1212,989,2201
15961,28099,15-19,1128,1160,2288
15962,28099,20-24,888,872,1760
15963,28099,25-29,933,815,1748
15964,28099,30-34,914,782,1696
15965,28099,35-39,905,789,1694
15966,28099,40-44,913,853,1766
15967,28099,45-49,887,749,1636
15968,28099,50-54,864,791,1655
15969,28099,55-59,920,837,1757
15970,28099,60-64,907,767,1674
15971,28099,65+,2595,2130,4725
15972,28101,15-19,841,861,1702
15973,28101,20-24,652,708,1360
15974,28101,25-29,625,637,1262
15975,28101,30-34,627,599,1226
15976,28101,35-39,597,556,1153
15977,28101,40-44,637,611,1248
15978,28101,45-49,685,658,1343
15979,28101,50-54,714,674,1388
15980,28101,55-59,644,660,1304
15981,28101,60-64,663,572,1235
15982,28101,65+,2047,1538,3585
15983,28103,15-19,305,331,636
15984,28103,20-24,316,325,641
15985,28103,25-29,364,352,716
15986,28103,30-34,332,308,640
15987,28103,35-39,280,277,557
15988,28103,40-44,310,260,570
15989,28103,45-49,288,236,524
15990,28103,50-54,310,266,576
15991,28103,55-59,369,294,663
15992,28103,60-64,376,349,725
15993,28103,65+,991,780,1771
15994,28105,15-19,2767,2799,5566
15995,28105,20-24,5257,6253,11510
15996,28105,25-29,1951,2056,4007
15997,28105,30-34,1532,1497,3029
15998,28105,35-39,1377,1383,2760
15999,28105,40-44,1218,1160,2378
16000,28105,45-49,1065,963,2028
16001,28105,50-54,1082,976,2058
16002,28105,55-59,1201,1056,2257
16003,28105,60-64,1287,1085,2372
16004,28105,65+,3476,2817,6293
16005,28107,15-19,1100,1055,2155
16006,28107,20-24,979,996,1975
16007,28107,25-29,1095,1014,2109
16008,28107,30-34,1109,990,2099
16009,28107,35-39,1008,886,1894
16010,28107,40-44,1016,867,1883
16011,28107,45-49,972,907,1879
16012,28107,50-54,1077,940,2017
16013,28107,55-59,1185,1113,2298
16014,28107,60-64,1132,1075,2207
16015,28107,65+,3045,2511,5556
16016,28109,15-19,1819,1987,3806
16017,28109,20-24,1562,1699,3261
16018,28109,25-29,1680,1643,3323
16019,28109,30-34,1715,1662,3377
16020,28109,35-39,1611,1647,3258
16021,28109,40-44,1704,1566,3270
16022,28109,45-49,1701,1659,3360
16023,28109,50-54,1818,1779,3597
16024,28109,55-59,2000,1970,3970
16025,28109,60-64,1911,1857,3768
16026,28109,65+,5907,5045,10952
16027,28111,15-19,320,364,684
16028,28111,20-24,340,333,673
16029,28111,25-29,372,401,773
16030,28111,30-34,380,325,705
16031,28111,35-39,334,282,616
16032,28111,40-44,378,353,731
16033,28111,45-49,364,350,714
16034,28111,50-54,361,351,712
16035,28111,55-59,412,378,790
16036,28111,60-64,410,411,821
16037,28111,65+,1225,1023,2248
16038,28113,15-19,1482,1559,3041
16039,28113,20-24,1260,1272,2532
16040,28113,25-29,1323,1163,2486
16041,28113,30-34,1191,1090,2281
16042,28113,35-39,1164,1068,2232
16043,28113,40-44,1295,1085,2380
16044,28113,45-49,1251,1042,2293
16045,28113,50-54,1211,1100,2311
16046,28113,55-59,1247,1178,2425
16047,28113,60-64,1395,1169,2564
16048,28113,65+,3968,3012,6980
16049,28115,15-19,1108,1154,2262
16050,28115,20-24,919,885,1804
16051,28115,25-29,1014,1014,2028
16052,28115,30-34,997,967,1964
16053,28115,35-39,1022,1039,2061
16054,28115,40-44,1000,942,1942
16055,28115,45-49,945,866,1811
16056,28115,50-54,995,968,1963
16057,28115,55-59,1029,1026,2055
16058,28115,60-64,959,932,1891
16059,28115,65+,2700,2198,4898
16060,28117,15-19,753,840,1593
16061,28117,20-24,795,896,1691
16062,28117,25-29,747,809,1556
16063,28117,30-34,851,786,1637
16064,28117,35-39,730,764,1494
16065,28117,40-44,716,756,1472
16066,28117,45-49,733,710,1443
16067,28117,50-54,807,801,1608
16068,28117,55-59,833,795,1628
16069,28117,60-64,816,755,1571
16070,28117,65+,2629,1934,4563
16071,28119,15-19,170,199,369
16072,28119,20-24,196,168,364
16073,28119,25-29,209,174,383
16074,28119,30-34,167,195,362
16075,28119,35-39,155,146,301
16076,28119,40-44,176,152,328
16077,28119,45-49,219,142,361
16078,28119,50-54,223,177,400
16079,28119,55-59,227,205,432
16080,28119,60-64,197,196,393
16081,28119,65+,664,467,1131
16082,28121,15-19,4817,5263,10080
16083,28121,20-24,4546,4498,9044
16084,28121,25-29,5298,4936,10234
16085,28121,30-34,5844,5354,11198
16086,28121,35-39,5953,5504,11457
16087,28121,40-44,5795,5521,11316
16088,28121,45-49,5377,5176,10553
16089,28121,50-54,5302,5177,10479
16090,28121,55-59,5027,4861,9888
16091,28121,60-64,5045,4540,9585
16092,28121,65+,14424,11138,25562
16093,28123,15-19,853,968,1821
16094,28123,20-24,790,740,1530
16095,28123,25-29,884,830,1714
16096,28123,30-34,832,813,1645
16097,28123,35-39,854,786,1640
16098,28123,40-44,813,768,1581
16099,28123,45-49,869,884,1753
16100,28123,50-54,836,858,1694
16101,28123,55-59,902,821,1723
16102,28123,60-64,910,866,1776
16103,28123,65+,2529,1854,4383
16104,28125,15-19,112,145,257
16105,28125,20-24,100,93,193
16106,28125,25-29,97,85,182
16107,28125,30-34,91,82,173
16108,28125,35-39,100,85,185
16109,28125,40-44,111,93,204
16110,28125,45-49,101,87,188
16111,28125,50-54,109,106,215
16112,28125,55-59,140,124,264
16113,28125,60-64,165,140,305
16114,28125,65+,442,345,787
16115,28127,15-19,796,903,1699
16116,28127,20-24,724,712,1436
16117,28127,25-29,788,782,1570
16118,28127,30-34,830,726,1556
16119,28127,35-39,789,698,1487
16120,28127,40-44,761,740,1501
16121,28127,45-49,789,700,1489
16122,28127,50-54,850,757,1607
16123,28127,55-59,948,827,1775
16124,28127,60-64,950,885,1835
16125,28127,65+,2656,2218,4874
16126,28129,15-19,427,449,876
16127,28129,20-24,377,362,739
16128,28129,25-29,436,428,864
16129,28129,30-34,446,404,850
16130,28129,35-39,379,364,743
16131,28129,40-44,420,397,817
16132,28129,45-49,416,391,807
16133,28129,50-54,438,479,917
16134,28129,55-59,490,439,929
16135,28129,60-64,516,479,995
16136,28129,65+,1605,1309,2914
16137,28131,15-19,666,739,1405
16138,28131,20-24,589,642,1231
16139,28131,25-29,592,545,1137
16140,28131,30-34,569,651,1220
16141,28131,35-39,538,526,1064
16142,28131,40-44,558,599,1157
16143,28131,45-49,548,580,1128
16144,28131,50-54,570,576,1146
16145,28131,55-59,665,691,1356
16146,28131,60-64,635,618,1253
16147,28131,65+,1681,1463,3144
16148,28133,15-19,865,894,1759
16149,28133,20-24,756,1056,1812
16150,28133,25-29,699,1315,2014
16151,28133,30-34,746,1295,2041
16152,28133,35-39,674,1032,1706
16153,28133,40-44,722,970,1692
16154,28133,45-49,614,925,1539
16155,28133,50-54,726,881,1607
16156,28133,55-59,791,791,1582
16157,28133,60-64,784,668,1452
16158,28133,65+,2166,1613,3779
16159,28135,15-19,292,287,579
16160,28135,20-24,269,721,990
16161,28135,25-29,349,788,1137
16162,28135,30-34,306,727,1033
16163,28135,35-39,275,535,810
16164,28135,40-44,316,491,807
16165,28135,45-49,327,446,773
16166,28135,50-54,362,350,712
16167,28135,55-59,368,368,736
16168,28135,60-64,402,354,756
16169,28135,65+,1136,891,2027
16170,28137,15-19,1115,1145,2260
16171,28137,20-24,980,1000,1980
16172,28137,25-29,894,872,1766
16173,28137,30-34,894,831,1725
16174,28137,35-39,827,821,1648
16175,28137,40-44,878,752,1630
16176,28137,45-49,879,743,1622
16177,28137,50-54,909,894,1803
16178,28137,55-59,959,948,1907
16179,28137,60-64,968,893,1861
16180,28137,65+,2671,2117,4788
16181,28139,15-19,770,767,1537
16182,28139,20-24,714,695,1409
16183,28139,25-29,638,683,1321
16184,28139,30-34,673,633,1306
16185,28139,35-39,647,582,1229
16186,28139,40-44,723,652,1375
16187,28139,45-49,647,637,1284
16188,28139,50-54,691,729,1420
16189,28139,55-59,711,760,1471
16190,28139,60-64,696,658,1354
16191,28139,65+,2067,1646,3713
16192,28141,15-19,550,570,1120
16193,28141,20-24,499,527,1026
16194,28141,25-29,559,576,1135
16195,28141,30-34,527,575,1102
16196,28141,35-39,519,479,998
16197,28141,40-44,586,474,1060
16198,28141,45-49,597,562,1159
16199,28141,50-54,628,596,1224
16200,28141,55-59,704,732,1436
16201,28141,60-64,623,652,1275
16202,28141,65+,2150,1785,3935
16203,28143,15-19,297,345,642
16204,28143,20-24,322,312,634
16205,28143,25-29,348,291,639
16206,28143,30-34,368,251,619
16207,28143,35-39,358,301,659
16208,28143,40-44,358,273,631
16209,28143,45-49,283,259,542
16210,28143,50-54,298,268,566
16211,28143,55-59,291,255,546
16212,28143,60-64,327,255,582
16213,28143,65+,751,580,1331
16214,28145,15-19,918,959,1877
16215,28145,20-24,811,829,1640
16216,28145,25-29,907,901,1808
16217,28145,30-34,895,892,1787
16218,28145,35-39,830,837,1667
16219,28145,40-44,893,887,1780
16220,28145,45-49,908,859,1767
16221,28145,50-54,907,912,1819
16222,28145,55-59,878,870,1748
16223,28145,60-64,811,810,1621
16224,28145,65+,2580,2066,4646
16225,28147,15-19,426,459,885
16226,28147,20-24,372,409,781
16227,28147,25-29,403,427,830
16228,28147,30-34,390,378,768
16229,28147,35-39,354,390,744
16230,28147,40-44,448,427,875
16231,28147,45-49,438,385,823
16232,28147,50-54,491,403,894
16233,28147,55-59,456,442,898
16234,28147,60-64,521,473,994
16235,28147,65+,1560,1251,2811
16236,28149,15-19,1388,1443,2831
16237,28149,20-24,1228,1167,2395
16238,28149,25-29,1422,1257,2679
16239,28149,30-34,1353,1182,2535
16240,28149,35-39,1405,1301,2706
16241,28149,40-44,1401,1324,2725
16242,28149,45-49,1358,1233,2591
16243,28149,50-54,1368,1210,2578
16244,28149,55-59,1585,1400,2985
16245,28149,60-64,1597,1490,3087
16246,28149,65+,4471,3532,8003
16247,28151,15-19,1452,1418,2870
16248,28151,20-24,1328,1274,2602
16249,28151,25-29,1456,1352,2808
16250,28151,30-34,1351,1152,2503
16251,28151,35-39,1331,1137,2468
16252,28151,40-44,1368,1109,2477
16253,28151,45-49,1359,1024,2383
16254,28151,50-54,1460,1195,2655
16255,28151,55-59,1527,1341,2868
16256,28151,60-64,1704,1394,3098
16257,28151,65+,4413,3172,7585
16258,28153,15-19,618,616,1234
16259,28153,20-24,595,555,1150
16260,28153,25-29,637,587,1224
16261,28153,30-34,604,582,1186
16262,28153,35-39,638,531,1169
16263,28153,40-44,624,552,1176
16264,28153,45-49,575,557,1132
16265,28153,50-54,607,546,1153
16266,28153,55-59,668,623,1291
16267,28153,60-64,729,701,1430
16268,28153,65+,1931,1587,3518
16269,28155,15-19,320,319,639
16270,28155,20-24,270,282,552
16271,28155,25-29,286,271,557
16272,28155,30-34,309,303,612
16273,28155,35-39,326,314,640
16274,28155,40-44,279,314,593
16275,28155,45-49,283,283,566
16276,28155,50-54,331,328,659
16277,28155,55-59,373,360,733
16278,28155,60-64,351,357,708
16279,28155,65+,990,778,1768
16280,28157,15-19,228,236,464
16281,28157,20-24,202,347,549
16282,28157,25-29,202,418,620
16283,28157,30-34,208,398,606
16284,28157,35-39,207,336,543
16285,28157,40-44,216,277,493
16286,28157,45-49,189,263,452
16287,28157,50-54,232,243,475
16288,28157,55-59,288,256,544
16289,28157,60-64,302,297,599
16290,28157,65+,861,705,1566
16291,28159,15-19,533,607,1140
16292,28159,20-24,457,521,978
16293,28159,25-29,472,494,966
16294,28159,30-34,500,543,1043
16295,28159,35-39,533,482,1015
16296,28159,40-44,566,533,1099
16297,28159,45-49,533,493,1026
16298,28159,50-54,542,557,1099
16299,28159,55-59,569,574,1143
16300,28159,60-64,629,591,1220
16301,28159,65+,2049,1662,3711
16302,28161,15-19,384,387,771
16303,28161,20-24,315,341,656
16304,28161,25-29,379,331,710
16305,28161,30-34,350,345,695
16306,28161,35-39,381,290,671
16307,28161,40-44,371,372,743
16308,28161,45-49,390,381,771
16309,28161,50-54,390,380,770
16310,28161,55-59,443,396,839
16311,28161,60-64,499,474,973
16312,28161,65+,1431,1198,2629
16313,28163,15-19,739,831,1570
16314,28163,20-24,664,885,1549
16315,28163,25-29,720,1438,2158
16316,28163,30-34,651,1691,2342
16317,28163,35-39,666,1692,2358
16318,28163,40-44,692,1294,1986
16319,28163,45-49,600,981,1581
16320,28163,50-54,631,848,1479
16321,28163,55-59,743,798,1541
16322,28163,60-64,736,720,1456
16323,28163,65+,2095,1614,3709
16324,29001,15-19,1627,1262,2889
16325,29001,20-24,2628,2298,4926
16326,29001,25-29,702,746,1448
16327,29001,30-34,609,563,1172
16328,29001,35-39,554,584,1138
16329,29001,40-44,546,547,1093
16330,29001,45-49,536,534,1070
16331,29001,50-54,584,647,1231
16332,29001,55-59,678,633,1311
16333,29001,60-64,661,653,1314
16334,29001,65+,2148,1730,3878
16335,29003,15-19,529,549,1078
16336,29003,20-24,432,457,889
16337,29003,25-29,461,472,933
16338,29003,30-34,516,537,1053
16339,29003,35-39,558,526,1084
16340,29003,40-44,604,583,1187
16341,29003,45-49,516,536,1052
16342,29003,50-54,562,602,1164
16343,29003,55-59,593,622,1215
16344,29003,60-64,690,677,1367
16345,29003,65+,1914,1662,3576
16346,29005,15-19,141,149,290
16347,29005,20-24,105,98,203
16348,29005,25-29,130,147,277
16349,29005,30-34,136,136,272
16350,29005,35-39,139,137,276
16351,29005,40-44,138,156,294
16352,29005,45-49,154,150,304
16353,29005,50-54,151,179,330
16354,29005,55-59,196,197,393
16355,29005,60-64,191,199,390
16356,29005,65+,707,621,1328
16357,29007,15-19,708,947,1655
16358,29007,20-24,737,627,1364
16359,29007,25-29,930,689,1619
16360,29007,30-34,938,654,1592
16361,29007,35-39,952,687,1639
16362,29007,40-44,842,714,1556
16363,29007,45-49,845,678,1523
16364,29007,50-54,752,705,1457
16365,29007,55-59,864,804,1668
16366,29007,60-64,896,866,1762
16367,29007,65+,2588,1982,4570
16368,29009,15-19,979,1118,2097
16369,29009,20-24,838,937,1775
16370,29009,25-29,965,964,1929
16371,29009,30-34,891,987,1878
16372,29009,35-39,906,929,1835
16373,29009,40-44,977,1016,1993
16374,29009,45-49,935,942,1877
16375,29009,50-54,1069,1053,2122
16376,29009,55-59,1222,1255,2477
16377,29009,60-64,1327,1340,2667
16378,29009,65+,3912,3606,7518
16379,29011,15-19,369,431,800
16380,29011,20-24,299,310,609
16381,29011,25-29,320,341,661
16382,29011,30-34,299,296,595
16383,29011,35-39,341,310,651
16384,29011,40-44,349,353,702
16385,29011,45-49,305,330,635
16386,29011,50-54,349,324,673
16387,29011,55-59,386,384,770
16388,29011,60-64,439,448,887
16389,29011,65+,1333,1118,2451
16390,29013,15-19,493,546,1039
16391,29013,20-24,395,446,841
16392,29013,25-29,460,492,952
16393,29013,30-34,436,461,897
16394,29013,35-39,447,464,911
16395,29013,40-44,514,457,971
16396,29013,45-49,423,470,893
16397,29013,50-54,461,476,937
16398,29013,55-59,605,602,1207
16399,29013,60-64,602,589,1191
16400,29013,65+,1699,1496,3195
16401,29015,15-19,457,514,971
16402,29015,20-24,348,385,733
16403,29015,25-29,383,392,775
16404,29015,30-34,406,461,867
16405,29015,35-39,440,428,868
16406,29015,40-44,435,440,875
16407,29015,45-49,487,483,970
16408,29015,50-54,647,648,1295
16409,29015,55-59,803,799,1602
16410,29015,60-64,959,955,1914
16411,29015,65+,3129,3050,6179
16412,29017,15-19,280,324,604
16413,29017,20-24,237,254,491
16414,29017,25-29,284,298,582
16415,29017,30-34,293,294,587
16416,29017,35-39,283,292,575
16417,29017,40-44,307,309,616
16418,29017,45-49,316,309,625
16419,29017,50-54,350,354,704
16420,29017,55-59,410,415,825
16421,29017,60-64,395,424,819
16422,29017,65+,1176,1039,2215
16423,29019,15-19,8084,7291,15375
16424,29019,20-24,12937,11587,24524
16425,29019,25-29,7205,6955,14160
16426,29019,30-34,6748,6482,13230
16427,29019,35-39,6028,6048,12076
16428,29019,40-44,5683,5467,11150
16429,29019,45-49,4788,4735,9523
16430,29019,50-54,4851,4663,9514
16431,29019,55-59,5029,4752,9781
16432,29019,60-64,5187,4721,9908
16433,29019,65+,13656,11254,24910
16434,29021,15-19,2623,2803,5426
16435,29021,20-24,2553,2924,5477
16436,29021,25-29,2556,2951,5507
16437,29021,30-34,2663,3000,5663
16438,29021,35-39,2550,3084,5634
16439,29021,40-44,2409,2789,5198
16440,29021,45-49,2218,2544,4762
16441,29021,50-54,2416,2534,4950
16442,29021,55-59,2854,2785,5639
16443,29021,60-64,2782,2787,5569
16444,29021,65+,8030,6387,14417
16445,29023,15-19,1299,1385,2684
16446,29023,20-24,1117,1211,2328
16447,29023,25-29,1302,1280,2582
16448,29023,30-34,1291,1256,2547
16449,29023,35-39,1306,1253,2559
16450,29023,40-44,1318,1199,2517
16451,29023,45-49,1244,1169,2413
16452,29023,50-54,1309,1225,2534
16453,29023,55-59,1465,1367,2832
16454,29023,60-64,1406,1366,2772
16455,29023,65+,4486,3652,8138
16456,29025,15-19,284,312,596
16457,29025,20-24,215,275,490
16458,29025,25-29,221,282,503
16459,29025,30-34,208,235,443
16460,29025,35-39,260,227,487
16461,29025,40-44,258,263,521
16462,29025,45-49,263,239,502
16463,29025,50-54,282,300,582
16464,29025,55-59,310,339,649
16465,29025,60-64,309,322,631
16466,29025,65+,963,833,1796
16467,29027,15-19,1526,1565,3091
16468,29027,20-24,1493,1687,3180
16469,29027,25-29,1261,1509,2770
16470,29027,30-34,1367,1629,2996
16471,29027,35-39,1318,1583,2901
16472,29027,40-44,1314,1445,2759
16473,29027,45-49,1209,1410,2619
16474,29027,50-54,1398,1488,2886
16475,29027,55-59,1535,1588,3123
16476,29027,60-64,1507,1542,3049
16477,29027,65+,3974,3700,7674
16478,29029,15-19,1089,1156,2245
16479,29029,20-24,886,901,1787
16480,29029,25-29,860,941,1801
16481,29029,30-34,962,971,1933
16482,29029,35-39,1073,1032,2105
16483,29029,40-44,1105,1073,2178
16484,29029,45-49,1114,1059,2173
16485,29029,50-54,1345,1338,2683
16486,29029,55-59,1850,1714,3564
16487,29029,60-64,2228,2109,4337
16488,29029,65+,6279,6363,12642
16489,29031,15-19,3266,2937,6203
16490,29031,20-24,4296,3816,8112
16491,29031,25-29,2615,2633,5248
16492,29031,30-34,2544,2537,5081
16493,29031,35-39,2518,2490,5008
16494,29031,40-44,2333,2406,4739
16495,29031,45-49,2194,2168,4362
16496,29031,50-54,2294,2213,4507
16497,29031,55-59,2412,2442,4854
16498,29031,60-64,2637,2528,5165
16499,29031,65+,7969,6329,14298
16500,29033,15-19,254,255,509
16501,29033,20-24,218,235,453
16502,29033,25-29,241,252,493
16503,29033,30-34,199,222,421
16504,29033,35-39,228,217,445
16505,29033,40-44,266,250,516
16506,29033,45-49,249,242,491
16507,29033,50-54,245,274,519
16508,29033,55-59,281,293,574
16509,29033,60-64,297,308,605
16510,29033,65+,965,883,1848
16511,29035,15-19,168,182,350
16512,29035,20-24,140,145,285
16513,29035,25-29,142,134,276
16514,29035,30-34,144,136,280
16515,29035,35-39,147,136,283
16516,29035,40-44,170,152,322
16517,29035,45-49,154,153,307
16518,29035,50-54,157,162,319
16519,29035,55-59,180,186,366
16520,29035,60-64,207,210,417
16521,29035,65+,575,493,1068
16522,29037,15-19,3494,3648,7142
16523,29037,20-24,2854,3013,5867
16524,29037,25-29,3162,3182,6344
16525,29037,30-34,3564,3339,6903
16526,29037,35-39,3536,3488,7024
16527,29037,40-44,3560,3487,7047
16528,29037,45-49,3338,3298,6636
16529,29037,50-54,3496,3507,7003
16530,29037,55-59,3871,3821,7692
16531,29037,60-64,3897,3715,7612
16532,29037,65+,10702,8508,19210
16533,29039,15-19,407,543,950
16534,29039,20-24,349,374,723
16535,29039,25-29,349,365,714
16536,29039,30-34,368,376,744
16537,29039,35-39,377,376,753
16538,29039,40-44,367,377,744
16539,29039,45-49,351,398,749
16540,29039,50-54,445,455,900
16541,29039,55-59,481,465,946
16542,29039,60-64,535,523,1058
16543,29039,65+,1711,1573,3284
16544,29041,15-19,200,221,421
16545,29041,20-24,143,192,335
16546,29041,25-29,173,177,350
16547,29041,30-34,180,200,380
16548,29041,35-39,187,179,366
16549,29041,40-44,192,199,391
16550,29041,45-49,183,177,360
16551,29041,50-54,207,215,422
16552,29041,55-59,237,267,504
16553,29041,60-64,316,294,610
16554,29041,65+,976,837,1813
16555,29043,15-19,2865,3116,5981
16556,29043,20-24,2308,2246,4554
16557,29043,25-29,2638,2561,5199
16558,29043,30-34,3118,2872,5990
16559,29043,35-39,3386,3226,6612
16560,29043,40-44,3127,3187,6314
16561,29043,45-49,2790,2815,5605
16562,29043,50-54,2782,2906,5688
16563,29043,55-59,2898,2764,5662
16564,29043,60-64,3048,2760,5808
16565,29043,65+,8113,6855,14968
16566,29045,15-19,184,212,396
16567,29045,20-24,161,172,333
16568,29045,25-29,177,181,358
16569,29045,30-34,170,183,353
16570,29045,35-39,173,186,359
16571,29045,40-44,186,202,388
16572,29045,45-49,177,205,382
16573,29045,50-54,201,211,412
16574,29045,55-59,242,271,513
16575,29045,60-64,248,273,521
16576,29045,65+,737,696,1433
16577,29047,15-19,7877,8654,16531
16578,29047,20-24,7174,7096,14270
16579,29047,25-29,9084,8702,17786
16580,29047,30-34,9399,9457,18856
16581,29047,35-39,9355,9591,18946
16582,29047,40-44,8914,8741,17655
16583,29047,45-49,8041,7932,15973
16584,29047,50-54,8094,8238,16332
16585,29047,55-59,8000,7766,15766
16586,29047,60-64,7871,7502,15373
16587,29047,65+,21063,16958,38021
16588,29049,15-19,655,722,1377
16589,29049,20-24,548,604,1152
16590,29049,25-29,588,586,1174
16591,29049,30-34,602,692,1294
16592,29049,35-39,668,608,1276
16593,29049,40-44,634,663,1297
16594,29049,45-49,589,625,1214
16595,29049,50-54,686,725,1411
16596,29049,55-59,789,795,1584
16597,29049,60-64,785,846,1631
16598,29049,65+,2029,1877,3906
16599,29051,15-19,2523,2631,5154
16600,29051,20-24,2209,2390,4599
16601,29051,25-29,2265,2659,4924
16602,29051,30-34,2368,2737,5105
16603,29051,35-39,2395,2789,5184
16604,29051,40-44,2268,2704,4972
16605,29051,45-49,2145,2436,4581
16606,29051,50-54,2361,2565,4926
16607,29051,55-59,2520,2521,5041
16608,29051,60-64,2592,2352,4944
16609,29051,65+,7606,6174,13780
16610,29053,15-19,491,570,1061
16611,29053,20-24,436,701,1137
16612,29053,25-29,489,652,1141
16613,29053,30-34,459,580,1039
16614,29053,35-39,513,516,1029
16615,29053,40-44,496,564,1060
16616,29053,45-49,448,465,913
16617,29053,50-54,504,521,1025
16618,29053,55-59,566,570,1136
16619,29053,60-64,626,603,1229
16620,29053,65+,1812,1464,3276
16621,29055,15-19,716,741,1457
16622,29055,20-24,575,599,1174
16623,29055,25-29,630,668,1298
16624,29055,30-34,624,640,1264
16625,29055,35-39,676,646,1322
16626,29055,40-44,653,693,1346
16627,29055,45-49,621,615,1236
16628,29055,50-54,687,752,1439
16629,29055,55-59,869,804,1673
16630,29055,60-64,872,941,1813
16631,29055,65+,2442,2194,4636
16632,29057,15-19,195,275,470
16633,29057,20-24,172,192,364
16634,29057,25-29,162,179,341
16635,29057,30-34,173,168,341
16636,29057,35-39,216,206,422
16637,29057,40-44,221,239,460
16638,29057,45-49,196,231,427
16639,29057,50-54,228,237,465
16640,29057,55-59,302,294,596
16641,29057,60-64,321,295,616
16642,29057,65+,951,876,1827
16643,29059,15-19,534,555,1089
16644,29059,20-24,379,421,800
16645,29059,25-29,464,461,925
16646,29059,30-34,542,457,999
16647,29059,35-39,472,506,978
16648,29059,40-44,473,497,970
16649,29059,45-49,486,497,983
16650,29059,50-54,524,513,1037
16651,29059,55-59,586,610,1196
16652,29059,60-64,683,682,1365
16653,29059,65+,1839,1704,3543
16654,29061,15-19,289,336,625
16655,29061,20-24,239,229,468
16656,29061,25-29,212,222,434
16657,29061,30-34,228,219,447
16658,29061,35-39,207,200,407
16659,29061,40-44,207,235,442
16660,29061,45-49,234,237,471
16661,29061,50-54,227,249,476
16662,29061,55-59,281,254,535
16663,29061,60-64,303,317,620
16664,29061,65+,909,869,1778
16665,29063,15-19,270,305,575
16666,29063,20-24,224,419,643
16667,29063,25-29,249,504,753
16668,29063,30-34,265,531,796
16669,29063,35-39,237,500,737
16670,29063,40-44,283,495,778
16671,29063,45-49,280,462,742
16672,29063,50-54,286,474,760
16673,29063,55-59,325,398,723
16674,29063,60-64,341,381,722
16675,29063,65+,1090,963,2053
16676,29065,15-19,393,431,824
16677,29065,20-24,312,369,681
16678,29065,25-29,335,365,700
16679,29065,30-34,408,374,782
16680,29065,35-39,372,411,783
16681,29065,40-44,431,432,863
16682,29065,45-49,409,398,807
16683,29065,50-54,429,446,875
16684,29065,55-59,545,539,1084
16685,29065,60-64,572,603,1175
16686,29065,65+,1704,1479,3183
16687,29067,15-19,360,376,736
16688,29067,20-24,226,247,473
16689,29067,25-29,236,258,494
16690,29067,30-34,304,298,602
16691,29067,35-39,315,346,661
16692,29067,40-44,295,331,626
16693,29067,45-49,306,306,612
16694,29067,50-54,348,338,686
16695,29067,55-59,410,419,829
16696,29067,60-64,477,475,952
16697,29067,65+,1551,1399,2950
16698,29069,15-19,911,899,1810
16699,29069,20-24,788,768,1556
16700,29069,25-29,791,748,1539
16701,29069,30-34,817,711,1528
16702,29069,35-39,790,771,1561
16703,29069,40-44,892,775,1667
16704,29069,45-49,828,741,1569
16705,29069,50-54,840,847,1687
16706,29069,55-59,931,853,1784
16707,29069,60-64,944,923,1867
16708,29069,65+,2959,2171,5130
16709,29071,15-19,3079,3271,6350
16710,29071,20-24,2686,2887,5573
16711,29071,25-29,2993,3217,6210
16712,29071,30-34,3230,3279,6509
16713,29071,35-39,3161,3317,6478
16714,29071,40-44,2982,3062,6044
16715,29071,45-49,2888,2939,5827
16716,29071,50-54,3463,3435,6898
16717,29071,55-59,4010,4031,8041
16718,29071,60-64,4129,4196,8325
16719,29071,65+,10439,8969,19408
16720,29073,15-19,397,464,861
16721,29073,20-24,341,377,718
16722,29073,25-29,371,342,713
16723,29073,30-34,404,430,834
16724,29073,35-39,399,411,810
16725,29073,40-44,372,391,763
16726,29073,45-49,412,414,826
16727,29073,50-54,458,474,932
16728,29073,55-59,570,589,1159
16729,29073,60-64,610,646,1256
16730,29073,65+,1819,1594,3413
16731,29075,15-19,181,183,364
16732,29075,20-24,147,161,308
16733,29075,25-29,165,157,322
16734,29075,30-34,194,163,357
16735,29075,35-39,200,188,388
16736,29075,40-44,161,164,325
16737,29075,45-49,160,165,325
16738,29075,50-54,183,189,372
16739,29075,55-59,206,217,423
16740,29075,60-64,211,222,433
16741,29075,65+,665,524,1189
16742,29077,15-19,10188,9976,20164
16743,29077,20-24,15775,14965,30740
16744,29077,25-29,11019,11218,22237
16745,29077,30-34,9680,9896,19576
16746,29077,35-39,9386,9707,19093
16747,29077,40-44,8845,9208,18053
16748,29077,45-49,8100,8085,16185
16749,29077,50-54,8419,8409,16828
16750,29077,55-59,9046,8491,17537
16751,29077,60-64,9270,8483,17753
16752,29077,65+,28896,21980,50876
16753,29079,15-19,345,295,640
16754,29079,20-24,232,226,458
16755,29079,25-29,279,262,541
16756,29079,30-34,305,325,630
16757,29079,35-39,250,290,540
16758,29079,40-44,221,243,464
16759,29079,45-49,229,222,451
16760,29079,50-54,271,256,527
16761,29079,55-59,324,301,625
16762,29079,60-64,362,355,717
16763,29079,65+,1163,948,2111
16764,29081,15-19,252,297,549
16765,29081,20-24,189,212,401
16766,29081,25-29,177,211,388
16767,29081,30-34,223,212,435
16768,29081,35-39,227,244,471
16769,29081,40-44,217,226,443
16770,29081,45-49,200,219,419
16771,29081,50-54,212,219,431
16772,29081,55-59,278,273,551
16773,29081,60-64,318,290,608
16774,29081,65+,996,830,1826
16775,29083,15-19,618,647,1265
16776,29083,20-24,563,607,1170
16777,29083,25-29,573,583,1156
16778,29083,30-34,639,604,1243
16779,29083,35-39,632,611,1243
16780,29083,40-44,638,647,1285
16781,29083,45-49,589,613,1202
16782,29083,50-54,655,658,1313
16783,29083,55-59,750,787,1537
16784,29083,60-64,871,853,1724
16785,29083,65+,2625,2299,4924
16786,29085,15-19,209,202,411
16787,29085,20-24,151,138,289
16788,29085,25-29,165,158,323
16789,29085,30-34,177,169,346
16790,29085,35-39,183,202,385
16791,29085,40-44,208,189,397
16792,29085,45-49,213,190,403
16793,29085,50-54,266,278,544
16794,29085,55-59,352,323,675
16795,29085,60-64,422,408,830
16796,29085,65+,1395,1367,2762
16797,29087,15-19,119,134,253
16798,29087,20-24,83,97,180
16799,29087,25-29,110,91,201
16800,29087,30-34,114,112,226
16801,29087,35-39,94,101,195
16802,29087,40-44,96,123,219
16803,29087,45-49,123,115,238
16804,29087,50-54,143,136,279
16805,29087,55-59,171,166,337
16806,29087,60-64,171,154,325
16807,29087,65+,573,490,1063
16808,29089,15-19,415,445,860
16809,29089,20-24,363,401,764
16810,29089,25-29,259,235,494
16811,29089,30-34,274,256,530
16812,29089,35-39,317,295,612
16813,29089,40-44,254,273,527
16814,29089,45-49,258,264,522
16815,29089,50-54,255,293,548
16816,29089,55-59,320,354,674
16817,29089,60-64,384,374,758
16818,29089,65+,1092,949,2041
16819,29091,15-19,1261,1280,2541
16820,29091,20-24,1039,1093,2132
16821,29091,25-29,1132,1161,2293
16822,29091,30-34,1243,1175,2418
16823,29091,35-39,1207,1156,2363
16824,29091,40-44,1110,1150,2260
16825,29091,45-49,1194,1119,2313
16826,29091,50-54,1223,1186,2409
16827,29091,55-59,1327,1289,2616
16828,29091,60-64,1413,1278,2691
16829,29091,65+,4381,3544,7925
16830,29093,15-19,269,307,576
16831,29093,20-24,215,241,456
16832,29093,25-29,241,234,475
16833,29093,30-34,221,261,482
16834,29093,35-39,262,245,507
16835,29093,40-44,321,282,603
16836,29093,45-49,288,300,588
16837,29093,50-54,300,302,602
16838,29093,55-59,349,361,710
16839,29093,60-64,347,397,744
16840,29093,65+,1114,955,2069
16841,29095,15-19,21881,22128,44009
16842,29095,20-24,22296,21030,43326
16843,29095,25-29,27568,26952,54520
16844,29095,30-34,27977,26772,54749
16845,29095,35-39,25628,24578,50206
16846,29095,40-44,22843,22240,45083
16847,29095,45-49,20414,19550,39964
16848,29095,50-54,21296,21171,42467
16849,29095,55-59,23196,21931,45127
16850,29095,60-64,24154,22016,46170
16851,29095,65+,63475,48857,112332
16852,29097,15-19,4126,4295,8421
16853,29097,20-24,4056,4086,8142
16854,29097,25-29,4130,4273,8403
16855,29097,30-34,4235,4136,8371
16856,29097,35-39,4101,4078,8179
16857,29097,40-44,3798,3891,7689
16858,29097,45-49,3608,3568,7176
16859,29097,50-54,3586,3492,7078
16860,29097,55-59,3630,3614,7244
16861,29097,60-64,3913,3545,7458
16862,29097,65+,11139,8692,19831
16863,29099,15-19,6748,7338,14086
16864,29099,20-24,5840,6123,11963
16865,29099,25-29,6544,6855,13399
16866,29099,30-34,7710,7532,15242
16867,29099,35-39,7685,7987,15672
16868,29099,40-44,7510,7820,15330
16869,29099,45-49,6931,7033,13964
16870,29099,50-54,7560,7559,15119
16871,29099,55-59,8460,8446,16906
16872,29099,60-64,8410,8441,16851
16873,29099,65+,19889,16957,36846
16874,29101,15-19,2205,2219,4424
16875,29101,20-24,3579,4402,7981
16876,29101,25-29,1820,2279,4099
16877,29101,30-34,1697,1858,3555
16878,29101,35-39,1574,1776,3350
16879,29101,40-44,1350,1450,2800
16880,29101,45-49,1191,1240,2431
16881,29101,50-54,1377,1270,2647
16882,29101,55-59,1418,1499,2917
16883,29101,60-64,1557,1457,3014
16884,29101,65+,3658,3345,7003
16885,29103,15-19,105,132,237
16886,29103,20-24,102,116,218
16887,29103,25-29,97,112,209
16888,29103,30-34,98,94,192
16889,29103,35-39,97,105,202
16890,29103,40-44,84,81,165
16891,29103,45-49,101,87,188
16892,29103,50-54,121,110,231
16893,29103,55-59,130,131,261
16894,29103,60-64,138,183,321
16895,29103,65+,470,365,835
16896,29105,15-19,1174,1227,2401
16897,29105,20-24,894,980,1874
16898,29105,25-29,1035,1059,2094
16899,29105,30-34,1058,1031,2089
16900,29105,35-39,1106,1092,2198
16901,29105,40-44,1090,1095,2185
16902,29105,45-49,1036,982,2018
16903,29105,50-54,1156,1182,2338
16904,29105,55-59,1248,1350,2598
16905,29105,60-64,1204,1192,2396
16906,29105,65+,3561,2979,6540
16907,29107,15-19,1001,1109,2110
16908,29107,20-24,845,896,1741
16909,29107,25-29,931,967,1898
16910,29107,30-34,970,955,1925
16911,29107,35-39,990,997,1987
16912,29107,40-44,935,909,1844
16913,29107,45-49,947,930,1877
16914,29107,50-54,1087,1094,2181
16915,29107,55-59,1150,1211,2361
16916,29107,60-64,1184,1180,2364
16917,29107,65+,3357,2954,6311
16918,29109,15-19,1226,1403,2629
16919,29109,20-24,1023,1072,2095
16920,29109,25-29,1124,1137,2261
16921,29109,30-34,1103,1075,2178
16922,29109,35-39,1139,1098,2237
16923,29109,40-44,1141,1166,2307
16924,29109,45-49,1038,1134,2172
16925,29109,50-54,1148,1190,2338
16926,29109,55-59,1276,1311,2587
16927,29109,60-64,1285,1217,2502
16928,29109,65+,3670,3265,6935
16929,29111,15-19,377,379,756
16930,29111,20-24,395,459,854
16931,29111,25-29,238,287,525
16932,29111,30-34,267,255,522
16933,29111,35-39,265,271,536
16934,29111,40-44,284,273,557
16935,29111,45-49,243,252,495
16936,29111,50-54,296,302,598
16937,29111,55-59,333,334,667
16938,29111,60-64,363,347,710
16939,29111,65+,1037,898,1935
16940,29113,15-19,1812,2067,3879
16941,29113,20-24,1670,1669,3339
16942,29113,25-29,2172,2085,4257
16943,29113,30-34,2169,2220,4389
16944,29113,35-39,2087,2030,4117
16945,29113,40-44,1930,2013,3943
16946,29113,45-49,1641,1724,3365
16947,29113,50-54,1889,2004,3893
16948,29113,55-59,2180,2180,4360
16949,29113,60-64,2067,2150,4217
16950,29113,65+,4560,4234,8794
16951,29115,15-19,402,397,799
16952,29115,20-24,298,318,616
16953,29115,25-29,315,366,681
16954,29115,30-34,292,312,604
16955,29115,35-39,362,312,674
16956,29115,40-44,334,346,680
16957,29115,45-49,307,299,606
16958,29115,50-54,337,344,681
16959,29115,55-59,387,383,770
16960,29115,60-64,483,450,933
16961,29115,65+,1392,1120,2512
16962,29117,15-19,437,428,865
16963,29117,20-24,461,334,795
16964,29117,25-29,556,417,973
16965,29117,30-34,596,387,983
16966,29117,35-39,583,393,976
16967,29117,40-44,570,387,957
16968,29117,45-49,518,373,891
16969,29117,50-54,465,385,850
16970,29117,55-59,469,411,880
16971,29117,60-64,494,453,947
16972,29117,65+,1652,1299,2951
16973,29119,15-19,746,841,1587
16974,29119,20-24,628,660,1288
16975,29119,25-29,648,707,1355
16976,29119,30-34,675,703,1378
16977,29119,35-39,650,709,1359
16978,29119,40-44,755,701,1456
16979,29119,45-49,700,725,1425
16980,29119,50-54,784,815,1599
16981,29119,55-59,822,855,1677
16982,29119,60-64,812,833,1645
16983,29119,65+,1895,1816,3711
16984,29121,15-19,496,522,1018
16985,29121,20-24,379,419,798
16986,29121,25-29,423,410,833
16987,29121,30-34,380,389,769
16988,29121,35-39,403,391,794
16989,29121,40-44,433,420,853
16990,29121,45-49,399,442,841
16991,29121,50-54,478,493,971
16992,29121,55-59,465,509,974
16993,29121,60-64,538,536,1074
16994,29121,65+,1846,1580,3426
16995,29123,15-19,365,409,774
16996,29123,20-24,310,333,643
16997,29123,25-29,349,368,717
16998,29123,30-34,387,364,751
16999,29123,35-39,363,361,724
17000,29123,40-44,398,401,799
17001,29123,45-49,358,374,732
17002,29123,50-54,424,398,822
17003,29123,55-59,452,445,897
17004,29123,60-64,478,467,945
17005,29123,65+,1318,1129,2447
17006,29125,15-19,259,250,509
17007,29125,20-24,205,230,435
17008,29125,25-29,225,225,450
17009,29125,30-34,214,225,439
17010,29125,35-39,256,221,477
17011,29125,40-44,225,248,473
17012,29125,45-49,239,253,492
17013,29125,50-54,302,276,578
17014,29125,55-59,322,361,683
17015,29125,60-64,331,333,664
17016,29125,65+,965,858,1823
17017,29127,15-19,941,950,1891
17018,29127,20-24,906,979,1885
17019,29127,25-29,836,820,1656
17020,29127,30-34,887,811,1698
17021,29127,35-39,887,921,1808
17022,29127,40-44,831,845,1676
17023,29127,45-49,788,828,1616
17024,29127,50-54,869,864,1733
17025,29127,55-59,945,903,1848
17026,29127,60-64,979,964,1943
17027,29127,65+,2939,2342,5281
17028,29129,15-19,104,118,222
17029,29129,20-24,84,94,178
17030,29129,25-29,86,88,174
17031,29129,30-34,74,78,152
17032,29129,35-39,81,89,170
17033,29129,40-44,101,81,182
17034,29129,45-49,89,96,185
17035,29129,50-54,101,103,204
17036,29129,55-59,132,113,245
17037,29129,60-64,140,142,282
17038,29129,65+,417,388,805
17039,29131,15-19,732,794,1526
17040,29131,20-24,623,706,1329
17041,29131,25-29,707,653,1360
17042,29131,30-34,772,733,1505
17043,29131,35-39,730,812,1542
17044,29131,40-44,716,711,1427
17045,29131,45-49,686,679,1365
17046,29131,50-54,706,823,1529
17047,29131,55-59,862,867,1729
17048,29131,60-64,914,878,1792
17049,29131,65+,2586,2293,4879
17050,29133,15-19,345,415,760
17051,29133,20-24,295,446,741
17052,29133,25-29,328,541,869
17053,29133,30-34,323,495,818
17054,29133,35-39,327,475,802
17055,29133,40-44,331,480,811
17056,29133,45-49,337,448,785
17057,29133,50-54,347,487,834
17058,29133,55-59,405,434,839
17059,29133,60-64,399,368,767
17060,29133,65+,1263,1026,2289
17061,29135,15-19,486,516,1002
17062,29135,20-24,398,471,869
17063,29135,25-29,392,525,917
17064,29135,30-34,441,548,989
17065,29135,35-39,443,602,1045
17066,29135,40-44,465,592,1057
17067,29135,45-49,436,528,964
17068,29135,50-54,426,503,929
17069,29135,55-59,487,547,1034
17070,29135,60-64,465,486,951
17071,29135,65+,1350,1166,2516
17072,29137,15-19,249,259,508
17073,29137,20-24,199,227,426
17074,29137,25-29,209,194,403
17075,29137,30-34,210,223,433
17076,29137,35-39,232,242,474
17077,29137,40-44,216,248,464
17078,29137,45-49,209,231,440
17079,29137,50-54,237,259,496
17080,29137,55-59,303,346,649
17081,29137,60-64,378,362,740
17082,29137,65+,1073,1014,2087
17083,29139,15-19,322,402,724
17084,29139,20-24,268,314,582
17085,29139,25-29,296,306,602
17086,29139,30-34,309,345,654
17087,29139,35-39,327,330,657
17088,29139,40-44,347,330,677
17089,29139,45-49,299,338,637
17090,29139,50-54,337,353,690
17091,29139,55-59,430,464,894
17092,29139,60-64,474,467,941
17093,29139,65+,1251,1081,2332
17094,29141,15-19,597,648,1245
17095,29141,20-24,482,549,1031
17096,29141,25-29,536,533,1069
17097,29141,30-34,558,582,1140
17098,29141,35-39,508,527,1035
17099,29141,40-44,496,544,1040
17100,29141,45-49,496,518,1014
17101,29141,50-54,610,634,1244
17102,29141,55-59,825,816,1641
17103,29141,60-64,895,913,1808
17104,29141,65+,2547,2515,5062
17105,29143,15-19,469,492,961
17106,29143,20-24,430,385,815
17107,29143,25-29,443,433,876
17108,29143,30-34,474,447,921
17109,29143,35-39,468,409,877
17110,29143,40-44,474,440,914
17111,29143,45-49,519,493,1012
17112,29143,50-54,511,488,999
17113,29143,55-59,618,537,1155
17114,29143,60-64,615,549,1164
17115,29143,65+,1808,1387,3195
17116,29145,15-19,1887,2024,3911
17117,29145,20-24,1585,1771,3356
17118,29145,25-29,1704,1817,3521
17119,29145,30-34,1766,1819,3585
17120,29145,35-39,1742,1727,3469
17121,29145,40-44,1744,1791,3535
17122,29145,45-49,1664,1679,3343
17123,29145,50-54,1892,1886,3778
17124,29145,55-59,2029,2096,4125
17125,29145,60-64,2057,2005,4062
17126,29145,65+,6023,5069,11092
17127,29147,15-19,1397,1107,2504
17128,29147,20-24,2154,2091,4245
17129,29147,25-29,525,662,1187
17130,29147,30-34,423,590,1013
17131,29147,35-39,488,535,1023
17132,29147,40-44,473,563,1036
17133,29147,45-49,424,461,885
17134,29147,50-54,456,459,915
17135,29147,55-59,579,588,1167
17136,29147,60-64,544,569,1113
17137,29147,65+,1844,1515,3359
17138,29149,15-19,271,274,545
17139,29149,20-24,190,192,382
17140,29149,25-29,219,237,456
17141,29149,30-34,230,212,442
17142,29149,35-39,216,203,419
17143,29149,40-44,224,219,443
17144,29149,45-49,232,235,467
17145,29149,50-54,270,262,532
17146,29149,55-59,327,334,661
17147,29149,60-64,340,344,684
17148,29149,65+,1039,945,1984
17149,29151,15-19,439,537,976
17150,29151,20-24,362,425,787
17151,29151,25-29,367,407,774
17152,29151,30-34,343,402,745
17153,29151,35-39,374,396,770
17154,29151,40-44,388,437,825
17155,29151,45-49,371,406,777
17156,29151,50-54,439,454,893
17157,29151,55-59,455,523,978
17158,29151,60-64,489,514,1003
17159,29151,65+,1256,1146,2402
17160,29153,15-19,232,246,478
17161,29153,20-24,165,163,328
17162,29153,25-29,168,183,351
17163,29153,30-34,188,182,370
17164,29153,35-39,230,218,448
17165,29153,40-44,222,233,455
17166,29153,45-49,220,219,439
17167,29153,50-54,249,273,522
17168,29153,55-59,326,319,645
17169,29153,60-64,428,419,847
17170,29153,65+,1235,1285,2520
17171,29155,15-19,450,529,979
17172,29155,20-24,431,438,869
17173,29155,25-29,437,392,829
17174,29155,30-34,507,393,900
17175,29155,35-39,485,396,881
17176,29155,40-44,481,408,889
17177,29155,45-49,424,411,835
17178,29155,50-54,488,432,920
17179,29155,55-59,545,495,1040
17180,29155,60-64,565,477,1042
17181,29155,65+,1528,1191,2719
17182,29157,15-19,575,662,1237
17183,29157,20-24,497,553,1050
17184,29157,25-29,560,526,1086
17185,29157,30-34,540,533,1073
17186,29157,35-39,534,565,1099
17187,29157,40-44,574,614,1188
17188,29157,45-49,562,534,1096
17189,29157,50-54,606,626,1232
17190,29157,55-59,656,707,1363
17191,29157,60-64,668,632,1300
17192,29157,65+,1972,1723,3695
17193,29159,15-19,1337,1488,2825
17194,29159,20-24,1279,1347,2626
17195,29159,25-29,1335,1283,2618
17196,29159,30-34,1407,1373,2780
17197,29159,35-39,1411,1428,2839
17198,29159,40-44,1275,1351,2626
17199,29159,45-49,1191,1195,2386
17200,29159,50-54,1127,1250,2377
17201,29159,55-59,1447,1351,2798
17202,29159,60-64,1409,1438,2847
17203,29159,65+,4022,3370,7392
17204,29161,15-19,1526,2317,3843
17205,29161,20-24,1834,3342,5176
17206,29161,25-29,1189,1448,2637
17207,29161,30-34,1237,1244,2481
17208,29161,35-39,1301,1335,2636
17209,29161,40-44,1262,1281,2543
17210,29161,45-49,1065,1142,2207
17211,29161,50-54,1204,1199,2403
17212,29161,55-59,1380,1296,2676
17213,29161,60-64,1458,1422,2880
17214,29161,65+,4126,3499,7625
17215,29163,15-19,489,602,1091
17216,29163,20-24,400,556,956
17217,29163,25-29,446,698,1144
17218,29163,30-34,490,707,1197
17219,29163,35-39,479,634,1113
17220,29163,40-44,478,608,1086
17221,29163,45-49,416,639,1055
17222,29163,50-54,464,609,1073
17223,29163,55-59,523,612,1135
17224,29163,60-64,603,638,1241
17225,29163,65+,1790,1520,3310
17226,29165,15-19,3353,3550,6903
17227,29165,20-24,3144,3063,6207
17228,29165,25-29,3462,3404,6866
17229,29165,30-34,3594,3619,7213
17230,29165,35-39,4013,3845,7858
17231,29165,40-44,3906,3990,7896
17232,29165,45-49,3426,3523,6949
17233,29165,50-54,3557,3523,7080
17234,29165,55-59,3501,3561,7062
17235,29165,60-64,3460,3289,6749
17236,29165,65+,9136,7846,16982
17237,29167,15-19,1200,1294,2494
17238,29167,20-24,1401,1312,2713
17239,29167,25-29,912,984,1896
17240,29167,30-34,890,900,1790
17241,29167,35-39,905,915,1820
17242,29167,40-44,861,865,1726
17243,29167,45-49,819,862,1681
17244,29167,50-54,904,939,1843
17245,29167,55-59,1106,1077,2183
17246,29167,60-64,1070,1028,2098
17247,29167,65+,3087,2574,5661
17248,29169,15-19,1745,4247,5992
17249,29169,20-24,2060,5106,7166
17250,29169,25-29,1999,2839,4838
17251,29169,30-34,2139,2489,4628
17252,29169,35-39,1718,2080,3798
17253,29169,40-44,1437,1605,3042
17254,29169,45-49,1148,1165,2313
17255,29169,50-54,1101,1097,2198
17256,29169,55-59,1196,1162,2358
17257,29169,60-64,1109,1072,2181
17258,29169,65+,2738,2345,5083
17259,29171,15-19,137,142,279
17260,29171,20-24,110,123,233
17261,29171,25-29,111,119,230
17262,29171,30-34,118,118,236
17263,29171,35-39,119,126,245
17264,29171,40-44,114,136,250
17265,29171,45-49,114,128,242
17266,29171,50-54,136,153,289
17267,29171,55-59,154,175,329
17268,29171,60-64,165,179,344
17269,29171,65+,597,540,1137
17270,29173,15-19,291,309,600
17271,29173,20-24,212,240,452
17272,29173,25-29,266,267,533
17273,29173,30-34,276,247,523
17274,29173,35-39,261,290,551
17275,29173,40-44,313,316,629
17276,29173,45-49,310,326,636
17277,29173,50-54,339,357,696
17278,29173,55-59,416,408,824
17279,29173,60-64,402,431,833
17280,29173,65+,1210,1150,2360
17281,29175,15-19,731,788,1519
17282,29175,20-24,688,921,1609
17283,29175,25-29,744,1010,1754
17284,29175,30-34,707,1006,1713
17285,29175,35-39,699,917,1616
17286,29175,40-44,713,926,1639
17287,29175,45-49,645,876,1521
17288,29175,50-54,751,851,1602
17289,29175,55-59,770,860,1630
17290,29175,60-64,785,764,1549
17291,29175,65+,2343,1871,4214
17292,29177,15-19,648,743,1391
17293,29177,20-24,580,634,1214
17294,29177,25-29,594,642,1236
17295,29177,30-34,667,667,1334
17296,29177,35-39,648,674,1322
17297,29177,40-44,727,721,1448
17298,29177,45-49,664,693,1357
17299,29177,50-54,730,764,1494
17300,29177,55-59,835,891,1726
17301,29177,60-64,893,914,1807
17302,29177,65+,2395,2010,4405
17303,29179,15-19,156,221,377
17304,29179,20-24,122,155,277
17305,29179,25-29,137,150,287
17306,29179,30-34,146,160,306
17307,29179,35-39,171,167,338
17308,29179,40-44,161,177,338
17309,29179,45-49,202,183,385
17310,29179,50-54,186,204,390
17311,29179,55-59,227,258,485
17312,29179,60-64,250,276,526
17313,29179,65+,708,718,1426
17314,29181,15-19,287,328,615
17315,29181,20-24,255,255,510
17316,29181,25-29,278,284,562
17317,29181,30-34,349,304,653
17318,29181,35-39,280,318,598
17319,29181,40-44,306,290,596
17320,29181,45-49,290,328,618
17321,29181,50-54,305,333,638
17322,29181,55-59,388,366,754
17323,29181,60-64,398,390,788
17324,29181,65+,1150,1004,2154
17325,29183,15-19,13024,13727,26751
17326,29183,20-24,11765,12262,24027
17327,29183,25-29,12012,12433,24445
17328,29183,30-34,13426,13297,26723
17329,29183,35-39,14722,15005,29727
17330,29183,40-44,13899,14217,28116
17331,29183,45-49,12398,12468,24866
17332,29183,50-54,13209,12996,26205
17333,29183,55-59,14300,13848,28148
17334,29183,60-64,14295,13741,28036
17335,29183,65+,36792,29983,66775
17336,29185,15-19,248,288,536
17337,29185,20-24,169,219,388
17338,29185,25-29,234,215,449
17339,29185,30-34,201,253,454
17340,29185,35-39,245,243,488
17341,29185,40-44,223,233,456
17342,29185,45-49,253,246,499
17343,29185,50-54,293,293,586
17344,29185,55-59,332,352,684
17345,29185,60-64,375,413,788
17346,29185,65+,1257,1204,2461
17347,29186,15-19,488,559,1047
17348,29186,20-24,447,483,930
17349,29186,25-29,486,519,1005
17350,29186,30-34,507,521,1028
17351,29186,35-39,508,559,1067
17352,29186,40-44,514,559,1073
17353,29186,45-49,496,519,1015
17354,29186,50-54,557,552,1109
17355,29186,55-59,698,742,1440
17356,29186,60-64,746,840,1586
17357,29186,65+,1979,1908,3887
17358,29187,15-19,1916,2038,3954
17359,29187,20-24,1726,2407,4133
17360,29187,25-29,1893,2842,4735
17361,29187,30-34,2034,2806,4840
17362,29187,35-39,2019,2684,4703
17363,29187,40-44,2002,2615,4617
17364,29187,45-49,1873,2418,4291
17365,29187,50-54,1980,2386,4366
17366,29187,55-59,2087,2353,4440
17367,29187,60-64,2155,2215,4370
17368,29187,65+,6183,5224,11407
17369,29189,15-19,30885,31825,62710
17370,29189,20-24,29440,28892,58332
17371,29189,25-29,32030,31087,63117
17372,29189,30-34,32866,30432,63298
17373,29189,35-39,33616,31842,65458
17374,29189,40-44,31968,29603,61571
17375,29189,45-49,29720,26576,56296
17376,29189,50-54,31927,29014,60941
17377,29189,55-59,35198,31499,66697
17378,29189,60-64,36945,32936,69881
17379,29189,65+,107358,80276,187634
17380,29195,15-19,812,978,1790
17381,29195,20-24,768,986,1754
17382,29195,25-29,646,682,1328
17383,29195,30-34,676,636,1312
17384,29195,35-39,703,663,1366
17385,29195,40-44,604,715,1319
17386,29195,45-49,655,662,1317
17387,29195,50-54,680,690,1370
17388,29195,55-59,742,765,1507
17389,29195,60-64,812,767,1579
17390,29195,65+,2364,1997,4361
17391,29197,15-19,119,114,233
17392,29197,20-24,115,114,229
17393,29197,25-29,119,123,242
17394,29197,30-34,111,127,238
17395,29197,35-39,90,102,192
17396,29197,40-44,112,93,205
17397,29197,45-49,97,105,202
17398,29197,50-54,115,109,224
17399,29197,55-59,125,148,273
17400,29197,60-64,151,143,294
17401,29197,65+,419,355,774
17402,29199,15-19,154,165,319
17403,29199,20-24,127,137,264
17404,29199,25-29,135,142,277
17405,29199,30-34,124,124,248
17406,29199,35-39,110,123,233
17407,29199,40-44,129,123,252
17408,29199,45-49,107,131,238
17409,29199,50-54,102,112,214
17410,29199,55-59,152,146,298
17411,29199,60-64,155,140,295
17412,29199,65+,492,421,913
17413,29201,15-19,1129,1258,2387
17414,29201,20-24,1036,1003,2039
17415,29201,25-29,1207,1151,2358
17416,29201,30-34,1225,1151,2376
17417,29201,35-39,1170,1102,2272
17418,29201,40-44,1130,1072,2202
17419,29201,45-49,1095,1045,2140
17420,29201,50-54,1210,1155,2365
17421,29201,55-59,1293,1253,2546
17422,29201,60-64,1257,1183,2440
17423,29201,65+,4012,3116,7128
17424,29203,15-19,178,226,404
17425,29203,20-24,157,152,309
17426,29203,25-29,186,169,355
17427,29203,30-34,190,220,410
17428,29203,35-39,174,208,382
17429,29203,40-44,174,180,354
17430,29203,45-49,192,197,389
17431,29203,50-54,203,241,444
17432,29203,55-59,267,271,538
17433,29203,60-64,303,304,607
17434,29203,65+,857,764,1621
17435,29205,15-19,165,212,377
17436,29205,20-24,131,123,254
17437,29205,25-29,165,156,321
17438,29205,30-34,154,151,305
17439,29205,35-39,172,181,353
17440,29205,40-44,167,205,372
17441,29205,45-49,147,150,297
17442,29205,50-54,144,153,297
17443,29205,55-59,214,217,431
17444,29205,60-64,209,236,445
17445,29205,65+,708,625,1333
17446,29207,15-19,824,962,1786
17447,29207,20-24,711,823,1534
17448,29207,25-29,808,825,1633
17449,29207,30-34,833,847,1680
17450,29207,35-39,868,853,1721
17451,29207,40-44,880,864,1744
17452,29207,45-49,828,876,1704
17453,29207,50-54,872,941,1813
17454,29207,55-59,994,986,1980
17455,29207,60-64,1017,955,1972
17456,29207,65+,3215,2580,5795
17457,29209,15-19,703,806,1509
17458,29209,20-24,615,672,1287
17459,29209,25-29,577,629,1206
17460,29209,30-34,647,614,1261
17461,29209,35-39,720,709,1429
17462,29209,40-44,733,741,1474
17463,29209,45-49,876,773,1649
17464,29209,50-54,989,938,1927
17465,29209,55-59,1327,1189,2516
17466,29209,60-64,1573,1468,3041
17467,29209,65+,5129,4885,10014
17468,29211,15-19,173,185,358
17469,29211,20-24,147,173,320
17470,29211,25-29,178,160,338
17471,29211,30-34,147,155,302
17472,29211,35-39,139,146,285
17473,29211,40-44,165,175,340
17474,29211,45-49,179,189,368
17475,29211,50-54,216,202,418
17476,29211,55-59,205,222,427
17477,29211,60-64,176,253,429
17478,29211,65+,638,567,1205
17479,29213,15-19,1813,1869,3682
17480,29213,20-24,1830,1806,3636
17481,29213,25-29,1577,1583,3160
17482,29213,30-34,1494,1420,2914
17483,29213,35-39,1605,1431,3036
17484,29213,40-44,1678,1550,3228
17485,29213,45-49,1582,1527,3109
17486,29213,50-54,1697,1586,3283
17487,29213,55-59,1930,1826,3756
17488,29213,60-64,2126,1930,4056
17489,29213,65+,6880,5960,12840
17490,29215,15-19,648,813,1461
17491,29215,20-24,543,840,1383
17492,29215,25-29,587,828,1415
17493,29215,30-34,626,826,1452
17494,29215,35-39,663,871,1534
17495,29215,40-44,695,805,1500
17496,29215,45-49,602,784,1386
17497,29215,50-54,697,827,1524
17498,29215,55-59,862,918,1780
17499,29215,60-64,890,933,1823
17500,29215,65+,2830,2482,5312
17501,29217,15-19,771,655,1426
17502,29217,20-24,599,510,1109
17503,29217,25-29,548,553,1101
17504,29217,30-34,517,561,1078
17505,29217,35-39,528,505,1033
17506,29217,40-44,546,573,1119
17507,29217,45-49,560,518,1078
17508,29217,50-54,584,596,1180
17509,29217,55-59,657,703,1360
17510,29217,60-64,710,642,1352
17511,29217,65+,2148,1832,3980
17512,29219,15-19,1116,1159,2275
17513,29219,20-24,957,1020,1977
17514,29219,25-29,1063,1091,2154
17515,29219,30-34,1131,1247,2378
17516,29219,35-39,1102,1091,2193
17517,29219,40-44,1078,1061,2139
17518,29219,45-49,934,999,1933
17519,29219,50-54,1138,1124,2262
17520,29219,55-59,1387,1392,2779
17521,29219,60-64,1406,1411,2817
17522,29219,65+,3452,3183,6635
17523,29221,15-19,715,742,1457
17524,29221,20-24,574,657,1231
17525,29221,25-29,660,727,1387
17526,29221,30-34,655,779,1434
17527,29221,35-39,649,796,1445
17528,29221,40-44,682,760,1442
17529,29221,45-49,707,839,1546
17530,29221,50-54,723,868,1591
17531,29221,55-59,833,913,1746
17532,29221,60-64,849,852,1701
17533,29221,65+,2120,2022,4142
17534,29223,15-19,285,318,603
17535,29223,20-24,244,252,496
17536,29223,25-29,237,251,488
17537,29223,30-34,289,265,554
17538,29223,35-39,306,283,589
17539,29223,40-44,265,318,583
17540,29223,45-49,296,291,587
17541,29223,50-54,359,341,700
17542,29223,55-59,466,473,939
17543,29223,60-64,476,445,921
17544,29223,65+,1372,1288,2660
17545,29225,15-19,1288,1427,2715
17546,29225,20-24,1001,1177,2178
17547,29225,25-29,1134,1248,2382
17548,29225,30-34,1175,1282,2457
17549,29225,35-39,1188,1261,2449
17550,29225,40-44,1118,1253,2371
17551,29225,45-49,1087,1198,2285
17552,29225,50-54,1238,1256,2494
17553,29225,55-59,1255,1311,2566
17554,29225,60-64,1252,1278,2530
17555,29225,65+,3280,2944,6224
17556,29227,15-19,48,56,104
17557,29227,20-24,39,55,94
17558,29227,25-29,55,45,100
17559,29227,30-34,60,42,102
17560,29227,35-39,44,56,100
17561,29227,40-44,48,63,111
17562,29227,45-49,30,45,75
17563,29227,50-54,62,59,121
17564,29227,55-59,72,88,160
17565,29227,60-64,86,91,177
17566,29227,65+,282,241,523
17567,29229,15-19,677,643,1320
17568,29229,20-24,417,459,876
17569,29229,25-29,478,479,957
17570,29229,30-34,524,554,1078
17571,29229,35-39,539,545,1084
17572,29229,40-44,549,487,1036
17573,29229,45-49,511,481,992
17574,29229,50-54,536,540,1076
17575,29229,55-59,600,588,1188
17576,29229,60-64,699,651,1350
17577,29229,65+,1978,1723,3701
17578,29510,15-19,7338,7389,14727
17579,29510,20-24,9605,8736,18341
17580,29510,25-29,15129,14073,29202
17581,29510,30-34,14727,14264,28991
17582,29510,35-39,11493,11563,23056
17583,29510,40-44,9483,9282,18765
17584,29510,45-49,8217,7784,16001
17585,29510,50-54,8233,8139,16372
17586,29510,55-59,9109,9147,18256
17587,29510,60-64,10021,9293,19314
17588,29510,65+,24761,19384,44145
17589,30001,15-19,340,378,718
17590,30001,20-24,460,447,907
17591,30001,25-29,249,300,549
17592,30001,30-34,260,244,504
17593,30001,35-39,272,281,553
17594,30001,40-44,239,278,517
17595,30001,45-49,208,247,455
17596,30001,50-54,235,237,472
17597,30001,55-59,297,301,598
17598,30001,60-64,353,382,735
17599,30001,65+,1095,1143,2238
17600,30003,15-19,545,556,1101
17601,30003,20-24,375,374,749
17602,30003,25-29,366,349,715
17603,30003,30-34,439,384,823
17604,30003,35-39,371,357,728
17605,30003,40-44,370,342,712
17606,30003,45-49,314,268,582
17607,30003,50-54,370,298,668
17608,30003,55-59,389,373,762
17609,30003,60-64,387,359,746
17610,30003,65+,915,869,1784
17611,30005,15-19,289,269,558
17612,30005,20-24,190,204,394
17613,30005,25-29,195,211,406
17614,30005,30-34,208,237,445
17615,30005,35-39,215,194,409
17616,30005,40-44,186,222,408
17617,30005,45-49,148,186,334
17618,30005,50-54,170,135,305
17619,30005,55-59,206,215,421
17620,30005,60-64,229,242,471
17621,30005,65+,595,500,1095
17622,30007,15-19,185,170,355
17623,30007,20-24,148,163,311
17624,30007,25-29,186,204,390
17625,30007,30-34,193,200,393
17626,30007,35-39,199,229,428
17627,30007,40-44,198,216,414
17628,30007,45-49,193,218,411
17629,30007,50-54,238,243,481
17630,30007,55-59,294,275,569
17631,30007,60-64,303,344,647
17632,30007,65+,806,905,1711
17633,30009,15-19,267,270,537
17634,30009,20-24,187,219,406
17635,30009,25-29,228,235,463
17636,30009,30-34,252,252,504
17637,30009,35-39,299,316,615
17638,30009,40-44,351,353,704
17639,30009,45-49,298,319,617
17640,30009,50-54,317,379,696
17641,30009,55-59,403,419,822
17642,30009,60-64,510,561,1071
17643,30009,65+,1430,1479,2909
17644,30011,15-19,23,39,62
17645,30011,20-24,27,20,47
17646,30011,25-29,34,38,72
17647,30011,30-34,43,43,86
17648,30011,35-39,38,49,87
17649,30011,40-44,36,38,74
17650,30011,45-49,24,19,43
17651,30011,50-54,34,28,62
17652,30011,55-59,59,49,108
17653,30011,60-64,54,74,128
17654,30011,65+,196,197,393
17655,30013,15-19,2298,2660,4958
17656,30013,20-24,2482,3238,5720
17657,30013,25-29,2820,3173,5993
17658,30013,30-34,2853,2991,5844
17659,30013,35-39,2613,2835,5448
17660,30013,40-44,2324,2474,4798
17661,30013,45-49,1986,2098,4084
17662,30013,50-54,2171,2249,4420
17663,30013,55-59,2630,2575,5205
17664,30013,60-64,2919,2772,5691
17665,30013,65+,8768,7569,16337
17666,30015,15-19,217,213,430
17667,30015,20-24,137,173,310
17668,30015,25-29,134,160,294
17669,30015,30-34,182,165,347
17670,30015,35-39,176,182,358
17671,30015,40-44,169,167,336
17672,30015,45-49,162,172,334
17673,30015,50-54,150,177,327
17674,30015,55-59,189,174,363
17675,30015,60-64,243,249,492
17676,30015,65+,666,652,1318
17677,30017,15-19,321,447,768
17678,30017,20-24,296,357,653
17679,30017,25-29,387,356,743
17680,30017,30-34,345,343,688
17681,30017,35-39,406,412,818
17682,30017,40-44,348,409,757
17683,30017,45-49,352,303,655
17684,30017,50-54,355,353,708
17685,30017,55-59,398,440,838
17686,30017,60-64,457,473,930
17687,30017,65+,1311,1108,2419
17688,30019,15-19,44,48,92
17689,30019,20-24,39,38,77
17690,30019,25-29,40,42,82
17691,30019,30-34,36,48,84
17692,30019,35-39,49,47,96
17693,30019,40-44,40,62,102
17694,30019,45-49,36,37,73
17695,30019,50-54,38,36,74
17696,30019,55-59,44,59,103
17697,30019,60-64,76,77,153
17698,30019,65+,235,221,456
17699,30021,15-19,264,317,581
17700,30021,20-24,237,285,522
17701,30021,25-29,244,297,541
17702,30021,30-34,268,266,534
17703,30021,35-39,237,300,537
17704,30021,40-44,226,292,518
17705,30021,45-49,220,266,486
17706,30021,50-54,226,276,502
17707,30021,55-59,277,280,557
17708,30021,60-64,334,350,684
17709,30021,65+,951,891,1842
17710,30023,15-19,192,320,512
17711,30023,20-24,182,335,517
17712,30023,25-29,239,296,535
17713,30023,30-34,257,351,608
17714,30023,35-39,224,316,540
17715,30023,40-44,257,311,568
17716,30023,45-49,269,318,587
17717,30023,50-54,308,355,663
17718,30023,55-59,356,374,730
17719,30023,60-64,420,424,844
17720,30023,65+,1207,1221,2428
17721,30025,15-19,112,84,196
17722,30025,20-24,57,81,138
17723,30025,25-29,90,88,178
17724,30025,30-34,69,101,170
17725,30025,35-39,96,101,197
17726,30025,40-44,85,100,185
17727,30025,45-49,76,79,155
17728,30025,50-54,77,84,161
17729,30025,55-59,79,91,170
17730,30025,60-64,122,119,241
17731,30025,65+,297,267,564
17732,30027,15-19,278,336,614
17733,30027,20-24,236,263,499
17734,30027,25-29,298,326,624
17735,30027,30-34,311,345,656
17736,30027,35-39,340,335,675
17737,30027,40-44,373,359,732
17738,30027,45-49,282,314,596
17739,30027,50-54,304,318,622
17740,30027,55-59,391,389,780
17741,30027,60-64,451,470,921
17742,30027,65+,1459,1413,2872
17743,30029,15-19,2880,3295,6175
17744,30029,20-24,2536,2679,5215
17745,30029,25-29,3230,3181,6411
17746,30029,30-34,3463,3462,6925
17747,30029,35-39,3552,3548,7100
17748,30029,40-44,3507,3602,7109
17749,30029,45-49,3014,3184,6198
17750,30029,50-54,3176,3264,6440
17751,30029,55-59,3607,3493,7100
17752,30029,60-64,4277,3925,8202
17753,30029,65+,11489,10720,22209
17754,30031,15-19,4030,4382,8412
17755,30031,20-24,6551,8059,14610
17756,30031,25-29,4828,6161,10989
17757,30031,30-34,4433,4969,9402
17758,30031,35-39,4349,4774,9123
17759,30031,40-44,3932,4484,8416
17760,30031,45-49,3242,3598,6840
17761,30031,50-54,2906,3244,6150
17762,30031,55-59,3035,3131,6166
17763,30031,60-64,3316,3344,6660
17764,30031,65+,8344,7974,16318
17765,30033,15-19,40,33,73
17766,30033,20-24,29,33,62
17767,30033,25-29,23,32,55
17768,30033,30-34,33,25,58
17769,30033,35-39,37,34,71
17770,30033,40-44,35,47,82
17771,30033,45-49,28,33,61
17772,30033,50-54,42,31,73
17773,30033,55-59,43,31,74
17774,30033,60-64,40,42,82
17775,30033,65+,130,161,291
17776,30035,15-19,539,595,1134
17777,30035,20-24,426,453,879
17778,30035,25-29,434,395,829
17779,30035,30-34,490,443,933
17780,30035,35-39,471,435,906
17781,30035,40-44,405,390,795
17782,30035,45-49,322,343,665
17783,30035,50-54,354,316,670
17784,30035,55-59,437,372,809
17785,30035,60-64,452,415,867
17786,30035,65+,963,802,1765
17787,30037,15-19,20,25,45
17788,30037,20-24,16,8,24
17789,30037,25-29,28,25,53
17790,30037,30-34,14,22,36
17791,30037,35-39,25,21,46
17792,30037,40-44,29,19,48
17793,30037,45-49,11,12,23
17794,30037,50-54,19,23,42
17795,30037,55-59,33,24,57
17796,30037,60-64,33,39,72
17797,30037,65+,131,119,250
17798,30039,15-19,60,78,138
17799,30039,20-24,72,65,137
17800,30039,25-29,71,84,155
17801,30039,30-34,74,82,156
17802,30039,35-39,73,96,169
17803,30039,40-44,109,85,194
17804,30039,45-49,76,100,176
17805,30039,50-54,87,91,178
17806,30039,55-59,115,149,264
17807,30039,60-64,184,174,358
17808,30039,65+,486,535,1021
17809,30041,15-19,552,629,1181
17810,30041,20-24,498,518,1016
17811,30041,25-29,507,531,1038
17812,30041,30-34,499,566,1065
17813,30041,35-39,502,523,1025
17814,30041,40-44,457,473,930
17815,30041,45-49,398,412,810
17816,30041,50-54,391,396,787
17817,30041,55-59,416,469,885
17818,30041,60-64,551,522,1073
17819,30041,65+,1277,1226,2503
17820,30043,15-19,364,375,739
17821,30043,20-24,234,284,518
17822,30043,25-29,259,263,522
17823,30043,30-34,304,344,648
17824,30043,35-39,346,357,703
17825,30043,40-44,393,390,783
17826,30043,45-49,364,404,768
17827,30043,50-54,429,430,859
17828,30043,55-59,504,488,992
17829,30043,60-64,538,539,1077
17830,30043,65+,1422,1483,2905
17831,30045,15-19,48,57,105
17832,30045,20-24,29,39,68
17833,30045,25-29,42,48,90
17834,30045,30-34,48,46,94
17835,30045,35-39,53,47,100
17836,30045,40-44,54,49,103
17837,30045,45-49,49,50,99
17838,30045,50-54,43,62,105
17839,30045,55-59,84,78,162
17840,30045,60-64,89,100,189
17841,30045,65+,289,302,591
17842,30047,15-19,1003,1060,2063
17843,30047,20-24,800,862,1662
17844,30047,25-29,805,855,1660
17845,30047,30-34,905,857,1762
17846,30047,35-39,894,906,1800
17847,30047,40-44,949,855,1804
17848,30047,45-49,849,783,1632
17849,30047,50-54,907,808,1715
17850,30047,55-59,1055,973,2028
17851,30047,60-64,1355,1149,2504
17852,30047,65+,3804,3683,7487
17853,30049,15-19,2121,2138,4259
17854,30049,20-24,1895,2001,3896
17855,30049,25-29,2123,2113,4236
17856,30049,30-34,2360,2311,4671
17857,30049,35-39,2536,2573,5109
17858,30049,40-44,2187,2341,4528
17859,30049,45-49,1980,1968,3948
17860,30049,50-54,2144,2115,4259
17861,30049,55-59,2517,2406,4923
17862,30049,60-64,2791,2587,5378
17863,30049,65+,7417,6830,14247
17864,30051,15-19,43,56,99
17865,30051,20-24,48,49,97
17866,30051,25-29,65,56,121
17867,30051,30-34,56,47,103
17868,30051,35-39,61,56,117
17869,30051,40-44,68,54,122
17870,30051,45-49,47,46,93
17871,30051,50-54,60,49,109
17872,30051,55-59,63,58,121
17873,30051,60-64,82,72,154
17874,30051,65+,234,221,455
17875,30053,15-19,586,537,1123
17876,30053,20-24,331,357,688
17877,30053,25-29,381,397,778
17878,30053,30-34,476,451,927
17879,30053,35-39,543,482,1025
17880,30053,40-44,532,564,1096
17881,30053,45-49,561,513,1074
17882,30053,50-54,586,585,1171
17883,30053,55-59,768,766,1534
17884,30053,60-64,962,983,1945
17885,30053,65+,2968,3165,6133
17886,30055,15-19,47,49,96
17887,30055,20-24,37,38,75
17888,30055,25-29,38,53,91
17889,30055,30-34,41,48,89
17890,30055,35-39,50,38,88
17891,30055,40-44,38,47,85
17892,30055,45-49,31,45,76
17893,30055,50-54,45,43,88
17894,30055,55-59,61,57,118
17895,30055,60-64,57,83,140
17896,30055,65+,239,244,483
17897,30057,15-19,201,187,388
17898,30057,20-24,140,209,349
17899,30057,25-29,194,225,419
17900,30057,30-34,240,261,501
17901,30057,35-39,253,297,550
17902,30057,40-44,218,259,477
17903,30057,45-49,191,244,435
17904,30057,50-54,241,274,515
17905,30057,55-59,325,321,646
17906,30057,60-64,402,409,811
17907,30057,65+,1280,1417,2697
17908,30059,15-19,51,61,112
17909,30059,20-24,32,36,68
17910,30059,25-29,36,39,75
17911,30059,30-34,44,42,86
17912,30059,35-39,48,50,98
17913,30059,40-44,49,55,104
17914,30059,45-49,50,51,101
17915,30059,50-54,42,48,90
17916,30059,55-59,71,70,141
17917,30059,60-64,94,89,183
17918,30059,65+,293,307,600
17919,30061,15-19,116,107,223
17920,30061,20-24,68,86,154
17921,30061,25-29,111,112,223
17922,30061,30-34,120,131,251
17923,30061,35-39,137,154,291
17924,30061,40-44,111,142,253
17925,30061,45-49,94,103,197
17926,30061,50-54,146,123,269
17927,30061,55-59,191,182,373
17928,30061,60-64,207,228,435
17929,30061,65+,678,727,1405
17930,30063,15-19,3710,3964,7674
17931,30063,20-24,6067,5970,12037
17932,30063,25-29,4907,4894,9801
17933,30063,30-34,4340,4680,9020
17934,30063,35-39,4223,4447,8670
17935,30063,40-44,3909,4113,8022
17936,30063,45-49,3099,3259,6358
17937,30063,50-54,3056,3347,6403
17938,30063,55-59,3392,3273,6665
17939,30063,60-64,3582,3355,6937
17940,30063,65+,10437,9559,19996
17941,30065,15-19,133,137,270
17942,30065,20-24,97,110,207
17943,30065,25-29,102,109,211
17944,30065,30-34,119,105,224
17945,30065,35-39,123,128,251
17946,30065,40-44,131,115,246
17947,30065,45-49,137,162,299
17948,30065,50-54,138,160,298
17949,30065,55-59,181,167,348
17950,30065,60-64,217,225,442
17951,30065,65+,687,686,1373
17952,30067,15-19,353,416,769
17953,30067,20-24,346,363,709
17954,30067,25-29,480,475,955
17955,30067,30-34,551,560,1111
17956,30067,35-39,568,620,1188
17957,30067,40-44,564,577,1141
17958,30067,45-49,547,507,1054
17959,30067,50-54,521,556,1077
17960,30067,55-59,633,637,1270
17961,30067,60-64,742,796,1538
17962,30067,65+,2154,2047,4201
17963,30069,15-19,10,9,19
17964,30069,20-24,9,11,20
17965,30069,25-29,14,11,25
17966,30069,30-34,9,14,23
17967,30069,35-39,11,19,30
17968,30069,40-44,10,8,18
17969,30069,45-49,9,10,19
17970,30069,50-54,24,19,43
17971,30069,55-59,24,30,54
17972,30069,60-64,27,31,58
17973,30069,65+,68,80,148
17974,30071,15-19,114,128,242
17975,30071,20-24,90,102,192
17976,30071,25-29,104,111,215
17977,30071,30-34,94,100,194
17978,30071,35-39,87,113,200
17979,30071,40-44,114,113,227
17980,30071,45-49,83,95,178
17981,30071,50-54,112,116,228
17982,30071,55-59,164,159,323
17983,30071,60-64,185,175,360
17984,30071,65+,520,470,990
17985,30073,15-19,196,186,382
17986,30073,20-24,159,166,325
17987,30073,25-29,173,154,327
17988,30073,30-34,174,175,349
17989,30073,35-39,159,189,348
17990,30073,40-44,170,148,318
17991,30073,45-49,148,163,311
17992,30073,50-54,154,158,312
17993,30073,55-59,212,197,409
17994,30073,60-64,240,217,457
17995,30073,65+,665,601,1266
17996,30075,15-19,28,44,72
17997,30075,20-24,43,31,74
17998,30075,25-29,39,53,92
17999,30075,30-34,41,47,88
18000,30075,35-39,35,39,74
18001,30075,40-44,34,44,78
18002,30075,45-49,37,30,67
18003,30075,50-54,55,42,97
18004,30075,55-59,70,75,145
18005,30075,60-64,78,94,172
18006,30075,65+,257,255,512
18007,30077,15-19,119,149,268
18008,30077,20-24,116,328,444
18009,30077,25-29,126,379,505
18010,30077,30-34,107,340,447
18011,30077,35-39,128,369,497
18012,30077,40-44,149,354,503
18013,30077,45-49,125,377,502
18014,30077,50-54,155,314,469
18015,30077,55-59,195,354,549
18016,30077,60-64,223,317,540
18017,30077,65+,669,762,1431
18018,30079,15-19,22,17,39
18019,30079,20-24,11,18,29
18020,30079,25-29,23,17,40
18021,30079,30-34,24,30,54
18022,30079,35-39,23,21,44
18023,30079,40-44,19,33,52
18024,30079,45-49,26,30,56
18025,30079,50-54,20,22,42
18026,30079,55-59,31,26,57
18027,30079,60-64,49,50,99
18028,30079,65+,186,189,375
18029,30081,15-19,1167,1359,2526
18030,30081,20-24,908,1085,1993
18031,30081,25-29,1007,1101,2108
18032,30081,30-34,1188,1147,2335
18033,30081,35-39,1230,1316,2546
18034,30081,40-44,1358,1330,2688
18035,30081,45-49,1170,1212,2382
18036,30081,50-54,1446,1341,2787
18037,30081,55-59,1721,1677,3398
18038,30081,60-64,2097,1918,4015
18039,30081,65+,6272,5985,12257
18040,30083,15-19,346,362,708
18041,30083,20-24,304,314,618
18042,30083,25-29,339,372,711
18043,30083,30-34,350,407,757
18044,30083,35-39,346,390,736
18045,30083,40-44,348,363,711
18046,30083,45-49,299,349,648
18047,30083,50-54,324,329,653
18048,30083,55-59,335,380,715
18049,30083,60-64,390,421,811
18050,30083,65+,876,975,1851
18051,30085,15-19,435,446,881
18052,30085,20-24,316,345,661
18053,30085,25-29,309,337,646
18054,30085,30-34,389,383,772
18055,30085,35-39,367,315,682
18056,30085,40-44,262,315,577
18057,30085,45-49,262,262,524
18058,30085,50-54,228,229,457
18059,30085,55-59,298,305,603
18060,30085,60-64,331,279,610
18061,30085,65+,696,583,1279
18062,30087,15-19,310,307,617
18063,30087,20-24,222,222,444
18064,30087,25-29,226,229,455
18065,30087,30-34,246,249,495
18066,30087,35-39,208,226,434
18067,30087,40-44,208,199,407
18068,30087,45-49,191,216,407
18069,30087,50-54,202,221,423
18070,30087,55-59,266,255,521
18071,30087,60-64,284,271,555
18072,30087,65+,698,674,1372
18073,30089,15-19,280,343,623
18074,30089,20-24,220,249,469
18075,30089,25-29,245,263,508
18076,30089,30-34,284,270,554
18077,30089,35-39,311,307,618
18078,30089,40-44,276,301,577
18079,30089,45-49,323,338,661
18080,30089,50-54,360,408,768
18081,30089,55-59,464,444,908
18082,30089,60-64,679,665,1344
18083,30089,65+,1995,2153,4148
18084,30091,15-19,89,101,190
18085,30091,20-24,69,87,156
18086,30091,25-29,79,88,167
18087,30091,30-34,84,92,176
18088,30091,35-39,105,121,226
18089,30091,40-44,116,97,213
18090,30091,45-49,91,99,190
18091,30091,50-54,100,77,177
18092,30091,55-59,135,141,276
18093,30091,60-64,122,167,289
18094,30091,65+,447,425,872
18095,30093,15-19,985,1096,2081
18096,30093,20-24,1348,1576,2924
18097,30093,25-29,1195,1244,2439
18098,30093,30-34,1012,1090,2102
18099,30093,35-39,983,1145,2128
18100,30093,40-44,978,1127,2105
18101,30093,45-49,889,916,1805
18102,30093,50-54,978,1021,1999
18103,30093,55-59,1112,1176,2288
18104,30093,60-64,1359,1307,2666
18105,30093,65+,3645,3207,6852
18106,30095,15-19,276,310,586
18107,30095,20-24,190,196,386
18108,30095,25-29,189,199,388
18109,30095,30-34,186,242,428
18110,30095,35-39,258,230,488
18111,30095,40-44,263,268,531
18112,30095,45-49,249,262,511
18113,30095,50-54,273,296,569
18114,30095,55-59,329,348,677
18115,30095,60-64,408,370,778
18116,30095,65+,1069,1141,2210
18117,30097,15-19,110,117,227
18118,30097,20-24,71,100,171
18119,30097,25-29,87,94,181
18120,30097,30-34,86,86,172
18121,30097,35-39,93,94,187
18122,30097,40-44,93,110,203
18123,30097,45-49,92,99,191
18124,30097,50-54,105,129,234
18125,30097,55-59,132,126,258
18126,30097,60-64,151,134,285
18127,30097,65+,529,520,1049
18128,30099,15-19,199,208,407
18129,30099,20-24,148,159,307
18130,30099,25-29,163,170,333
18131,30099,30-34,148,146,294
18132,30099,35-39,186,160,346
18133,30099,40-44,175,169,344
18134,30099,45-49,149,151,300
18135,30099,50-54,166,166,332
18136,30099,55-59,234,225,459
18137,30099,60-64,218,223,441
18138,30099,65+,737,687,1424
18139,30101,15-19,122,117,239
18140,30101,20-24,80,178,258
18141,30101,25-29,116,203,319
18142,30101,30-34,120,252,372
18143,30101,35-39,130,221,351
18144,30101,40-44,119,210,329
18145,30101,45-49,113,151,264
18146,30101,50-54,113,184,297
18147,30101,55-59,140,176,316
18148,30101,60-64,181,205,386
18149,30101,65+,463,479,942
18150,30103,15-19,14,12,26
18151,30103,20-24,20,17,37
18152,30103,25-29,19,19,38
18153,30103,30-34,19,21,40
18154,30103,35-39,19,21,40
18155,30103,40-44,18,14,32
18156,30103,45-49,8,10,18
18157,30103,50-54,12,12,24
18158,30103,55-59,19,29,48
18159,30103,60-64,37,39,76
18160,30103,65+,114,117,231
18161,30105,15-19,234,250,484
18162,30105,20-24,181,199,380
18163,30105,25-29,193,178,371
18164,30105,30-34,173,195,368
18165,30105,35-39,215,218,433
18166,30105,40-44,209,222,431
18167,30105,45-49,190,212,402
18168,30105,50-54,186,196,382
18169,30105,55-59,247,250,497
18170,30105,60-64,310,318,628
18171,30105,65+,937,853,1790
18172,30107,15-19,60,64,124
18173,30107,20-24,43,55,98
18174,30107,25-29,38,48,86
18175,30107,30-34,42,56,98
18176,30107,35-39,46,38,84
18177,30107,40-44,61,54,115
18178,30107,45-49,61,60,121
18179,30107,50-54,53,77,130
18180,30107,55-59,42,52,94
18181,30107,60-64,97,86,183
18182,30107,65+,276,261,537
18183,30109,15-19,30,22,52
18184,30109,20-24,25,22,47
18185,30109,25-29,19,25,44
18186,30109,30-34,16,15,31
18187,30109,35-39,30,27,57
18188,30109,40-44,24,22,46
18189,30109,45-49,17,31,48
18190,30109,50-54,31,27,58
18191,30109,55-59,33,37,70
18192,30109,60-64,31,53,84
18193,30109,65+,131,111,242
18194,30111,15-19,5189,5277,10466
18195,30111,20-24,4755,4867,9622
18196,30111,25-29,5697,5777,11474
18197,30111,30-34,5873,5816,11689
18198,30111,35-39,5759,5929,11688
18199,30111,40-44,5299,5435,10734
18200,30111,45-49,4633,4666,9299
18201,30111,50-54,4717,4859,9576
18202,30111,55-59,5202,5024,10226
18203,30111,60-64,5656,5382,11038
18204,30111,65+,16009,13340,29349
18205,31001,15-19,1182,1254,2436
18206,31001,20-24,1042,1187,2229
18207,31001,25-29,972,978,1950
18208,31001,30-34,885,891,1776
18209,31001,35-39,861,952,1813
18210,31001,40-44,873,854,1727
18211,31001,45-49,769,831,1600
18212,31001,50-54,827,868,1695
18213,31001,55-59,936,916,1852
18214,31001,60-64,1041,1094,2135
18215,31001,65+,3177,2656,5833
18216,31003,15-19,171,184,355
18217,31003,20-24,161,147,308
18218,31003,25-29,160,173,333
18219,31003,30-34,141,140,281
18220,31003,35-39,164,190,354
18221,31003,40-44,138,182,320
18222,31003,45-49,142,135,277
18223,31003,50-54,141,161,302
18224,31003,55-59,217,214,431
18225,31003,60-64,250,253,503
18226,31003,65+,813,718,1531
18227,31005,15-19,19,16,35
18228,31005,20-24,16,11,27
18229,31005,25-29,13,12,25
18230,31005,30-34,7,13,20
18231,31005,35-39,11,8,19
18232,31005,40-44,19,17,36
18233,31005,45-49,16,10,26
18234,31005,50-54,11,9,20
18235,31005,55-59,10,15,25
18236,31005,60-64,11,11,22
18237,31005,65+,44,50,94
18238,31007,15-19,26,19,45
18239,31007,20-24,11,9,20
18240,31007,25-29,15,16,31
18241,31007,30-34,25,20,45
18242,31007,35-39,14,16,30
18243,31007,40-44,21,26,47
18244,31007,45-49,13,10,23
18245,31007,50-54,19,17,36
18246,31007,55-59,30,15,45
18247,31007,60-64,27,36,63
18248,31007,65+,77,88,165
18249,31009,15-19,9,10,19
18250,31009,20-24,11,9,20
18251,31009,25-29,19,14,33
18252,31009,30-34,17,14,31
18253,31009,35-39,8,13,21
18254,31009,40-44,8,7,15
18255,31009,45-49,10,9,19
18256,31009,50-54,18,14,32
18257,31009,55-59,23,24,47
18258,31009,60-64,17,29,46
18259,31009,65+,48,46,94
18260,31011,15-19,140,171,311
18261,31011,20-24,126,137,263
18262,31011,25-29,128,128,256
18263,31011,30-34,131,158,289
18264,31011,35-39,138,150,288
18265,31011,40-44,134,149,283
18266,31011,45-49,120,126,246
18267,31011,50-54,136,143,279
18268,31011,55-59,182,199,381
18269,31011,60-64,220,242,462
18270,31011,65+,662,576,1238
18271,31013,15-19,322,354,676
18272,31013,20-24,250,234,484
18273,31013,25-29,281,294,575
18274,31013,30-34,320,312,632
18275,31013,35-39,335,316,651
18276,31013,40-44,306,357,663
18277,31013,45-49,262,304,566
18278,31013,50-54,277,261,538
18279,31013,55-59,286,269,555
18280,31013,60-64,413,426,839
18281,31013,65+,1129,1056,2185
18282,31015,15-19,50,45,95
18283,31015,20-24,35,45,80
18284,31015,25-29,44,45,89
18285,31015,30-34,35,32,67
18286,31015,35-39,36,39,75
18287,31015,40-44,46,50,96
18288,31015,45-49,41,43,84
18289,31015,50-54,37,55,92
18290,31015,55-59,57,57,114
18291,31015,60-64,91,91,182
18292,31015,65+,280,255,535
18293,31017,15-19,111,90,201
18294,31017,20-24,73,71,144
18295,31017,25-29,66,70,136
18296,31017,30-34,68,79,147
18297,31017,35-39,72,82,154
18298,31017,40-44,62,71,133
18299,31017,45-49,86,81,167
18300,31017,50-54,76,77,153
18301,31017,55-59,93,100,193
18302,31017,60-64,115,110,225
18303,31017,65+,410,343,753
18304,31019,15-19,1897,2018,3915
18305,31019,20-24,2621,2733,5354
18306,31019,25-29,1666,1739,3405
18307,31019,30-34,1493,1563,3056
18308,31019,35-39,1597,1735,3332
18309,31019,40-44,1495,1599,3094
18310,31019,45-49,1207,1307,2514
18311,31019,50-54,1263,1294,2557
18312,31019,55-59,1357,1309,2666
18313,31019,60-64,1471,1405,2876
18314,31019,65+,4401,3547,7948
18315,31021,15-19,186,245,431
18316,31021,20-24,140,156,296
18317,31021,25-29,141,162,303
18318,31021,30-34,183,158,341
18319,31021,35-39,195,198,393
18320,31021,40-44,175,180,355
18321,31021,45-49,167,167,334
18322,31021,50-54,182,195,377
18323,31021,55-59,239,223,462
18324,31021,60-64,225,263,488
18325,31021,65+,897,764,1661
18326,31023,15-19,258,281,539
18327,31023,20-24,198,237,435
18328,31023,25-29,206,217,423
18329,31023,30-34,217,229,446
18330,31023,35-39,220,267,487
18331,31023,40-44,232,248,480
18332,31023,45-49,220,255,475
18333,31023,50-54,212,253,465
18334,31023,55-59,311,311,622
18335,31023,60-64,314,334,648
18336,31023,65+,936,816,1752
18337,31025,15-19,826,940,1766
18338,31025,20-24,648,745,1393
18339,31025,25-29,643,677,1320
18340,31025,30-34,698,788,1486
18341,31025,35-39,854,912,1766
18342,31025,40-44,854,876,1730
18343,31025,45-49,825,842,1667
18344,31025,50-54,918,879,1797
18345,31025,55-59,1015,1055,2070
18346,31025,60-64,952,1054,2006
18347,31025,65+,2568,2349,4917
18348,31027,15-19,264,301,565
18349,31027,20-24,200,217,417
18350,31027,25-29,167,206,373
18351,31027,30-34,193,180,373
18352,31027,35-39,210,229,439
18353,31027,40-44,207,231,438
18354,31027,45-49,196,209,405
18355,31027,50-54,225,220,445
18356,31027,55-59,285,286,571
18357,31027,60-64,333,346,679
18358,31027,65+,986,882,1868
18359,31029,15-19,145,112,257
18360,31029,20-24,89,93,182
18361,31029,25-29,97,82,179
18362,31029,30-34,86,93,179
18363,31029,35-39,102,132,234
18364,31029,40-44,104,116,220
18365,31029,45-49,97,111,208
18366,31029,50-54,104,118,222
18367,31029,55-59,122,115,237
18368,31029,60-64,151,151,302
18369,31029,65+,444,370,814
18370,31031,15-19,152,178,330
18371,31031,20-24,112,131,243
18372,31031,25-29,105,146,251
18373,31031,30-34,137,148,285
18374,31031,35-39,158,176,334
18375,31031,40-44,156,189,345
18376,31031,45-49,147,150,297
18377,31031,50-54,148,158,306
18378,31031,55-59,162,168,330
18379,31031,60-64,203,205,408
18380,31031,65+,627,595,1222
18381,31033,15-19,262,319,581
18382,31033,20-24,229,227,456
18383,31033,25-29,235,220,455
18384,31033,30-34,270,294,564
18385,31033,35-39,303,303,606
18386,31033,40-44,272,262,534
18387,31033,45-49,252,293,545
18388,31033,50-54,249,274,523
18389,31033,55-59,300,314,614
18390,31033,60-64,350,374,724
18391,31033,65+,1101,978,2079
18392,31035,15-19,213,210,423
18393,31035,20-24,123,147,270
18394,31035,25-29,171,180,351
18395,31035,30-34,162,177,339
18396,31035,35-39,160,200,360
18397,31035,40-44,161,144,305
18398,31035,45-49,166,149,315
18399,31035,50-54,147,178,325
18400,31035,55-59,206,219,425
18401,31035,60-64,217,241,458
18402,31035,65+,638,650,1288
18403,31037,15-19,364,415,779
18404,31037,20-24,255,360,615
18405,31037,25-29,222,310,532
18406,31037,30-34,252,318,570
18407,31037,35-39,294,434,728
18408,31037,40-44,243,459,702
18409,31037,45-49,264,316,580
18410,31037,50-54,243,316,559
18411,31037,55-59,257,385,642
18412,31037,60-64,302,327,629
18413,31037,65+,749,731,1480
18414,31039,15-19,310,323,633
18415,31039,20-24,252,229,481
18416,31039,25-29,227,238,465
18417,31039,30-34,227,238,465
18418,31039,35-39,263,248,511
18419,31039,40-44,227,233,460
18420,31039,45-49,221,203,424
18421,31039,50-54,239,273,512
18422,31039,55-59,291,327,618
18423,31039,60-64,288,347,635
18424,31039,65+,1042,939,1981
18425,31041,15-19,325,348,673
18426,31041,20-24,225,259,484
18427,31041,25-29,263,273,536
18428,31041,30-34,288,303,591
18429,31041,35-39,282,302,584
18430,31041,40-44,283,294,577
18431,31041,45-49,271,279,550
18432,31041,50-54,269,272,541
18433,31041,55-59,350,351,701
18434,31041,60-64,383,400,783
18435,31041,65+,1255,1120,2375
18436,31043,15-19,701,810,1511
18437,31043,20-24,662,700,1362
18438,31043,25-29,694,705,1399
18439,31043,30-34,752,717,1469
18440,31043,35-39,617,719,1336
18441,31043,40-44,547,632,1179
18442,31043,45-49,543,555,1098
18443,31043,50-54,588,587,1175
18444,31043,55-59,583,683,1266
18445,31043,60-64,600,600,1200
18446,31043,65+,1597,1397,2994
18447,31045,15-19,441,410,851
18448,31045,20-24,587,595,1182
18449,31045,25-29,220,212,432
18450,31045,30-34,184,202,386
18451,31045,35-39,201,213,414
18452,31045,40-44,207,211,418
18453,31045,45-49,173,178,351
18454,31045,50-54,187,197,384
18455,31045,55-59,239,201,440
18456,31045,60-64,283,256,539
18457,31045,65+,852,742,1594
18458,31047,15-19,845,892,1737
18459,31047,20-24,674,651,1325
18460,31047,25-29,700,788,1488
18461,31047,30-34,642,873,1515
18462,31047,35-39,674,822,1496
18463,31047,40-44,651,730,1381
18464,31047,45-49,642,679,1321
18465,31047,50-54,621,753,1374
18466,31047,55-59,587,751,1338
18467,31047,60-64,677,756,1433
18468,31047,65+,2115,1976,4091
18469,31049,15-19,53,62,115
18470,31049,20-24,30,26,56
18471,31049,25-29,37,40,77
18472,31049,30-34,45,44,89
18473,31049,35-39,36,34,70
18474,31049,40-44,43,50,93
18475,31049,45-49,47,60,107
18476,31049,50-54,56,58,114
18477,31049,55-59,72,71,143
18478,31049,60-64,73,91,164
18479,31049,65+,259,254,513
18480,31051,15-19,169,188,357
18481,31051,20-24,144,139,283
18482,31051,25-29,141,140,281
18483,31051,30-34,114,141,255
18484,31051,35-39,145,159,304
18485,31051,40-44,157,148,305
18486,31051,45-49,141,172,313
18487,31051,50-54,148,175,323
18488,31051,55-59,163,176,339
18489,31051,60-64,210,217,427
18490,31051,65+,611,576,1187
18491,31053,15-19,1307,1370,2677
18492,31053,20-24,1165,1250,2415
18493,31053,25-29,1015,1080,2095
18494,31053,30-34,971,1071,2042
18495,31053,35-39,1061,1111,2172
18496,31053,40-44,1053,1160,2213
18497,31053,45-49,947,980,1927
18498,31053,50-54,1004,1107,2111
18499,31053,55-59,1209,1200,2409
18500,31053,60-64,1244,1226,2470
18501,31053,65+,3860,3184,7044
18502,31055,15-19,19683,20144,39827
18503,31055,20-24,19046,18686,37732
18504,31055,25-29,21780,21826,43606
18505,31055,30-34,21382,21764,43146
18506,31055,35-39,21599,22084,43683
18507,31055,40-44,19109,19832,38941
18508,31055,45-49,16438,16686,33124
18509,31055,50-54,16281,17006,33287
18510,31055,55-59,16913,17054,33967
18511,31055,60-64,17171,16121,33292
18512,31055,65+,44736,35927,80663
18513,31057,15-19,35,52,87
18514,31057,20-24,42,45,87
18515,31057,25-29,48,40,88
18516,31057,30-34,35,30,65
18517,31057,35-39,38,42,80
18518,31057,40-44,37,57,94
18519,31057,45-49,54,49,103
18520,31057,50-54,47,37,84
18521,31057,55-59,54,55,109
18522,31057,60-64,69,76,145
18523,31057,65+,216,212,428
18524,31059,15-19,181,146,327
18525,31059,20-24,110,129,239
18526,31059,25-29,144,158,302
18527,31059,30-34,180,174,354
18528,31059,35-39,170,172,342
18529,31059,40-44,147,178,325
18530,31059,45-49,124,153,277
18531,31059,50-54,169,160,329
18532,31059,55-59,206,224,430
18533,31059,60-64,219,236,455
18534,31059,65+,690,593,1283
18535,31061,15-19,66,81,147
18536,31061,20-24,72,56,128
18537,31061,25-29,65,56,121
18538,31061,30-34,66,70,136
18539,31061,35-39,76,83,159
18540,31061,40-44,91,75,166
18541,31061,45-49,63,66,129
18542,31061,50-54,77,71,148
18543,31061,55-59,83,98,181
18544,31061,60-64,130,133,263
18545,31061,65+,407,397,804
18546,31063,15-19,88,117,205
18547,31063,20-24,74,82,156
18548,31063,25-29,53,60,113
18549,31063,30-34,64,66,130
18550,31063,35-39,68,56,124
18551,31063,40-44,57,70,127
18552,31063,45-49,70,71,141
18553,31063,50-54,72,73,145
18554,31063,55-59,78,73,151
18555,31063,60-64,91,123,214
18556,31063,65+,331,300,631
18557,31065,15-19,150,161,311
18558,31065,20-24,111,118,229
18559,31065,25-29,113,120,233
18560,31065,30-34,92,107,199
18561,31065,35-39,119,118,237
18562,31065,40-44,111,132,243
18563,31065,45-49,137,111,248
18564,31065,50-54,124,136,260
18565,31065,55-59,133,145,278
18566,31065,60-64,175,184,359
18567,31065,65+,648,539,1187
18568,31067,15-19,627,689,1316
18569,31067,20-24,495,571,1066
18570,31067,25-29,525,544,1069
18571,31067,30-34,605,594,1199
18572,31067,35-39,617,655,1272
18573,31067,40-44,625,677,1302
18574,31067,45-49,580,609,1189
18575,31067,50-54,618,660,1278
18576,31067,55-59,785,748,1533
18577,31067,60-64,850,846,1696
18578,31067,65+,2466,2204,4670
18579,31069,15-19,38,69,107
18580,31069,20-24,35,25,60
18581,31069,25-29,28,46,74
18582,31069,30-34,53,48,101
18583,31069,35-39,47,58,105
18584,31069,40-44,42,34,76
18585,31069,45-49,40,40,80
18586,31069,50-54,55,53,108
18587,31069,55-59,55,70,125
18588,31069,60-64,81,104,185
18589,31069,65+,277,261,538
18590,31071,15-19,58,46,104
18591,31071,20-24,45,47,92
18592,31071,25-29,51,57,108
18593,31071,30-34,38,39,77
18594,31071,35-39,37,59,96
18595,31071,40-44,35,45,80
18596,31071,45-49,46,39,85
18597,31071,50-54,46,52,98
18598,31071,55-59,72,59,131
18599,31071,60-64,82,83,165
18600,31071,65+,272,259,531
18601,31073,15-19,39,70,109
18602,31073,20-24,37,35,72
18603,31073,25-29,47,35,82
18604,31073,30-34,43,44,87
18605,31073,35-39,50,57,107
18606,31073,40-44,53,57,110
18607,31073,45-49,40,51,91
18608,31073,50-54,46,54,100
18609,31073,55-59,66,71,137
18610,31073,60-64,87,76,163
18611,31073,65+,217,234,451
18612,31075,15-19,16,17,33
18613,31075,20-24,10,10,20
18614,31075,25-29,10,15,25
18615,31075,30-34,12,18,30
18616,31075,35-39,15,22,37
18617,31075,40-44,19,17,36
18618,31075,45-49,10,15,25
18619,31075,50-54,8,10,18
18620,31075,55-59,26,18,44
18621,31075,60-64,19,24,43
18622,31075,65+,73,78,151
18623,31077,15-19,66,64,130
18624,31077,20-24,51,62,113
18625,31077,25-29,52,51,103
18626,31077,30-34,54,50,104
18627,31077,35-39,59,57,116
18628,31077,40-44,56,53,109
18629,31077,45-49,50,62,112
18630,31077,50-54,47,50,97
18631,31077,55-59,84,68,152
18632,31077,60-64,70,94,164
18633,31077,65+,294,265,559
18634,31079,15-19,2118,2325,4443
18635,31079,20-24,1748,1789,3537
18636,31079,25-29,1830,2005,3835
18637,31079,30-34,1851,2052,3903
18638,31079,35-39,2017,2131,4148
18639,31079,40-44,1853,1971,3824
18640,31079,45-49,1690,1813,3503
18641,31079,50-54,1714,1847,3561
18642,31079,55-59,1881,1986,3867
18643,31079,60-64,1829,1863,3692
18644,31079,65+,5176,4372,9548
18645,31081,15-19,266,334,600
18646,31081,20-24,239,238,477
18647,31081,25-29,264,243,507
18648,31081,30-34,250,258,508
18649,31081,35-39,272,302,574
18650,31081,40-44,261,290,551
18651,31081,45-49,246,252,498
18652,31081,50-54,300,280,580
18653,31081,55-59,304,325,629
18654,31081,60-64,335,339,674
18655,31081,65+,1018,906,1924
18656,31083,15-19,77,96,173
18657,31083,20-24,63,71,134
18658,31083,25-29,74,70,144
18659,31083,30-34,61,63,124
18660,31083,35-39,69,64,133
18661,31083,40-44,76,80,156
18662,31083,45-49,74,84,158
18663,31083,50-54,87,97,184
18664,31083,55-59,106,113,219
18665,31083,60-64,134,140,274
18666,31083,65+,415,427,842
18667,31085,15-19,21,25,46
18668,31085,20-24,8,16,24
18669,31085,25-29,23,17,40
18670,31085,30-34,17,26,43
18671,31085,35-39,21,28,49
18672,31085,40-44,21,21,42
18673,31085,45-49,18,13,31
18674,31085,50-54,8,11,19
18675,31085,55-59,31,33,64
18676,31085,60-64,41,47,88
18677,31085,65+,107,123,230
18678,31087,15-19,75,98,173
18679,31087,20-24,49,48,97
18680,31087,25-29,52,56,108
18681,31087,30-34,54,60,114
18682,31087,35-39,68,83,151
18683,31087,40-44,74,88,162
18684,31087,45-49,67,58,125
18685,31087,50-54,68,65,133
18686,31087,55-59,82,87,169
18687,31087,60-64,105,101,206
18688,31087,65+,350,315,665
18689,31089,15-19,316,319,635
18690,31089,20-24,229,247,476
18691,31089,25-29,241,237,478
18692,31089,30-34,216,253,469
18693,31089,35-39,268,286,554
18694,31089,40-44,266,258,524
18695,31089,45-49,229,259,488
18696,31089,50-54,241,246,487
18697,31089,55-59,331,345,676
18698,31089,60-64,401,427,828
18699,31089,65+,1189,1086,2275
18700,31091,15-19,19,31,50
18701,31091,20-24,17,12,29
18702,31091,25-29,12,11,23
18703,31091,30-34,17,20,37
18704,31091,35-39,20,11,31
18705,31091,40-44,25,35,60
18706,31091,45-49,19,20,39
18707,31091,50-54,12,18,30
18708,31091,55-59,21,17,38
18709,31091,60-64,26,32,58
18710,31091,65+,115,97,212
18711,31093,15-19,197,237,434
18712,31093,20-24,121,136,257
18713,31093,25-29,162,150,312
18714,31093,30-34,186,197,383
18715,31093,35-39,183,187,370
18716,31093,40-44,188,199,387
18717,31093,45-49,177,201,378
18718,31093,50-54,174,190,364
18719,31093,55-59,242,226,468
18720,31093,60-64,221,242,463
18721,31093,65+,712,690,1402
18722,31095,15-19,227,209,436
18723,31095,20-24,166,159,325
18724,31095,25-29,157,153,310
18725,31095,30-34,181,194,375
18726,31095,35-39,209,207,416
18727,31095,40-44,201,194,395
18728,31095,45-49,186,209,395
18729,31095,50-54,197,184,381
18730,31095,55-59,239,237,476
18731,31095,60-64,287,308,595
18732,31095,65+,904,834,1738
18733,31097,15-19,128,139,267
18734,31097,20-24,91,226,317
18735,31097,25-29,113,278,391
18736,31097,30-34,88,318,406
18737,31097,35-39,114,290,404
18738,31097,40-44,97,214,311
18739,31097,45-49,102,224,326
18740,31097,50-54,118,245,363
18741,31097,55-59,156,220,376
18742,31097,60-64,168,199,367
18743,31097,65+,521,466,987
18744,31099,15-19,233,235,468
18745,31099,20-24,144,164,308
18746,31099,25-29,179,189,368
18747,31099,30-34,196,187,383
18748,31099,35-39,198,210,408
18749,31099,40-44,182,218,400
18750,31099,45-49,183,185,368
18751,31099,50-54,161,187,348
18752,31099,55-59,223,209,432
18753,31099,60-64,226,254,480
18754,31099,65+,717,640,1357
18755,31101,15-19,215,283,498
18756,31101,20-24,163,163,326
18757,31101,25-29,194,193,387
18758,31101,30-34,188,182,370
18759,31101,35-39,236,241,477
18760,31101,40-44,195,222,417
18761,31101,45-49,197,197,394
18762,31101,50-54,240,236,476
18763,31101,55-59,282,298,580
18764,31101,60-64,339,375,714
18765,31101,65+,1175,1070,2245
18766,31103,15-19,21,29,50
18767,31103,20-24,18,16,34
18768,31103,25-29,15,24,39
18769,31103,30-34,12,15,27
18770,31103,35-39,16,15,31
18771,31103,40-44,20,17,37
18772,31103,45-49,20,19,39
18773,31103,50-54,16,19,35
18774,31103,55-59,27,22,49
18775,31103,60-64,40,47,87
18776,31103,65+,123,128,251
18777,31105,15-19,97,88,185
18778,31105,20-24,73,80,153
18779,31105,25-29,89,82,171
18780,31105,30-34,80,97,177
18781,31105,35-39,86,90,176
18782,31105,40-44,83,105,188
18783,31105,45-49,80,67,147
18784,31105,50-54,101,105,206
18785,31105,55-59,127,113,240
18786,31105,60-64,151,156,307
18787,31105,65+,479,400,879
18788,31107,15-19,296,273,569
18789,31107,20-24,194,205,399
18790,31107,25-29,168,203,371
18791,31107,30-34,191,173,364
18792,31107,35-39,202,220,422
18793,31107,40-44,195,227,422
18794,31107,45-49,192,211,403
18795,31107,50-54,194,216,410
18796,31107,55-59,296,274,570
18797,31107,60-64,300,323,623
18798,31107,65+,1166,947,2113
18799,31109,15-19,12479,12665,25144
18800,31109,20-24,17546,17965,35511
18801,31109,25-29,11333,12503,23836
18802,31109,30-34,9411,10818,20229
18803,31109,35-39,10382,11163,21545
18804,31109,40-44,9784,10380,20164
18805,31109,45-49,8328,9257,17585
18806,31109,50-54,8247,8766,17013
18807,31109,55-59,8547,8627,17174
18808,31109,60-64,9223,8731,17954
18809,31109,65+,26354,21874,48228
18810,31111,15-19,1131,1150,2281
18811,31111,20-24,828,857,1685
18812,31111,25-29,854,956,1810
18813,31111,30-34,935,924,1859
18814,31111,35-39,1097,1057,2154
18815,31111,40-44,1101,1120,2221
18816,31111,45-49,989,1028,2017
18817,31111,50-54,955,1081,2036
18818,31111,55-59,1051,1054,2105
18819,31111,60-64,1242,1200,2442
18820,31111,65+,3786,3248,7034
18821,31113,15-19,25,31,56
18822,31113,20-24,15,15,30
18823,31113,25-29,15,14,29
18824,31113,30-34,14,24,38
18825,31113,35-39,23,17,40
18826,31113,40-44,29,21,50
18827,31113,45-49,15,28,43
18828,31113,50-54,21,9,30
18829,31113,55-59,20,24,44
18830,31113,60-64,25,27,52
18831,31113,65+,78,84,162
18832,31115,15-19,13,15,28
18833,31115,20-24,17,14,31
18834,31115,25-29,12,13,25
18835,31115,30-34,15,17,32
18836,31115,35-39,10,19,29
18837,31115,40-44,13,10,23
18838,31115,45-49,14,20,34
18839,31115,50-54,17,11,28
18840,31115,55-59,22,18,40
18841,31115,60-64,32,35,67
18842,31115,65+,82,87,169
18843,31117,15-19,13,12,25
18844,31117,20-24,13,6,19
18845,31117,25-29,8,8,16
18846,31117,30-34,7,7,14
18847,31117,35-39,11,9,20
18848,31117,40-44,11,8,19
18849,31117,45-49,8,15,23
18850,31117,50-54,10,13,23
18851,31117,55-59,16,18,34
18852,31117,60-64,20,13,33
18853,31117,65+,51,50,101
18854,31119,15-19,1256,1340,2596
18855,31119,20-24,1027,1111,2138
18856,31119,25-29,1016,1094,2110
18857,31119,30-34,1052,1135,2187
18858,31119,35-39,1098,1242,2340
18859,31119,40-44,1052,1054,2106
18860,31119,45-49,889,933,1822
18861,31119,50-54,897,890,1787
18862,31119,55-59,1101,1155,2256
18863,31119,60-64,1254,1256,2510
18864,31119,65+,3178,2703,5881
18865,31121,15-19,231,271,502
18866,31121,20-24,177,191,368
18867,31121,25-29,230,237,467
18868,31121,30-34,204,217,421
18869,31121,35-39,225,210,435
18870,31121,40-44,230,241,471
18871,31121,45-49,215,224,439
18872,31121,50-54,212,235,447
18873,31121,55-59,270,274,544
18874,31121,60-64,265,324,589
18875,31121,65+,849,782,1631
18876,31123,15-19,140,154,294
18877,31123,20-24,108,142,250
18878,31123,25-29,118,132,250
18879,31123,30-34,116,128,244
18880,31123,35-39,135,147,282
18881,31123,40-44,121,130,251
18882,31123,45-49,140,118,258
18883,31123,50-54,110,156,266
18884,31123,55-59,148,146,294
18885,31123,60-64,164,163,327
18886,31123,65+,508,502,1010
18887,31125,15-19,105,109,214
18888,31125,20-24,74,81,155
18889,31125,25-29,81,81,162
18890,31125,30-34,93,97,190
18891,31125,35-39,72,112,184
18892,31125,40-44,107,107,214
18893,31125,45-49,89,80,169
18894,31125,50-54,89,85,174
18895,31125,55-59,126,141,267
18896,31125,60-64,135,153,288
18897,31125,65+,405,320,725
18898,31127,15-19,302,305,607
18899,31127,20-24,253,275,528
18900,31127,25-29,190,184,374
18901,31127,30-34,188,207,395
18902,31127,35-39,215,221,436
18903,31127,40-44,181,219,400
18904,31127,45-49,179,153,332
18905,31127,50-54,172,167,339
18906,31127,55-59,216,212,428
18907,31127,60-64,218,238,456
18908,31127,65+,736,692,1428
18909,31129,15-19,109,112,221
18910,31129,20-24,96,99,195
18911,31129,25-29,89,91,180
18912,31129,30-34,94,104,198
18913,31129,35-39,116,103,219
18914,31129,40-44,85,118,203
18915,31129,45-49,103,100,203
18916,31129,50-54,94,102,196
18917,31129,55-59,118,144,262
18918,31129,60-64,200,202,402
18919,31129,65+,599,507,1106
18920,31131,15-19,514,497,1011
18921,31131,20-24,379,403,782
18922,31131,25-29,380,433,813
18923,31131,30-34,441,462,903
18924,31131,35-39,457,480,937
18925,31131,40-44,470,491,961
18926,31131,45-49,447,461,908
18927,31131,50-54,475,501,976
18928,31131,55-59,544,543,1087
18929,31131,60-64,580,601,1181
18930,31131,65+,1769,1461,3230
18931,31133,15-19,63,70,133
18932,31133,20-24,68,57,125
18933,31133,25-29,56,57,113
18934,31133,30-34,56,49,105
18935,31133,35-39,59,62,121
18936,31133,40-44,67,65,132
18937,31133,45-49,56,48,104
18938,31133,50-54,76,74,150
18939,31133,55-59,81,82,163
18940,31133,60-64,99,98,197
18941,31133,65+,371,349,720
18942,31135,15-19,88,92,180
18943,31135,20-24,63,85,148
18944,31135,25-29,56,71,127
18945,31135,30-34,59,56,115
18946,31135,35-39,81,104,185
18947,31135,40-44,83,91,174
18948,31135,45-49,75,78,153
18949,31135,50-54,69,65,134
18950,31135,55-59,81,75,156
18951,31135,60-64,110,102,212
18952,31135,65+,356,331,687
18953,31137,15-19,271,292,563
18954,31137,20-24,233,252,485
18955,31137,25-29,241,263,504
18956,31137,30-34,251,279,530
18957,31137,35-39,236,282,518
18958,31137,40-44,250,247,497
18959,31137,45-49,231,242,473
18960,31137,50-54,247,266,513
18961,31137,55-59,312,306,618
18962,31137,60-64,296,318,614
18963,31137,65+,999,808,1807
18964,31139,15-19,232,270,502
18965,31139,20-24,169,197,366
18966,31139,25-29,187,189,376
18967,31139,30-34,167,205,372
18968,31139,35-39,219,241,460
18969,31139,40-44,204,227,431
18970,31139,45-49,189,197,386
18971,31139,50-54,203,208,411
18972,31139,55-59,251,252,503
18973,31139,60-64,243,278,521
18974,31139,65+,743,714,1457
18975,31141,15-19,1156,1172,2328
18976,31141,20-24,899,1011,1910
18977,31141,25-29,955,1097,2052
18978,31141,30-34,951,1047,1998
18979,31141,35-39,991,1167,2158
18980,31141,40-44,993,1069,2062
18981,31141,45-49,905,961,1866
18982,31141,50-54,850,963,1813
18983,31141,55-59,1052,1076,2128
18984,31141,60-64,1127,1174,2301
18985,31141,65+,3227,2876,6103
18986,31143,15-19,148,180,328
18987,31143,20-24,125,152,277
18988,31143,25-29,119,127,246
18989,31143,30-34,127,124,251
18990,31143,35-39,110,133,243
18991,31143,40-44,156,139,295
18992,31143,45-49,144,147,291
18993,31143,50-54,166,164,330
18994,31143,55-59,167,202,369
18995,31143,60-64,197,199,396
18996,31143,65+,604,591,1195
18997,31145,15-19,361,386,747
18998,31145,20-24,279,361,640
18999,31145,25-29,301,324,625
19000,31145,30-34,282,295,577
19001,31145,35-39,317,333,650
19002,31145,40-44,296,321,617
19003,31145,45-49,263,243,506
19004,31145,50-54,269,317,586
19005,31145,55-59,340,338,678
19006,31145,60-64,398,406,804
19007,31145,65+,1214,1038,2252
19008,31147,15-19,210,238,448
19009,31147,20-24,177,192,369
19010,31147,25-29,187,186,373
19011,31147,30-34,168,181,349
19012,31147,35-39,223,208,431
19013,31147,40-44,200,217,417
19014,31147,45-49,190,193,383
19015,31147,50-54,219,211,430
19016,31147,55-59,285,296,581
19017,31147,60-64,322,347,669
19018,31147,65+,986,902,1888
19019,31149,15-19,38,40,78
19020,31149,20-24,26,29,55
19021,31149,25-29,29,22,51
19022,31149,30-34,29,28,57
19023,31149,35-39,27,42,69
19024,31149,40-44,45,40,85
19025,31149,45-49,22,26,48
19026,31149,50-54,27,29,56
19027,31149,55-59,32,32,64
19028,31149,60-64,56,52,108
19029,31149,65+,195,166,361
19030,31151,15-19,612,659,1271
19031,31151,20-24,521,591,1112
19032,31151,25-29,374,396,770
19033,31151,30-34,322,357,679
19034,31151,35-39,390,509,899
19035,31151,40-44,424,428,852
19036,31151,45-49,408,429,837
19037,31151,50-54,405,430,835
19038,31151,55-59,396,444,840
19039,31151,60-64,401,467,868
19040,31151,65+,1159,1023,2182
19041,31153,15-19,6517,7012,13529
19042,31153,20-24,5522,6138,11660
19043,31153,25-29,6229,6674,12903
19044,31153,30-34,6929,7014,13943
19045,31153,35-39,7425,7518,14943
19046,31153,40-44,6880,7093,13973
19047,31153,45-49,5942,6090,12032
19048,31153,50-54,5650,5814,11464
19049,31153,55-59,5772,5752,11524
19050,31153,60-64,5311,5188,10499
19051,31153,65+,13192,10913,24105
19052,31155,15-19,654,811,1465
19053,31155,20-24,512,578,1090
19054,31155,25-29,575,601,1176
19055,31155,30-34,627,617,1244
19056,31155,35-39,741,791,1532
19057,31155,40-44,675,718,1393
19058,31155,45-49,601,622,1223
19059,31155,50-54,653,653,1306
19060,31155,55-59,846,913,1759
19061,31155,60-64,818,868,1686
19062,31155,65+,2152,2024,4176
19063,31157,15-19,1252,1246,2498
19064,31157,20-24,959,1034,1993
19065,31157,25-29,991,1054,2045
19066,31157,30-34,1060,1021,2081
19067,31157,35-39,1102,1031,2133
19068,31157,40-44,1067,1055,2122
19069,31157,45-49,956,1019,1975
19070,31157,50-54,979,916,1895
19071,31157,55-59,1124,1120,2244
19072,31157,60-64,1212,1209,2421
19073,31157,65+,3941,3094,7035
19074,31159,15-19,724,867,1591
19075,31159,20-24,651,800,1451
19076,31159,25-29,399,419,818
19077,31159,30-34,459,477,936
19078,31159,35-39,513,582,1095
19079,31159,40-44,534,538,1072
19080,31159,45-49,442,478,920
19081,31159,50-54,438,509,947
19082,31159,55-59,533,598,1131
19083,31159,60-64,576,560,1136
19084,31159,65+,1601,1514,3115
19085,31161,15-19,134,171,305
19086,31161,20-24,126,132,258
19087,31161,25-29,108,126,234
19088,31161,30-34,115,136,251
19089,31161,35-39,135,129,264
19090,31161,40-44,138,139,277
19091,31161,45-49,120,128,248
19092,31161,50-54,152,165,317
19093,31161,55-59,114,174,288
19094,31161,60-64,203,186,389
19095,31161,65+,748,598,1346
19096,31163,15-19,89,86,175
19097,31163,20-24,66,65,131
19098,31163,25-29,73,81,154
19099,31163,30-34,73,58,131
19100,31163,35-39,75,69,144
19101,31163,40-44,55,77,132
19102,31163,45-49,72,83,155
19103,31163,50-54,93,67,160
19104,31163,55-59,105,97,202
19105,31163,60-64,127,135,262
19106,31163,65+,416,387,803
19107,31165,15-19,30,34,64
19108,31165,20-24,31,29,60
19109,31165,25-29,31,31,62
19110,31165,30-34,17,17,34
19111,31165,35-39,36,33,69
19112,31165,40-44,25,22,47
19113,31165,45-49,30,32,62
19114,31165,50-54,26,26,52
19115,31165,55-59,39,51,90
19116,31165,60-64,47,55,102
19117,31165,65+,151,194,345
19118,31167,15-19,188,192,380
19119,31167,20-24,137,141,278
19120,31167,25-29,155,148,303
19121,31167,30-34,150,173,323
19122,31167,35-39,167,190,357
19123,31167,40-44,166,194,360
19124,31167,45-49,141,160,301
19125,31167,50-54,160,181,341
19126,31167,55-59,209,206,415
19127,31167,60-64,214,251,465
19128,31167,65+,559,556,1115
19129,31169,15-19,154,144,298
19130,31169,20-24,119,119,238
19131,31169,25-29,107,115,222
19132,31169,30-34,105,127,232
19133,31169,35-39,129,124,253
19134,31169,40-44,116,134,250
19135,31169,45-49,117,148,265
19136,31169,50-54,148,144,292
19137,31169,55-59,177,168,345
19138,31169,60-64,168,200,368
19139,31169,65+,659,569,1228
19140,31171,15-19,18,23,41
19141,31171,20-24,11,21,32
19142,31171,25-29,15,15,30
19143,31171,30-34,15,17,32
19144,31171,35-39,14,21,35
19145,31171,40-44,19,16,35
19146,31171,45-49,17,18,35
19147,31171,50-54,14,17,31
19148,31171,55-59,21,20,41
19149,31171,60-64,18,17,35
19150,31171,65+,97,98,195
19151,31173,15-19,280,317,597
19152,31173,20-24,241,228,469
19153,31173,25-29,222,218,440
19154,31173,30-34,189,209,398
19155,31173,35-39,152,179,331
19156,31173,40-44,168,169,337
19157,31173,45-49,157,117,274
19158,31173,50-54,163,132,295
19159,31173,55-59,185,157,342
19160,31173,60-64,175,179,354
19161,31173,65+,411,386,797
19162,31175,15-19,120,125,245
19163,31175,20-24,90,96,186
19164,31175,25-29,109,95,204
19165,31175,30-34,97,101,198
19166,31175,35-39,112,110,222
19167,31175,40-44,110,105,215
19168,31175,45-49,92,120,212
19169,31175,50-54,107,109,216
19170,31175,55-59,137,156,293
19171,31175,60-64,141,131,272
19172,31175,65+,517,494,1011
19173,31177,15-19,671,727,1398
19174,31177,20-24,529,563,1092
19175,31177,25-29,482,489,971
19176,31177,30-34,523,525,1048
19177,31177,35-39,665,700,1365
19178,31177,40-44,681,750,1431
19179,31177,45-49,623,612,1235
19180,31177,50-54,639,662,1301
19181,31177,55-59,816,789,1605
19182,31177,60-64,733,801,1534
19183,31177,65+,2057,1826,3883
19184,31179,15-19,584,512,1096
19185,31179,20-24,726,719,1445
19186,31179,25-29,231,299,530
19187,31179,30-34,228,270,498
19188,31179,35-39,235,234,469
19189,31179,40-44,239,255,494
19190,31179,45-49,214,215,429
19191,31179,50-54,222,259,481
19192,31179,55-59,290,250,540
19193,31179,60-64,267,307,574
19194,31179,65+,838,796,1634
19195,31181,15-19,118,86,204
19196,31181,20-24,74,91,165
19197,31181,25-29,96,103,199
19198,31181,30-34,86,102,188
19199,31181,35-39,70,78,148
19200,31181,40-44,87,100,187
19201,31181,45-49,94,96,190
19202,31181,50-54,103,110,213
19203,31181,55-59,127,115,242
19204,31181,60-64,119,147,266
19205,31181,65+,430,340,770
19206,31183,15-19,13,19,32
19207,31183,20-24,14,15,29
19208,31183,25-29,17,16,33
19209,31183,30-34,16,28,44
19210,31183,35-39,19,19,38
19211,31183,40-44,15,22,37
19212,31183,45-49,16,12,28
19213,31183,50-54,16,31,47
19214,31183,55-59,23,24,47
19215,31183,60-64,41,44,85
19216,31183,65+,117,109,226
19217,31185,15-19,462,517,979
19218,31185,20-24,417,483,900
19219,31185,25-29,430,410,840
19220,31185,30-34,451,380,831
19221,31185,35-39,428,430,858
19222,31185,40-44,390,384,774
19223,31185,45-49,351,359,710
19224,31185,50-54,380,357,737
19225,31185,55-59,449,439,888
19226,31185,60-64,505,513,1018
19227,31185,65+,1603,1346,2949
19228,32001,15-19,680,755,1435
19229,32001,20-24,678,764,1442
19230,32001,25-29,844,954,1798
19231,32001,30-34,918,987,1905
19232,32001,35-39,764,858,1622
19233,32001,40-44,669,784,1453
19234,32001,45-49,615,656,1271
19235,32001,50-54,733,683,1416
19236,32001,55-59,808,894,1702
19237,32001,60-64,909,874,1783
19238,32001,65+,2564,2352,4916
19239,32003,15-19,68351,71702,140053
19240,32003,20-24,66432,68534,134966
19241,32003,25-29,80706,81546,162252
19242,32003,30-34,85830,87348,173178
19243,32003,35-39,82338,84707,167045
19244,32003,40-44,77416,79418,156834
19245,32003,45-49,73651,73856,147507
19246,32003,50-54,73920,76975,150895
19247,32003,55-59,70414,72559,142973
19248,32003,60-64,67027,65603,132630
19249,32003,65+,188441,165378,353819
19250,32005,15-19,1116,1252,2368
19251,32005,20-24,855,1012,1867
19252,32005,25-29,973,1129,2102
19253,32005,30-34,1215,1305,2520
19254,32005,35-39,1249,1397,2646
19255,32005,40-44,1243,1299,2542
19256,32005,45-49,1181,1236,2417
19257,32005,50-54,1466,1422,2888
19258,32005,55-59,1968,1841,3809
19259,32005,60-64,2560,2376,4936
19260,32005,65+,7876,7736,15612
19261,32007,15-19,1763,2031,3794
19262,32007,20-24,1455,1609,3064
19263,32007,25-29,1798,1942,3740
19264,32007,30-34,2031,2210,4241
19265,32007,35-39,1821,2122,3943
19266,32007,40-44,1612,1858,3470
19267,32007,45-49,1485,1583,3068
19268,32007,50-54,1552,1662,3214
19269,32007,55-59,1598,1799,3397
19270,32007,60-64,1500,1708,3208
19271,32007,65+,3396,3439,6835
19272,32009,15-19,16,14,30
19273,32009,20-24,10,16,26
19274,32009,25-29,10,13,23
19275,32009,30-34,15,17,32
19276,32009,35-39,25,25,50
19277,32009,40-44,19,21,40
19278,32009,45-49,14,22,36
19279,32009,50-54,18,29,47
19280,32009,55-59,30,30,60
19281,32009,60-64,24,40,64
19282,32009,65+,105,137,242
19283,32011,15-19,49,62,111
19284,32011,20-24,33,32,65
19285,32011,25-29,36,56,92
19286,32011,30-34,69,60,129
19287,32011,35-39,57,57,114
19288,32011,40-44,49,66,115
19289,32011,45-49,49,70,119
19290,32011,50-54,67,83,150
19291,32011,55-59,72,83,155
19292,32011,60-64,70,92,162
19293,32011,65+,149,196,345
19294,32013,15-19,549,602,1151
19295,32013,20-24,465,485,950
19296,32013,25-29,542,584,1126
19297,32013,30-34,616,631,1247
19298,32013,35-39,546,684,1230
19299,32013,40-44,467,582,1049
19300,32013,45-49,453,523,976
19301,32013,50-54,487,545,1032
19302,32013,55-59,513,544,1057
19303,32013,60-64,543,599,1142
19304,32013,65+,1296,1348,2644
19305,32015,15-19,197,198,395
19306,32015,20-24,131,134,265
19307,32015,25-29,149,174,323
19308,32015,30-34,202,191,393
19309,32015,35-39,197,199,396
19310,32015,40-44,153,194,347
19311,32015,45-49,131,158,289
19312,32015,50-54,166,199,365
19313,32015,55-59,189,208,397
19314,32015,60-64,166,210,376
19315,32015,65+,474,479,953
19316,32017,15-19,115,147,262
19317,32017,20-24,80,134,214
19318,32017,25-29,121,147,268
19319,32017,30-34,112,134,246
19320,32017,35-39,115,150,265
19321,32017,40-44,134,160,294
19322,32017,45-49,114,119,233
19323,32017,50-54,126,160,286
19324,32017,55-59,138,158,296
19325,32017,60-64,159,176,335
19326,32017,65+,529,563,1092
19327,32019,15-19,1571,1879,3450
19328,32019,20-24,1363,1442,2805
19329,32019,25-29,1818,2019,3837
19330,32019,30-34,1958,2343,4301
19331,32019,35-39,1851,2129,3980
19332,32019,40-44,1685,1877,3562
19333,32019,45-49,1561,1646,3207
19334,32019,50-54,1717,1871,3588
19335,32019,55-59,2072,2130,4202
19336,32019,60-64,2180,2348,4528
19337,32019,65+,6530,6496,13026
19338,32021,15-19,99,127,226
19339,32021,20-24,107,85,192
19340,32021,25-29,128,120,248
19341,32021,30-34,144,152,296
19342,32021,35-39,125,164,289
19343,32021,40-44,117,139,256
19344,32021,45-49,102,87,189
19345,32021,50-54,142,128,270
19346,32021,55-59,163,160,323
19347,32021,60-64,189,193,382
19348,32021,65+,585,571,1156
19349,32023,15-19,1206,1286,2492
19350,32023,20-24,1013,1358,2371
19351,32023,25-29,1178,1470,2648
19352,32023,30-34,1180,1403,2583
19353,32023,35-39,1233,1258,2491
19354,32023,40-44,1185,1333,2518
19355,32023,45-49,1247,1272,2519
19356,32023,50-54,1603,1571,3174
19357,32023,55-59,2057,2113,4170
19358,32023,60-64,2426,2433,4859
19359,32023,65+,8052,8320,16372
19360,32027,15-19,127,152,279
19361,32027,20-24,111,280,391
19362,32027,25-29,144,364,508
19363,32027,30-34,150,381,531
19364,32027,35-39,131,387,518
19365,32027,40-44,118,379,497
19366,32027,45-49,120,380,500
19367,32027,50-54,164,359,523
19368,32027,55-59,160,305,465
19369,32027,60-64,184,269,453
19370,32027,65+,505,636,1141
19371,32029,15-19,84,83,167
19372,32029,20-24,71,74,145
19373,32029,25-29,93,102,195
19374,32029,30-34,88,111,199
19375,32029,35-39,90,99,189
19376,32029,40-44,90,104,194
19377,32029,45-49,119,115,234
19378,32029,50-54,129,135,264
19379,32029,55-59,161,171,332
19380,32029,60-64,212,227,439
19381,32029,65+,674,699,1373
19382,32031,15-19,14193,15118,29311
19383,32031,20-24,15156,15900,31056
19384,32031,25-29,17598,18820,36418
19385,32031,30-34,18299,19859,38158
19386,32031,35-39,16507,17914,34421
19387,32031,40-44,14852,15478,30330
19388,32031,45-49,13660,14319,27979
19389,32031,50-54,14882,15927,30809
19390,32031,55-59,15712,15861,31573
19391,32031,60-64,16031,16136,32167
19392,32031,65+,44166,40618,84784
19393,32033,15-19,233,265,498
19394,32033,20-24,184,322,506
19395,32033,25-29,223,416,639
19396,32033,30-34,224,470,694
19397,32033,35-39,242,378,620
19398,32033,40-44,226,412,638
19399,32033,45-49,200,336,536
19400,32033,50-54,221,317,538
19401,32033,55-59,267,350,617
19402,32033,60-64,276,352,628
19403,32033,65+,841,905,1746
19404,32510,15-19,1591,1704,3295
19405,32510,20-24,1466,1737,3203
19406,32510,25-29,1707,2093,3800
19407,32510,30-34,1788,2220,4008
19408,32510,35-39,1624,2080,3704
19409,32510,40-44,1543,1862,3405
19410,32510,45-49,1484,1769,3253
19411,32510,50-54,1674,1995,3669
19412,32510,55-59,1990,2078,4068
19413,32510,60-64,2229,2161,4390
19414,32510,65+,6671,5740,12411
19415,33001,15-19,1659,1807,3466
19416,33001,20-24,1494,1632,3126
19417,33001,25-29,1680,1831,3511
19418,33001,30-34,1698,1807,3505
19419,33001,35-39,1830,1757,3587
19420,33001,40-44,1882,1847,3729
19421,33001,45-49,1806,1814,3620
19422,33001,50-54,2202,2147,4349
19423,33001,55-59,2729,2640,5369
19424,33001,60-64,3052,2997,6049
19425,33001,65+,7800,7142,14942
19426,33003,15-19,1075,1203,2278
19427,33003,20-24,1037,1156,2193
19428,33003,25-29,1104,1200,2304
19429,33003,30-34,1202,1266,2468
19430,33003,35-39,1307,1256,2563
19431,33003,40-44,1244,1148,2392
19432,33003,45-49,1303,1267,2570
19433,33003,50-54,1754,1749,3503
19434,33003,55-59,2335,2119,4454
19435,33003,60-64,2757,2621,5378
19436,33003,65+,7696,7454,15150
19437,33005,15-19,2717,2623,5340
19438,33005,20-24,2616,2563,5179
19439,33005,25-29,2198,2250,4448
19440,33005,30-34,2441,2576,5017
19441,33005,35-39,2325,2366,4691
19442,33005,40-44,2029,2075,4104
19443,33005,45-49,2006,1964,3970
19444,33005,50-54,2481,2441,4922
19445,33005,55-59,2869,2819,5688
19446,33005,60-64,3142,3009,6151
19447,33005,65+,8817,7728,16545
19448,33007,15-19,707,773,1480
19449,33007,20-24,642,911,1553
19450,33007,25-29,697,1048,1745
19451,33007,30-34,715,972,1687
19452,33007,35-39,772,956,1728
19453,33007,40-44,818,949,1767
19454,33007,45-49,855,1018,1873
19455,33007,50-54,987,1242,2229
19456,33007,55-59,1282,1306,2588
19457,33007,60-64,1328,1438,2766
19458,33007,65+,3984,3780,7764
19459,33009,15-19,3373,3497,6870
19460,33009,20-24,3611,3908,7519
19461,33009,25-29,2800,2777,5577
19462,33009,30-34,2814,2920,5734
19463,33009,35-39,2571,2721,5292
19464,33009,40-44,2389,2346,4735
19465,33009,45-49,2471,2254,4725
19466,33009,50-54,2893,2675,5568
19467,33009,55-59,3334,3250,6584
19468,33009,60-64,3820,3629,7449
19469,33009,65+,10649,9740,20389
19470,33011,15-19,12315,12956,25271
19471,33011,20-24,12351,13047,25398
19472,33011,25-29,14331,15505,29836
19473,33011,30-34,14758,15861,30619
19474,33011,35-39,13843,14480,28323
19475,33011,40-44,12872,13169,26041
19476,33011,45-49,12732,12848,25580
19477,33011,50-54,14888,15190,30078
19478,33011,55-59,16256,16439,32695
19479,33011,60-64,15551,15601,31152
19480,33011,65+,38290,32324,70614
19481,33013,15-19,4814,4829,9643
19482,33013,20-24,4578,4832,9410
19483,33013,25-29,4553,5018,9571
19484,33013,30-34,4849,5212,10061
19485,33013,35-39,4796,5286,10082
19486,33013,40-44,4737,4783,9520
19487,33013,45-49,4372,4681,9053
19488,33013,50-54,5364,5262,10626
19489,33013,55-59,6174,5741,11915
19490,33013,60-64,6138,5949,12087
19491,33013,65+,16356,13623,29979
19492,33015,15-19,8662,9187,17849
19493,33015,20-24,7872,8636,16508
19494,33015,25-29,9034,9735,18769
19495,33015,30-34,9809,10174,19983
19496,33015,35-39,9962,10266,20228
19497,33015,40-44,9218,9401,18619
19498,33015,45-49,9693,9512,19205
19499,33015,50-54,11958,11892,23850
19500,33015,55-59,13433,13265,26698
19501,33015,60-64,13438,13117,26555
19502,33015,65+,32571,28367,60938
19503,33017,15-19,5532,4973,10505
19504,33017,20-24,7278,6577,13855
19505,33017,25-29,4410,4869,9279
19506,33017,30-34,4304,4817,9121
19507,33017,35-39,4085,4212,8297
19508,33017,40-44,3672,3758,7430
19509,33017,45-49,3532,3492,7024
19510,33017,50-54,4206,4198,8404
19511,33017,55-59,4678,4497,9175
19512,33017,60-64,4546,4489,9035
19513,33017,65+,11534,9663,21197
19514,33019,15-19,1098,1174,2272
19515,33019,20-24,1011,1074,2085
19516,33019,25-29,1138,1246,2384
19517,33019,30-34,1312,1377,2689
19518,33019,35-39,1228,1285,2513
19519,33019,40-44,1208,1201,2409
19520,33019,45-49,1297,1257,2554
19521,33019,50-54,1504,1615,3119
19522,33019,55-59,1754,1732,3486
19523,33019,60-64,1827,1858,3685
19524,33019,65+,5280,4723,10003
19525,34001,15-19,8377,8783,17160
19526,34001,20-24,8540,8692,17232
19527,34001,25-29,8487,8536,17023
19528,34001,30-34,8088,8054,16142
19529,34001,35-39,7924,7756,15680
19530,34001,40-44,7782,7432,15214
19531,34001,45-49,8331,7575,15906
19532,34001,50-54,9713,8976,18689
19533,34001,55-59,10800,9994,20794
19534,34001,60-64,10865,10128,20993
19535,34001,65+,29030,23979,53009
19536,34003,15-19,28947,30305,59252
19537,34003,20-24,27137,27514,54651
19538,34003,25-29,26445,26958,53403
19539,34003,30-34,27822,28084,55906
19540,34003,35-39,31815,31365,63180
19541,34003,40-44,33209,32022,65231
19542,34003,45-49,32318,31628,63946
19543,34003,50-54,35022,33932,68954
19544,34003,55-59,35966,34763,70729
19545,34003,60-64,33741,32105,65846
19546,34003,65+,94580,75425,170005
19547,34005,15-19,13382,14497,27879
19548,34005,20-24,12705,15125,27830
19549,34005,25-29,14051,15313,29364
19550,34005,30-34,14429,14895,29324
19551,34005,35-39,14862,15189,30051
19552,34005,40-44,14748,15160,29908
19553,34005,45-49,14370,14352,28722
19554,34005,50-54,16433,16118,32551
19555,34005,55-59,18189,17154,35343
19556,34005,60-64,17036,16681,33717
19557,34005,65+,46079,36030,82109
19558,34007,15-19,15583,16598,32181
19559,34007,20-24,15262,15306,30568
19560,34007,25-29,17660,17269,34929
19561,34007,30-34,18872,18310,37182
19562,34007,35-39,18373,17964,36337
19563,34007,40-44,17260,16397,33657
19564,34007,45-49,16272,15243,31515
19565,34007,50-54,17808,16695,34503
19566,34007,55-59,18362,16871,35233
19567,34007,60-64,17956,16485,34441
19568,34007,65+,48321,36905,85226
19569,34009,15-19,2244,2493,4737
19570,34009,20-24,2210,2591,4801
19571,34009,25-29,2390,2674,5064
19572,34009,30-34,2282,2544,4826
19573,34009,35-39,2342,2410,4752
19574,34009,40-44,2325,2249,4574
19575,34009,45-49,2228,2266,4494
19576,34009,50-54,2885,2903,5788
19577,34009,55-59,3916,3541,7457
19578,34009,60-64,4554,4049,8603
19579,34009,65+,14694,12299,26993
19580,34011,15-19,4910,5034,9944
19581,34011,20-24,4270,4774,9044
19582,34011,25-29,4574,5509,10083
19583,34011,30-34,4649,6282,10931
19584,34011,35-39,4543,5713,10256
19585,34011,40-44,4484,5373,9857
19586,34011,45-49,4501,4983,9484
19587,34011,50-54,4939,4845,9784
19588,34011,55-59,5014,4905,9919
19589,34011,60-64,4755,4494,9249
19590,34011,65+,13415,10941,24356
19591,34013,15-19,26463,27774,54237
19592,34013,20-24,26043,25976,52019
19593,34013,25-29,27982,27403,55385
19594,34013,30-34,30533,29205,59738
19595,34013,35-39,30855,29358,60213
19596,34013,40-44,31209,29438,60647
19597,34013,45-49,29552,28269,57821
19598,34013,50-54,30162,28857,59019
19599,34013,55-59,28391,27158,55549
19600,34013,60-64,26456,24060,50516
19601,34013,65+,70316,50701,121017
19602,34015,15-19,9489,10074,19563
19603,34015,20-24,9309,9761,19070
19604,34015,25-29,9195,9551,18746
19605,34015,30-34,9704,9767,19471
19606,34015,35-39,10149,9578,19727
19607,34015,40-44,10039,9494,19533
19608,34015,45-49,9875,9211,19086
19609,34015,50-54,11114,10420,21534
19610,34015,55-59,11337,11044,22381
19611,34015,60-64,11003,10347,21350
19612,34015,65+,28348,22585,50933
19613,34017,15-19,16577,17557,34134
19614,34017,20-24,18687,20220,38907
19615,34017,25-29,32713,33125,65838
19616,34017,30-34,36791,39582,76373
19617,34017,35-39,30136,33875,64011
19618,34017,40-44,24438,26607,51045
19619,34017,45-49,20773,21976,42749
19620,34017,50-54,21119,20553,41672
19621,34017,55-59,20581,20037,40618
19622,34017,60-64,18600,17795,36395
19623,34017,65+,50969,37662,88631
19624,34019,15-19,3860,4161,8021
19625,34019,20-24,3665,4451,8116
19626,34019,25-29,3109,3312,6421
19627,34019,30-34,3180,3037,6217
19628,34019,35-39,3600,3578,7178
19629,34019,40-44,3892,3728,7620
19630,34019,45-49,4056,3912,7968
19631,34019,50-54,5262,4967,10229
19632,34019,55-59,5946,5647,11593
19633,34019,60-64,5565,5588,11153
19634,34019,65+,13741,12385,26126
19635,34021,15-19,14103,14113,28216
19636,34021,20-24,14591,14284,28875
19637,34021,25-29,11537,12204,23741
19638,34021,30-34,11578,12068,23646
19639,34021,35-39,12016,12248,24264
19640,34021,40-44,12507,12604,25111
19641,34021,45-49,12559,12620,25179
19642,34021,50-54,13318,13197,26515
19643,34021,55-59,13408,13101,26509
19644,34021,60-64,12677,12068,24745
19645,34021,65+,34803,26872,61675
19646,34023,15-19,28385,29892,58277
19647,34023,20-24,26520,27345,53865
19648,34023,25-29,26838,27206,54044
19649,34023,30-34,28124,28976,57100
19650,34023,35-39,29614,31171,60785
19651,34023,40-44,29210,30091,59301
19652,34023,45-49,27884,29029,56913
19653,34023,50-54,28853,29382,58235
19654,34023,55-59,29263,29096,58359
19655,34023,60-64,28104,27033,55137
19656,34023,65+,75527,60944,136471
19657,34025,15-19,20451,21377,41828
19658,34025,20-24,18402,18900,37302
19659,34025,25-29,17920,18540,36460
19660,34025,30-34,17464,17547,35011
19661,34025,35-39,18850,18626,37476
19662,34025,40-44,19654,18890,38544
19663,34025,45-49,20376,19844,40220
19664,34025,50-54,24270,23378,47648
19665,34025,55-59,26991,25573,52564
19666,34025,60-64,25605,24859,50464
19667,34025,65+,66608,53896,120504
19668,34027,15-19,16247,17276,33523
19669,34027,20-24,15062,15138,30200
19670,34027,25-29,13861,14654,28515
19671,34027,30-34,14323,14980,29303
19672,34027,35-39,15966,16380,32346
19673,34027,40-44,16376,16616,32992
19674,34027,45-49,16649,16282,32931
19675,34027,50-54,19455,19341,38796
19676,34027,55-59,20472,20332,40804
19677,34027,60-64,18420,18193,36613
19678,34027,65+,49978,40803,90781
19679,34029,15-19,18906,20174,39080
19680,34029,20-24,17015,17471,34486
19681,34029,25-29,18196,18760,36956
19682,34029,30-34,17278,17758,35036
19683,34029,35-39,16889,17354,34243
19684,34029,40-44,16091,16570,32661
19685,34029,45-49,15892,15897,31789
19686,34029,50-54,18817,18017,36834
19687,34029,55-59,21880,20594,42474
19688,34029,60-64,23973,21576,45549
19689,34029,65+,82378,62893,145271
19690,34031,15-19,17416,17892,35308
19691,34031,20-24,17529,17199,34728
19692,34031,25-29,17094,16979,34073
19693,34031,30-34,17136,17568,34704
19694,34031,35-39,16515,16980,33495
19695,34031,40-44,16147,16242,32389
19696,34031,45-49,16085,15512,31597
19697,34031,50-54,17199,16854,34053
19698,34031,55-59,17614,17114,34728
19699,34031,60-64,16522,15673,32195
19700,34031,65+,44324,34830,79154
19701,34033,15-19,1847,2033,3880
19702,34033,20-24,1736,1900,3636
19703,34033,25-29,1961,2041,4002
19704,34033,30-34,1922,1902,3824
19705,34033,35-39,1956,2014,3970
19706,34033,40-44,1969,2007,3976
19707,34033,45-49,1895,1904,3799
19708,34033,50-54,2155,2172,4327
19709,34033,55-59,2460,2307,4767
19710,34033,60-64,2453,2345,4798
19711,34033,65+,6871,5576,12447
19712,34035,15-19,10884,11887,22771
19713,34035,20-24,10028,10046,20074
19714,34035,25-29,9674,9831,19505
19715,34035,30-34,9750,9880,19630
19716,34035,35-39,10967,10745,21712
19717,34035,40-44,11879,11509,23388
19718,34035,45-49,11805,11888,23693
19719,34035,50-54,13241,13081,26322
19720,34035,55-59,13917,13597,27514
19721,34035,60-64,12486,12239,24725
19722,34035,65+,32131,25480,57611
19723,34037,15-19,4263,4497,8760
19724,34037,20-24,3915,4165,8080
19725,34037,25-29,3981,4333,8314
19726,34037,30-34,4077,4456,8533
19727,34037,35-39,4277,4605,8882
19728,34037,40-44,4317,4479,8796
19729,34037,45-49,4449,4441,8890
19730,34037,50-54,5722,5629,11351
19731,34037,55-59,6189,6240,12429
19732,34037,60-64,5917,6038,11955
19733,34037,65+,14386,12758,27144
19734,34039,15-19,17790,18697,36487
19735,34039,20-24,16538,16986,33524
19736,34039,25-29,16918,17015,33933
19737,34039,30-34,18438,18749,37187
19738,34039,35-39,19802,19968,39770
19739,34039,40-44,20377,20227,40604
19740,34039,45-49,19030,19500,38530
19741,34039,50-54,20193,19943,40136
19742,34039,55-59,20083,19691,39774
19743,34039,60-64,18315,17847,36162
19744,34039,65+,48110,37078,85188
19745,34041,15-19,3377,3356,6733
19746,34041,20-24,3194,3244,6438
19747,34041,25-29,3097,3299,6396
19748,34041,30-34,3156,3362,6518
19749,34041,35-39,3281,3308,6589
19750,34041,40-44,3220,3279,6499
19751,34041,45-49,3354,3331,6685
19752,34041,50-54,4168,4151,8319
19753,34041,55-59,4675,4638,9313
19754,34041,60-64,4501,4448,8949
19755,34041,65+,11630,9636,21266
19756,35001,15-19,21171,21780,42951
19757,35001,20-24,21375,22029,43404
19758,35001,25-29,23594,24379,47973
19759,35001,30-34,24735,25378,50113
19760,35001,35-39,24136,24697,48833
19761,35001,40-44,21699,22004,43703
19762,35001,45-49,19588,19551,39139
19763,35001,50-54,20163,19630,39793
19764,35001,55-59,21871,20649,42520
19765,35001,60-64,22829,20725,43554
19766,35001,65+,64974,52207,117181
19767,35003,15-19,68,76,144
19768,35003,20-24,62,61,123
19769,35003,25-29,68,73,141
19770,35003,30-34,50,70,120
19771,35003,35-39,57,57,114
19772,35003,40-44,72,68,140
19773,35003,45-49,64,72,136
19774,35003,50-54,80,86,166
19775,35003,55-59,143,124,267
19776,35003,60-64,223,209,432
19777,35003,65+,730,856,1586
19778,35005,15-19,2423,2946,5369
19779,35005,20-24,1971,2258,4229
19780,35005,25-29,2006,2068,4074
19781,35005,30-34,2100,2103,4203
19782,35005,35-39,2125,2099,4224
19783,35005,40-44,2025,2010,4035
19784,35005,45-49,1762,1668,3430
19785,35005,50-54,1735,1748,3483
19786,35005,55-59,2006,1859,3865
19787,35005,60-64,1999,1933,3932
19788,35005,65+,5576,4760,10336
19789,35006,15-19,854,847,1701
19790,35006,20-24,802,884,1686
19791,35006,25-29,845,1089,1934
19792,35006,30-34,933,1098,2031
19793,35006,35-39,780,1020,1800
19794,35006,40-44,802,1018,1820
19795,35006,45-49,662,831,1493
19796,35006,50-54,727,812,1539
19797,35006,55-59,775,769,1544
19798,35006,60-64,918,861,1779
19799,35006,65+,2506,2111,4617
19800,35007,15-19,301,323,624
19801,35007,20-24,261,331,592
19802,35007,25-29,321,352,673
19803,35007,30-34,301,367,668
19804,35007,35-39,309,328,637
19805,35007,40-44,304,314,618
19806,35007,45-49,284,330,614
19807,35007,50-54,355,357,712
19808,35007,55-59,440,457,897
19809,35007,60-64,555,520,1075
19810,35007,65+,1776,1727,3503
19811,35009,15-19,1525,1780,3305
19812,35009,20-24,1722,2720,4442
19813,35009,25-29,1866,2422,4288
19814,35009,30-34,1806,1991,3797
19815,35009,35-39,1595,1690,3285
19816,35009,40-44,1234,1361,2595
19817,35009,45-49,1112,1078,2190
19818,35009,50-54,1080,1079,2159
19819,35009,55-59,1292,1166,2458
19820,35009,60-64,1211,1242,2453
19821,35009,65+,3443,2851,6294
19822,35011,15-19,47,49,96
19823,35011,20-24,42,49,91
19824,35011,25-29,32,40,72
19825,35011,30-34,32,33,65
19826,35011,35-39,38,49,87
19827,35011,40-44,45,39,84
19828,35011,45-49,37,34,71
19829,35011,50-54,39,41,80
19830,35011,55-59,56,60,116
19831,35011,60-64,67,59,126
19832,35011,65+,251,248,499
19833,35013,15-19,8891,9104,17995
19834,35013,20-24,11632,11412,23044
19835,35013,25-29,7665,8228,15893
19836,35013,30-34,6467,6779,13246
19837,35013,35-39,6521,6818,13339
19838,35013,40-44,5972,6090,12062
19839,35013,45-49,5834,5295,11129
19840,35013,50-54,5692,5231,10923
19841,35013,55-59,6189,5530,11719
19842,35013,60-64,6546,5627,12173
19843,35013,65+,19471,17131,36602
19844,35015,15-19,2069,2115,4184
19845,35015,20-24,1796,1939,3735
19846,35015,25-29,1981,2129,4110
19847,35015,30-34,2051,2278,4329
19848,35015,35-39,2010,2415,4425
19849,35015,40-44,1809,2080,3889
19850,35015,45-49,1596,1639,3235
19851,35015,50-54,1641,1720,3361
19852,35015,55-59,1743,1799,3542
19853,35015,60-64,1744,1817,3561
19854,35015,65+,4806,4210,9016
19855,35017,15-19,778,810,1588
19856,35017,20-24,691,805,1496
19857,35017,25-29,662,712,1374
19858,35017,30-34,613,632,1245
19859,35017,35-39,686,701,1387
19860,35017,40-44,786,728,1514
19861,35017,45-49,679,710,1389
19862,35017,50-54,738,703,1441
19863,35017,55-59,912,804,1716
19864,35017,60-64,1097,1058,2155
19865,35017,65+,4295,3945,8240
19866,35019,15-19,126,148,274
19867,35019,20-24,93,184,277
19868,35019,25-29,99,225,324
19869,35019,30-34,99,239,338
19870,35019,35-39,139,196,335
19871,35019,40-44,110,179,289
19872,35019,45-49,84,136,220
19873,35019,50-54,95,123,218
19874,35019,55-59,130,153,283
19875,35019,60-64,141,153,294
19876,35019,65+,423,464,887
19877,35021,15-19,5,10,15
19878,35021,20-24,7,10,17
19879,35021,25-29,18,6,24
19880,35021,30-34,9,9,18
19881,35021,35-39,22,19,41
19882,35021,40-44,13,22,35
19883,35021,45-49,7,14,21
19884,35021,50-54,11,11,22
19885,35021,55-59,25,30,55
19886,35021,60-64,25,34,59
19887,35021,65+,131,133,264
19888,35023,15-19,118,122,240
19889,35023,20-24,102,116,218
19890,35023,25-29,103,135,238
19891,35023,30-34,97,117,214
19892,35023,35-39,108,142,250
19893,35023,40-44,100,89,189
19894,35023,45-49,101,91,192
19895,35023,50-54,131,126,257
19896,35023,55-59,153,158,311
19897,35023,60-64,143,139,282
19898,35023,65+,490,450,940
19899,35025,15-19,2875,3026,5901
19900,35025,20-24,2334,2721,5055
19901,35025,25-29,2376,2757,5133
19902,35025,30-34,2384,2700,5084
19903,35025,35-39,2463,2802,5265
19904,35025,40-44,2168,2467,4635
19905,35025,45-49,1991,2096,4087
19906,35025,50-54,1804,1980,3784
19907,35025,55-59,1812,2045,3857
19908,35025,60-64,1825,1916,3741
19909,35025,65+,4427,3893,8320
19910,35027,15-19,505,572,1077
19911,35027,20-24,400,429,829
19912,35027,25-29,396,460,856
19913,35027,30-34,484,460,944
19914,35027,35-39,613,487,1100
19915,35027,40-44,523,464,987
19916,35027,45-49,459,474,933
19917,35027,50-54,534,531,1065
19918,35027,55-59,785,720,1505
19919,35027,60-64,1005,818,1823
19920,35027,65+,3236,3036,6272
19921,35028,15-19,587,602,1189
19922,35028,20-24,427,466,893
19923,35028,25-29,544,648,1192
19924,35028,30-34,645,799,1444
19925,35028,35-39,597,794,1391
19926,35028,40-44,605,648,1253
19927,35028,45-49,565,548,1113
19928,35028,50-54,640,609,1249
19929,35028,55-59,653,729,1382
19930,35028,60-64,615,694,1309
19931,35028,65+,1820,1727,3547
19932,35029,15-19,851,935,1786
19933,35029,20-24,742,855,1597
19934,35029,25-29,769,891,1660
19935,35029,30-34,696,755,1451
19936,35029,35-39,667,816,1483
19937,35029,40-44,642,603,1245
19938,35029,45-49,604,604,1208
19939,35029,50-54,666,656,1322
19940,35029,55-59,707,722,1429
19941,35029,60-64,777,689,1466
19942,35029,65+,2650,2574,5224
19943,35031,15-19,2814,2897,5711
19944,35031,20-24,2326,2240,4566
19945,35031,25-29,2557,2500,5057
19946,35031,30-34,2742,2751,5493
19947,35031,35-39,2347,2320,4667
19948,35031,40-44,2150,2121,4271
19949,35031,45-49,2070,1853,3923
19950,35031,50-54,2021,1854,3875
19951,35031,55-59,2268,1960,4228
19952,35031,60-64,2155,1896,4051
19953,35031,65+,5612,3912,9524
19954,35033,15-19,107,105,212
19955,35033,20-24,91,117,208
19956,35033,25-29,96,98,194
19957,35033,30-34,96,92,188
19958,35033,35-39,93,108,201
19959,35033,40-44,117,107,224
19960,35033,45-49,90,96,186
19961,35033,50-54,131,118,249
19962,35033,55-59,165,165,330
19963,35033,60-64,178,195,373
19964,35033,65+,589,655,1244
19965,35035,15-19,1989,2151,4140
19966,35035,20-24,2138,3232,5370
19967,35035,25-29,2207,3036,5243
19968,35035,30-34,2262,2827,5089
19969,35035,35-39,2163,2467,4630
19970,35035,40-44,1836,1982,3818
19971,35035,45-49,1641,1687,3328
19972,35035,50-54,1759,1708,3467
19973,35035,55-59,2034,1916,3950
19974,35035,60-64,2205,2165,4370
19975,35035,65+,6362,5770,12132
19976,35037,15-19,237,277,514
19977,35037,20-24,186,199,385
19978,35037,25-29,189,227,416
19979,35037,30-34,203,236,439
19980,35037,35-39,224,227,451
19981,35037,40-44,222,225,447
19982,35037,45-49,205,194,399
19983,35037,50-54,260,257,517
19984,35037,55-59,322,294,616
19985,35037,60-64,335,329,664
19986,35037,65+,1201,1065,2266
19987,35039,15-19,1256,1289,2545
19988,35039,20-24,1109,1124,2233
19989,35039,25-29,1091,1096,2187
19990,35039,30-34,1162,1200,2362
19991,35039,35-39,1160,1162,2322
19992,35039,40-44,1115,1158,2273
19993,35039,45-49,1127,1100,2227
19994,35039,50-54,1207,1176,2383
19995,35039,55-59,1366,1354,2720
19996,35039,60-64,1503,1476,2979
19997,35039,65+,4508,3873,8381
19998,35041,15-19,832,870,1702
19999,35041,20-24,1203,1137,2340
20000,35041,25-29,702,745,1447
20001,35041,30-34,502,555,1057
20002,35041,35-39,495,562,1057
20003,35041,40-44,480,494,974
20004,35041,45-49,484,469,953
20005,35041,50-54,469,471,940
20006,35041,55-59,427,471,898
20007,35041,60-64,535,431,966
20008,35041,65+,1518,1330,2848
20009,35043,15-19,4819,5179,9998
20010,35043,20-24,3975,4134,8109
20011,35043,25-29,4235,4350,8585
20012,35043,30-34,4795,4913,9708
20013,35043,35-39,5169,5263,10432
20014,35043,40-44,4873,4942,9815
20015,35043,45-49,4611,4485,9096
20016,35043,50-54,4650,4526,9176
20017,35043,55-59,4964,4830,9794
20018,35043,60-64,5346,4970,10316
20019,35043,65+,15653,13271,28924
20020,35045,15-19,4469,4554,9023
20021,35045,20-24,3519,3662,7181
20022,35045,25-29,3712,3811,7523
20023,35045,30-34,4055,4150,8205
20024,35045,35-39,4047,4190,8237
20025,35045,40-44,3851,3920,7771
20026,35045,45-49,3291,3258,6549
20027,35045,50-54,3349,3197,6546
20028,35045,55-59,3737,3641,7378
20029,35045,60-64,3964,4032,7996
20030,35045,65+,10647,8867,19514
20031,35047,15-19,876,922,1798
20032,35047,20-24,815,858,1673
20033,35047,25-29,809,841,1650
20034,35047,30-34,736,817,1553
20035,35047,35-39,724,785,1509
20036,35047,40-44,741,764,1505
20037,35047,45-49,768,709,1477
20038,35047,50-54,779,840,1619
20039,35047,55-59,988,1032,2020
20040,35047,60-64,1074,1122,2196
20041,35047,65+,3456,2992,6448
20042,35049,15-19,4276,4171,8447
20043,35049,20-24,3811,4011,7822
20044,35049,25-29,4040,4139,8179
20045,35049,30-34,4371,4478,8849
20046,35049,35-39,4529,4822,9351
20047,35049,40-44,4384,4512,8896
20048,35049,45-49,4319,4297,8616
20049,35049,50-54,4830,4793,9623
20050,35049,55-59,5693,5161,10854
20051,35049,60-64,6597,5745,12342
20052,35049,65+,22360,18968,41328
20053,35051,15-19,226,251,477
20054,35051,20-24,190,234,424
20055,35051,25-29,245,259,504
20056,35051,30-34,223,250,473
20057,35051,35-39,244,243,487
20058,35051,40-44,239,249,488
20059,35051,45-49,256,245,501
20060,35051,50-54,325,287,612
20061,35051,55-59,414,349,763
20062,35051,60-64,516,452,968
20063,35051,65+,2097,2164,4261
20064,35053,15-19,533,695,1228
20065,35053,20-24,523,638,1161
20066,35053,25-29,430,493,923
20067,35053,30-34,448,466,914
20068,35053,35-39,429,475,904
20069,35053,40-44,410,456,866
20070,35053,45-49,412,437,849
20071,35053,50-54,462,432,894
20072,35053,55-59,531,528,1059
20073,35053,60-64,604,534,1138
20074,35053,65+,1773,1599,3372
20075,35055,15-19,832,972,1804
20076,35055,20-24,727,793,1520
20077,35055,25-29,776,842,1618
20078,35055,30-34,907,932,1839
20079,35055,35-39,955,920,1875
20080,35055,40-44,979,1002,1981
20081,35055,45-49,894,968,1862
20082,35055,50-54,1057,1115,2172
20083,35055,55-59,1314,1171,2485
20084,35055,60-64,1493,1335,2828
20085,35055,65+,5313,4617,9930
20086,35057,15-19,485,482,967
20087,35057,20-24,366,526,892
20088,35057,25-29,368,578,946
20089,35057,30-34,379,467,846
20090,35057,35-39,353,557,910
20091,35057,40-44,421,457,878
20092,35057,45-49,383,469,852
20093,35057,50-54,446,461,907
20094,35057,55-59,525,510,1035
20095,35057,60-64,585,578,1163
20096,35057,65+,1650,1722,3372
20097,35059,15-19,117,98,215
20098,35059,20-24,65,163,228
20099,35059,25-29,74,216,290
20100,35059,30-34,102,192,294
20101,35059,35-39,89,186,275
20102,35059,40-44,86,187,273
20103,35059,45-49,87,143,230
20104,35059,50-54,94,132,226
20105,35059,55-59,99,126,225
20106,35059,60-64,133,147,280
20107,35059,65+,498,391,889
20108,35061,15-19,2508,2703,5211
20109,35061,20-24,2302,2436,4738
20110,35061,25-29,2302,2499,4801
20111,35061,30-34,2322,2523,4845
20112,35061,35-39,2412,2466,4878
20113,35061,40-44,2217,2382,4599
20114,35061,45-49,2093,2265,4358
20115,35061,50-54,2244,2393,4637
20116,35061,55-59,2551,2510,5061
20117,35061,60-64,2690,2578,5268
20118,35061,65+,7442,6743,14185
20119,36001,15-19,11498,10892,22390
20120,36001,20-24,16480,15591,32071
20121,36001,25-29,10753,10865,21618
20122,36001,30-34,10128,9994,20122
20123,36001,35-39,9866,10025,19891
20124,36001,40-44,9192,9010,18202
20125,36001,45-49,8455,8098,16553
20126,36001,50-54,9460,9409,18869
20127,36001,55-59,10600,10006,20606
20128,36001,60-64,10481,9900,20381
20129,36001,65+,31480,24650,56130
20130,36003,15-19,1974,2379,4353
20131,36003,20-24,1890,2158,4048
20132,36003,25-29,1076,1168,2244
20133,36003,30-34,1147,1170,2317
20134,36003,35-39,1253,1247,2500
20135,36003,40-44,1199,1223,2422
20136,36003,45-49,1143,1173,2316
20137,36003,50-54,1336,1352,2688
20138,36003,55-59,1512,1540,3052
20139,36003,60-64,1648,1721,3369
20140,36003,65+,4702,4528,9230
20141,36005,15-19,46231,49352,95583
20142,36005,20-24,47848,48261,96109
20143,36005,25-29,54978,51793,106771
20144,36005,30-34,56347,53279,109626
20145,36005,35-39,50000,45649,95649
20146,36005,40-44,47329,40844,88173
20147,36005,45-49,44372,37953,82325
20148,36005,50-54,47378,41151,88529
20149,36005,55-59,48937,41766,90703
20150,36005,60-64,43976,36425,80401
20151,36005,65+,118677,80421,199098
20152,36007,15-19,7139,7860,14999
20153,36007,20-24,9559,10048,19607
20154,36007,25-29,5786,5994,11780
20155,36007,30-34,5240,5375,10615
20156,36007,35-39,5496,5507,11003
20157,36007,40-44,5174,5216,10390
20158,36007,45-49,4762,4696,9458
20159,36007,50-54,5754,5768,11522
20160,36007,55-59,6792,6506,13298
20161,36007,60-64,7206,7125,14331
20162,36007,65+,21380,17427,38807
20163,36009,15-19,2563,2643,5206
20164,36009,20-24,2233,2449,4682
20165,36009,25-29,1953,2015,3968
20166,36009,30-34,2068,2115,4183
20167,36009,35-39,2118,2224,4342
20168,36009,40-44,2139,2159,4298
20169,36009,45-49,2110,2081,4191
20170,36009,50-54,2404,2445,4849
20171,36009,55-59,2766,2811,5577
20172,36009,60-64,2962,2909,5871
20173,36009,65+,8110,7375,15485
20174,36011,15-19,2078,2227,4305
20175,36011,20-24,2029,2310,4339
20176,36011,25-29,2012,2585,4597
20177,36011,30-34,2107,2593,4700
20178,36011,35-39,2231,2583,4814
20179,36011,40-44,2038,2444,4482
20180,36011,45-49,1920,2263,4183
20181,36011,50-54,2460,2651,5111
20182,36011,55-59,2786,2982,5768
20183,36011,60-64,3020,2931,5951
20184,36011,65+,8185,7436,15621
20185,36013,15-19,4288,4417,8705
20186,36013,20-24,3726,4054,7780
20187,36013,25-29,3290,3755,7045
20188,36013,30-34,3695,3751,7446
20189,36013,35-39,3531,3652,7183
20190,36013,40-44,3455,3445,6900
20191,36013,45-49,3445,3391,6836
20192,36013,50-54,3924,4084,8008
20193,36013,55-59,4543,4535,9078
20194,36013,60-64,4983,4912,9895
20195,36013,65+,14411,12399,26810
20196,36015,15-19,2460,2505,4965
20197,36015,20-24,2328,2531,4859
20198,36015,25-29,2287,2633,4920
20199,36015,30-34,2461,2796,5257
20200,36015,35-39,2527,2672,5199
20201,36015,40-44,2438,2584,5022
20202,36015,45-49,2239,2473,4712
20203,36015,50-54,2608,2658,5266
20204,36015,55-59,2993,2905,5898
20205,36015,60-64,3140,2947,6087
20206,36015,65+,9048,7418,16466
20207,36017,15-19,1228,1376,2604
20208,36017,20-24,1148,1259,2407
20209,36017,25-29,1284,1298,2582
20210,36017,30-34,1276,1321,2597
20211,36017,35-39,1286,1361,2647
20212,36017,40-44,1291,1315,2606
20213,36017,45-49,1248,1279,2527
20214,36017,50-54,1539,1567,3106
20215,36017,55-59,1836,1801,3637
20216,36017,60-64,1902,1960,3862
20217,36017,65+,5174,4872,10046
20218,36019,15-19,2657,2623,5280
20219,36019,20-24,3515,3528,7043
20220,36019,25-29,2136,2721,4857
20221,36019,30-34,2086,2806,4892
20222,36019,35-39,2253,2799,5052
20223,36019,40-44,2173,2723,4896
20224,36019,45-49,2074,2498,4572
20225,36019,50-54,2292,2638,4930
20226,36019,55-59,2911,2932,5843
20227,36019,60-64,2890,2930,5820
20228,36019,65+,7675,6846,14521
20229,36021,15-19,1392,1757,3149
20230,36021,20-24,1372,1518,2890
20231,36021,25-29,1609,1706,3315
20232,36021,30-34,1741,1743,3484
20233,36021,35-39,1809,1753,3562
20234,36021,40-44,1719,1711,3430
20235,36021,45-49,1730,1779,3509
20236,36021,50-54,2101,2211,4312
20237,36021,55-59,2515,2643,5158
20238,36021,60-64,2629,2658,5287
20239,36021,65+,8245,7466,15711
20240,36023,15-19,2311,2038,4349
20241,36023,20-24,2864,2651,5515
20242,36023,25-29,1375,1299,2674
20243,36023,30-34,1209,1319,2528
20244,36023,35-39,1250,1286,2536
20245,36023,40-44,1231,1275,2506
20246,36023,45-49,1117,1153,2270
20247,36023,50-54,1330,1415,2745
20248,36023,55-59,1573,1520,3093
20249,36023,60-64,1483,1545,3028
20250,36023,65+,4279,3644,7923
20251,36025,15-19,1342,1625,2967
20252,36025,20-24,1153,1294,2447
20253,36025,25-29,1001,1106,2107
20254,36025,30-34,1125,1249,2374
20255,36025,35-39,1166,1206,2372
20256,36025,40-44,1189,1174,2363
20257,36025,45-49,1144,1191,2335
20258,36025,50-54,1430,1454,2884
20259,36025,55-59,1718,1710,3428
20260,36025,60-64,1906,1973,3879
20261,36025,65+,5925,5598,11523
20262,36027,15-19,10236,10483,20719
20263,36027,20-24,10424,10368,20792
20264,36027,25-29,8384,9471,17855
20265,36027,30-34,8698,9567,18265
20266,36027,35-39,8761,9318,18079
20267,36027,40-44,8713,9318,18031
20268,36027,45-49,8671,9179,17850
20269,36027,50-54,10390,10566,20956
20270,36027,55-59,11730,11646,23376
20271,36027,60-64,11053,11310,22363
20272,36027,65+,29972,25033,55005
20273,36029,15-19,28628,29426,58054
20274,36029,20-24,30086,30005,60091
20275,36029,25-29,32002,32192,64194
20276,36029,30-34,34184,34506,68690
20277,36029,35-39,31228,31060,62288
20278,36029,40-44,27364,27032,54396
20279,36029,45-49,25363,24981,50344
20280,36029,50-54,30992,29661,60653
20281,36029,55-59,33907,32289,66196
20282,36029,60-64,36145,33264,69409
20283,36029,65+,99867,78309,178176
20284,36031,15-19,842,992,1834
20285,36031,20-24,768,995,1763
20286,36031,25-29,904,1275,2179
20287,36031,30-34,982,1273,2255
20288,36031,35-39,972,1271,2243
20289,36031,40-44,999,1118,2117
20290,36031,45-49,1010,1153,2163
20291,36031,50-54,1205,1299,2504
20292,36031,55-59,1527,1453,2980
20293,36031,60-64,1581,1708,3289
20294,36031,65+,4769,4494,9263
20295,36033,15-19,1299,1618,2917
20296,36033,20-24,1167,2052,3219
20297,36033,25-29,1218,2136,3354
20298,36033,30-34,1257,2063,3320
20299,36033,35-39,1334,1852,3186
20300,36033,40-44,1161,1789,2950
20301,36033,45-49,1182,1624,2806
20302,36033,50-54,1360,1685,3045
20303,36033,55-59,1631,1752,3383
20304,36033,60-64,1655,1760,3415
20305,36033,65+,4380,4043,8423
20306,36035,15-19,1444,1520,2964
20307,36035,20-24,1349,1455,2804
20308,36035,25-29,1426,1604,3030
20309,36035,30-34,1547,1661,3208
20310,36035,35-39,1647,1648,3295
20311,36035,40-44,1586,1641,3227
20312,36035,45-49,1521,1574,3095
20313,36035,50-54,1805,1915,3720
20314,36035,55-59,2021,2083,4104
20315,36035,60-64,2062,2038,4100
20316,36035,65+,5898,4961,10859
20317,36037,15-19,1707,1840,3547
20318,36037,20-24,1457,1655,3112
20319,36037,25-29,1636,1921,3557
20320,36037,30-34,1709,1882,3591
20321,36037,35-39,1697,1873,3570
20322,36037,40-44,1600,1685,3285
20323,36037,45-49,1554,1608,3162
20324,36037,50-54,2009,2037,4046
20325,36037,55-59,2197,2242,4439
20326,36037,60-64,2303,2317,4620
20327,36037,65+,6105,5241,11346
20328,36039,15-19,965,1565,2530
20329,36039,20-24,1064,1877,2941
20330,36039,25-29,1289,1547,2836
20331,36039,30-34,1380,1671,3051
20332,36039,35-39,1369,1557,2926
20333,36039,40-44,1255,1458,2713
20334,36039,45-49,1395,1504,2899
20335,36039,50-54,1575,1704,3279
20336,36039,55-59,1893,1956,3849
20337,36039,60-64,1982,2016,3998
20338,36039,65+,5809,5346,11155
20339,36041,15-19,112,121,233
20340,36041,20-24,92,114,206
20341,36041,25-29,107,83,190
20342,36041,30-34,91,95,186
20343,36041,35-39,106,108,214
20344,36041,40-44,123,122,245
20345,36041,45-49,129,134,263
20346,36041,50-54,159,159,318
20347,36041,55-59,227,244,471
20348,36041,60-64,298,280,578
20349,36041,65+,835,860,1695
20350,36043,15-19,1896,1947,3843
20351,36043,20-24,1594,1692,3286
20352,36043,25-29,1660,1702,3362
20353,36043,30-34,1671,1767,3438
20354,36043,35-39,1669,1716,3385
20355,36043,40-44,1650,1665,3315
20356,36043,45-49,1659,1697,3356
20357,36043,50-54,1906,1914,3820
20358,36043,55-59,2276,2316,4592
20359,36043,60-64,2337,2366,4703
20360,36043,65+,6864,6023,12887
20361,36045,15-19,3087,3626,6713
20362,36045,20-24,4090,6964,11054
20363,36045,25-29,4237,6053,10290
20364,36045,30-34,3860,4770,8630
20365,36045,35-39,3698,4222,7920
20366,36045,40-44,2974,3453,6427
20367,36045,45-49,2607,2728,5335
20368,36045,50-54,2961,3010,5971
20369,36045,55-59,3288,3255,6543
20370,36045,60-64,3350,3156,6506
20371,36045,65+,9122,7840,16962
20372,36047,15-19,70351,72583,142934
20373,36047,20-24,76908,71465,148373
20374,36047,25-29,115488,103118,218606
20375,36047,30-34,122571,117259,239830
20376,36047,35-39,104236,99635,203871
20377,36047,40-44,89656,83592,173248
20378,36047,45-49,81723,72786,154509
20379,36047,50-54,81009,71613,152622
20380,36047,55-59,81482,70831,152313
20381,36047,60-64,79786,67398,147184
20382,36047,65+,232822,167260,400082
20383,36049,15-19,763,839,1602
20384,36049,20-24,687,712,1399
20385,36049,25-29,744,758,1502
20386,36049,30-34,729,800,1529
20387,36049,35-39,760,796,1556
20388,36049,40-44,742,751,1493
20389,36049,45-49,708,747,1455
20390,36049,50-54,768,881,1649
20391,36049,55-59,979,1032,2011
20392,36049,60-64,1033,1101,2134
20393,36049,65+,2660,2550,5210
20394,36051,15-19,2633,2439,5072
20395,36051,20-24,3193,3005,6198
20396,36051,25-29,1418,1855,3273
20397,36051,30-34,1367,1796,3163
20398,36051,35-39,1648,1902,3550
20399,36051,40-44,1549,1868,3417
20400,36051,45-49,1462,1713,3175
20401,36051,50-54,1910,2024,3934
20402,36051,55-59,2277,2294,4571
20403,36051,60-64,2354,2330,4684
20404,36051,65+,6228,5567,11795
20405,36053,15-19,2873,2622,5495
20406,36053,20-24,2592,2622,5214
20407,36053,25-29,1691,1742,3433
20408,36053,30-34,1822,1822,3644
20409,36053,35-39,1852,1922,3774
20410,36053,40-44,1762,1887,3649
20411,36053,45-49,1771,1773,3544
20412,36053,50-54,2258,2194,4452
20413,36053,55-59,2674,2629,5303
20414,36053,60-64,2644,2760,5404
20415,36053,65+,7081,6321,13402
20416,36055,15-19,24499,25752,50251
20417,36055,20-24,24933,24592,49525
20418,36055,25-29,25784,25296,51080
20419,36055,30-34,27208,26627,53835
20420,36055,35-39,25075,24042,49117
20421,36055,40-44,22352,21093,43445
20422,36055,45-49,20966,19288,40254
20423,36055,50-54,24719,23277,47996
20424,36055,55-59,26896,25038,51934
20425,36055,60-64,27014,25297,52311
20426,36055,65+,76940,61060,138000
20427,36057,15-19,1431,1643,3074
20428,36057,20-24,1339,1374,2713
20429,36057,25-29,1458,1487,2945
20430,36057,30-34,1549,1606,3155
20431,36057,35-39,1649,1565,3214
20432,36057,40-44,1437,1427,2864
20433,36057,45-49,1358,1355,2713
20434,36057,50-54,1568,1557,3125
20435,36057,55-59,1709,1642,3351
20436,36057,60-64,1770,1658,3428
20437,36057,65+,5008,4464,9472
20438,36059,15-19,42522,45147,87669
20439,36059,20-24,40928,42268,83196
20440,36059,25-29,40955,42389,83344
20441,36059,30-34,40090,40368,80458
20442,36059,35-39,42582,42204,84786
20443,36059,40-44,43712,43575,87287
20444,36059,45-49,43509,43057,86566
20445,36059,50-54,48949,47259,96208
20446,36059,55-59,52647,50415,103062
20447,36059,60-64,50655,48043,98698
20448,36059,65+,141969,113869,255838
20449,36061,15-19,38008,33019,71027
20450,36061,20-24,53338,42850,96188
20451,36061,25-29,82776,73450,156226
20452,36061,30-34,79576,78524,158100
20453,36061,35-39,62902,63564,126466
20454,36061,40-44,51919,51768,103687
20455,36061,45-49,47782,46616,94398
20456,36061,50-54,49041,49322,98363
20457,36061,55-59,48644,48055,96699
20458,36061,60-64,47139,43714,90853
20459,36061,65+,168917,119999,288916
20460,36063,15-19,6080,6201,12281
20461,36063,20-24,5799,6100,11899
20462,36063,25-29,6086,6388,12474
20463,36063,30-34,6800,6814,13614
20464,36063,35-39,6388,6365,12753
20465,36063,40-44,6188,6020,12208
20466,36063,45-49,5921,5822,11743
20467,36063,50-54,7049,7043,14092
20468,36063,55-59,8253,7754,16007
20469,36063,60-64,8735,8441,17176
20470,36063,65+,23237,19508,42745
20471,36065,15-19,7324,7795,15119
20472,36065,20-24,6830,7942,14772
20473,36065,25-29,6576,7286,13862
20474,36065,30-34,6914,7354,14268
20475,36065,35-39,6763,7447,14210
20476,36065,40-44,6287,6758,13045
20477,36065,45-49,6244,6407,12651
20478,36065,50-54,7263,7611,14874
20479,36065,55-59,8042,8134,16176
20480,36065,60-64,8147,8050,16197
20481,36065,65+,24637,19988,44625
20482,36067,15-19,16476,16102,32578
20483,36067,20-24,16249,15516,31765
20484,36067,25-29,15519,15065,30584
20485,36067,30-34,15893,15577,31470
20486,36067,35-39,15392,14897,30289
20487,36067,40-44,13830,13288,27118
20488,36067,45-49,12825,12140,24965
20489,36067,50-54,15185,14652,29837
20490,36067,55-59,17271,16262,33533
20491,36067,60-64,17002,16094,33096
20492,36067,65+,47480,38037,85517
20493,36069,15-19,3475,3532,7007
20494,36069,20-24,3411,3510,6921
20495,36069,25-29,3017,3173,6190
20496,36069,30-34,3126,3260,6386
20497,36069,35-39,3405,3374,6779
20498,36069,40-44,3260,3237,6497
20499,36069,45-49,3008,3004,6012
20500,36069,50-54,3779,3776,7555
20501,36069,55-59,4440,4120,8560
20502,36069,60-64,4361,4228,8589
20503,36069,65+,13100,11035,24135
20504,36071,15-19,14442,16370,30812
20505,36071,20-24,12785,16209,28994
20506,36071,25-29,11554,12555,24109
20507,36071,30-34,11896,12126,24022
20508,36071,35-39,12424,12560,24984
20509,36071,40-44,12372,12521,24893
20510,36071,45-49,12030,12019,24049
20511,36071,50-54,13555,13644,27199
20512,36071,55-59,13902,13773,27675
20513,36071,60-64,12200,12070,24270
20514,36071,65+,32045,26519,58564
20515,36073,15-19,1134,1175,2309
20516,36073,20-24,1146,1277,2423
20517,36073,25-29,1231,1429,2660
20518,36073,30-34,1228,1367,2595
20519,36073,35-39,1204,1279,2483
20520,36073,40-44,1166,1136,2302
20521,36073,45-49,1166,1085,2251
20522,36073,50-54,1403,1441,2844
20523,36073,55-59,1575,1600,3175
20524,36073,60-64,1617,1591,3208
20525,36073,65+,4114,3667,7781
20526,36075,15-19,4129,4228,8357
20527,36075,20-24,3692,4056,7748
20528,36075,25-29,3385,3499,6884
20529,36075,30-34,3620,3795,7415
20530,36075,35-39,3382,3547,6929
20531,36075,40-44,3325,3330,6655
20532,36075,45-49,3171,3218,6389
20533,36075,50-54,4077,4020,8097
20534,36075,55-59,4574,4702,9276
20535,36075,60-64,4395,4547,8942
20536,36075,65+,10737,9829,20566
20537,36077,15-19,2695,2151,4846
20538,36077,20-24,3337,2985,6322
20539,36077,25-29,1498,1504,3002
20540,36077,30-34,1397,1456,2853
20541,36077,35-39,1454,1533,2987
20542,36077,40-44,1420,1493,2913
20543,36077,45-49,1415,1409,2824
20544,36077,50-54,1750,1762,3512
20545,36077,55-59,2034,2026,4060
20546,36077,60-64,2270,2219,4489
20547,36077,65+,6877,5953,12830
20548,36079,15-19,2898,3049,5947
20549,36079,20-24,2703,2999,5702
20550,36079,25-29,2616,2973,5589
20551,36079,30-34,2711,2829,5540
20552,36079,35-39,2930,3258,6188
20553,36079,40-44,2918,3108,6026
20554,36079,45-49,3102,3228,6330
20555,36079,50-54,3752,3849,7601
20556,36079,55-59,4149,4151,8300
20557,36079,60-64,3726,3781,7507
20558,36079,65+,9773,8440,18213
20559,36081,15-19,57923,61850,119773
20560,36081,20-24,62494,60937,123431
20561,36081,25-29,84180,81308,165488
20562,36081,30-34,90774,92787,183561
20563,36081,35-39,80990,83675,164665
20564,36081,40-44,76951,76097,153048
20565,36081,45-49,75068,73158,148226
20566,36081,50-54,80400,78429,158829
20567,36081,55-59,83530,79983,163513
20568,36081,60-64,80672,75312,155984
20569,36081,65+,228933,175697,404630
20570,36083,15-19,4735,5571,10306
20571,36083,20-24,4818,5547,10365
20572,36083,25-29,5354,5547,10901
20573,36083,30-34,5698,5667,11365
20574,36083,35-39,5435,5255,10690
20575,36083,40-44,4904,4880,9784
20576,36083,45-49,4522,4503,9025
20577,36083,50-54,5242,5207,10449
20578,36083,55-59,5965,5488,11453
20579,36083,60-64,5880,5576,11456
20580,36083,65+,15777,13275,29052
20581,36085,15-19,15045,15671,30716
20582,36085,20-24,14288,14734,29022
20583,36085,25-29,15558,15905,31463
20584,36085,30-34,16881,16812,33693
20585,36085,35-39,15892,15619,31511
20586,36085,40-44,15642,15099,30741
20587,36085,45-49,15821,15203,31024
20588,36085,50-54,17635,16638,34273
20589,36085,55-59,18271,17263,35534
20590,36085,60-64,17553,16361,33914
20591,36085,65+,46942,36927,83869
20592,36087,15-19,12321,13164,25485
20593,36087,20-24,10654,11068,21722
20594,36087,25-29,9991,10265,20256
20595,36087,30-34,9194,9504,18698
20596,36087,35-39,9561,9785,19346
20597,36087,40-44,9458,9681,19139
20598,36087,45-49,9077,8967,18044
20599,36087,50-54,10126,9994,20120
20600,36087,55-59,10754,10413,21167
20601,36087,60-64,10047,9489,19536
20602,36087,65+,29876,23286,53162
20603,36089,15-19,4470,4830,9300
20604,36089,20-24,4150,4971,9121
20605,36089,25-29,2574,3199,5773
20606,36089,30-34,2958,3430,6388
20607,36089,35-39,2915,3383,6298
20608,36089,40-44,2936,3120,6056
20609,36089,45-49,2830,3097,5927
20610,36089,50-54,3191,3527,6718
20611,36089,55-59,3780,3677,7457
20612,36089,60-64,3877,3857,7734
20613,36089,65+,10355,9295,19650
20614,36091,15-19,6832,6904,13736
20615,36091,20-24,6519,6729,13248
20616,36091,25-29,6774,7064,13838
20617,36091,30-34,7314,7580,14894
20618,36091,35-39,7602,7742,15344
20619,36091,40-44,7440,7598,15038
20620,36091,45-49,7392,7302,14694
20621,36091,50-54,8613,8748,17361
20622,36091,55-59,9318,9070,18388
20623,36091,60-64,8925,8540,17465
20624,36091,65+,24780,21146,45926
20625,36093,15-19,4791,5120,9911
20626,36093,20-24,4906,4918,9824
20627,36093,25-29,5217,5163,10380
20628,36093,30-34,5389,5383,10772
20629,36093,35-39,5278,5235,10513
20630,36093,40-44,4940,4922,9862
20631,36093,45-49,4539,4500,9039
20632,36093,50-54,5072,4953,10025
20633,36093,55-59,5669,5244,10913
20634,36093,60-64,5501,5208,10709
20635,36093,65+,15592,12365,27957
20636,36095,15-19,1042,1042,2084
20637,36095,20-24,906,959,1865
20638,36095,25-29,782,777,1559
20639,36095,30-34,788,827,1615
20640,36095,35-39,818,857,1675
20641,36095,40-44,766,803,1569
20642,36095,45-49,798,805,1603
20643,36095,50-54,952,1019,1971
20644,36095,55-59,1148,1143,2291
20645,36095,60-64,1204,1223,2427
20646,36095,65+,3548,3376,6924
20647,36097,15-19,419,471,890
20648,36097,20-24,408,428,836
20649,36097,25-29,432,499,931
20650,36097,30-34,500,492,992
20651,36097,35-39,522,513,1035
20652,36097,40-44,531,482,1013
20653,36097,45-49,502,502,1004
20654,36097,50-54,626,672,1298
20655,36097,55-59,699,732,1431
20656,36097,60-64,766,778,1544
20657,36097,65+,2077,1924,4001
20658,36099,15-19,887,1010,1897
20659,36099,20-24,834,1241,2075
20660,36099,25-29,944,1329,2273
20661,36099,30-34,979,1247,2226
20662,36099,35-39,925,1190,2115
20663,36099,40-44,824,1067,1891
20664,36099,45-49,846,955,1801
20665,36099,50-54,1008,1090,2098
20666,36099,55-59,1129,1210,2339
20667,36099,60-64,1284,1295,2579
20668,36099,65+,3563,3288,6851
20669,36101,15-19,2609,2878,5487
20670,36101,20-24,2407,2511,4918
20671,36101,25-29,2589,2725,5314
20672,36101,30-34,2788,2774,5562
20673,36101,35-39,2695,2755,5450
20674,36101,40-44,2677,2808,5485
20675,36101,45-49,2581,2590,5171
20676,36101,50-54,3096,3143,6239
20677,36101,55-59,3422,3462,6884
20678,36101,60-64,3524,3610,7134
20679,36101,65+,9966,8884,18850
20680,36103,15-19,46984,50544,97528
20681,36103,20-24,47516,48607,96123
20682,36103,25-29,46499,48661,95160
20683,36103,30-34,44543,46570,91113
20684,36103,35-39,43937,45568,89505
20685,36103,40-44,45481,46697,92178
20686,36103,45-49,47205,47433,94638
20687,36103,50-54,56574,56075,112649
20688,36103,55-59,60835,60176,121011
20689,36103,60-64,56143,55208,111351
20690,36103,65+,148742,120350,269092
20691,36105,15-19,2243,2448,4691
20692,36105,20-24,2090,2373,4463
20693,36105,25-29,2245,2410,4655
20694,36105,30-34,2316,2676,4992
20695,36105,35-39,2403,2487,4890
20696,36105,40-44,2260,2516,4776
20697,36105,45-49,2044,2565,4609
20698,36105,50-54,2562,2826,5388
20699,36105,55-59,2943,3113,6056
20700,36105,60-64,2814,3073,5887
20701,36105,65+,7823,7496,15319
20702,36107,15-19,1374,1490,2864
20703,36107,20-24,1190,1278,2468
20704,36107,25-29,1239,1298,2537
20705,36107,30-34,1321,1325,2646
20706,36107,35-39,1428,1410,2838
20707,36107,40-44,1351,1475,2826
20708,36107,45-49,1338,1345,2683
20709,36107,50-54,1555,1541,3096
20710,36107,55-59,1888,1843,3731
20711,36107,60-64,2046,2008,4054
20712,36107,65+,5395,4917,10312
20713,36109,15-19,5985,5864,11849
20714,36109,20-24,8796,9238,18034
20715,36109,25-29,3409,3596,7005
20716,36109,30-34,2986,2916,5902
20717,36109,35-39,3045,2845,5890
20718,36109,40-44,2975,2760,5735
20719,36109,45-49,2494,2464,4958
20720,36109,50-54,2732,2668,5400
20721,36109,55-59,2942,2737,5679
20722,36109,60-64,3069,2786,5855
20723,36109,65+,8900,7654,16554
20724,36111,15-19,5551,5341,10892
20725,36111,20-24,5371,5462,10833
20726,36111,25-29,5222,5860,11082
20727,36111,30-34,5910,6165,12075
20728,36111,35-39,5395,6187,11582
20729,36111,40-44,5493,5699,11192
20730,36111,45-49,5197,5645,10842
20731,36111,50-54,6130,6365,12495
20732,36111,55-59,7095,7024,14119
20733,36111,60-64,7256,7068,14324
20734,36111,65+,20563,17402,37965
20735,36113,15-19,1594,1809,3403
20736,36113,20-24,1602,1689,3291
20737,36113,25-29,1836,1893,3729
20738,36113,30-34,1937,2059,3996
20739,36113,35-39,1983,1946,3929
20740,36113,40-44,1728,1782,3510
20741,36113,45-49,1768,1741,3509
20742,36113,50-54,2335,2217,4552
20743,36113,55-59,2784,2548,5332
20744,36113,60-64,2832,2644,5476
20745,36113,65+,8149,7257,15406
20746,36115,15-19,1450,1902,3352
20747,36115,20-24,1351,1941,3292
20748,36115,25-29,1638,2054,3692
20749,36115,30-34,1804,2018,3822
20750,36115,35-39,1748,2037,3785
20751,36115,40-44,1664,2076,3740
20752,36115,45-49,1661,2008,3669
20753,36115,50-54,2085,2277,4362
20754,36115,55-59,2397,2402,4799
20755,36115,60-64,2369,2394,4763
20756,36115,65+,6535,6033,12568
20757,36117,15-19,2542,2655,5197
20758,36117,20-24,2277,2322,4599
20759,36117,25-29,2486,2675,5161
20760,36117,30-34,2680,2698,5378
20761,36117,35-39,2689,2754,5443
20762,36117,40-44,2489,2559,5048
20763,36117,45-49,2456,2519,4975
20764,36117,50-54,3223,3249,6472
20765,36117,55-59,3663,3638,7301
20766,36117,60-64,3620,3693,7313
20767,36117,65+,9563,8655,18218
20768,36119,15-19,32728,33911,66639
20769,36119,20-24,29933,29591,59524
20770,36119,25-29,28297,28229,56526
20771,36119,30-34,28951,29146,58097
20772,36119,35-39,31989,31899,63888
20773,36119,40-44,33446,32906,66352
20774,36119,45-49,33143,32062,65205
20775,36119,50-54,36639,35458,72097
20776,36119,55-59,36935,35080,72015
20777,36119,60-64,34253,32610,66863
20778,36119,65+,100693,76815,177508
20779,36121,15-19,1043,1042,2085
20780,36121,20-24,924,1254,2178
20781,36121,25-29,1037,1642,2679
20782,36121,30-34,1108,1730,2838
20783,36121,35-39,1093,1660,2753
20784,36121,40-44,1018,1548,2566
20785,36121,45-49,1022,1457,2479
20786,36121,50-54,1253,1621,2874
20787,36121,55-59,1502,1633,3135
20788,36121,60-64,1472,1596,3068
20789,36121,65+,3912,3859,7771
20790,36123,15-19,948,786,1734
20791,36123,20-24,976,868,1844
20792,36123,25-29,692,658,1350
20793,36123,30-34,622,649,1271
20794,36123,35-39,626,643,1269
20795,36123,40-44,599,580,1179
20796,36123,45-49,588,548,1136
20797,36123,50-54,662,690,1352
20798,36123,55-59,880,829,1709
20799,36123,60-64,993,921,1914
20800,36123,65+,2769,2534,5303
20801,37001,15-19,6928,6467,13395
20802,37001,20-24,6066,5497,11563
20803,37001,25-29,5441,5042,10483
20804,37001,30-34,5997,5440,11437
20805,37001,35-39,5491,4871,10362
20806,37001,40-44,5267,4792,10059
20807,37001,45-49,5357,5009,10366
20808,37001,50-54,5912,5648,11560
20809,37001,55-59,6176,5801,11977
20810,37001,60-64,5882,5343,11225
20811,37001,65+,17055,12765,29820
20812,37003,15-19,1017,1055,2072
20813,37003,20-24,890,1061,1951
20814,37003,25-29,999,1307,2306
20815,37003,30-34,1018,1193,2211
20816,37003,35-39,952,1111,2063
20817,37003,40-44,1012,1207,2219
20818,37003,45-49,1072,1246,2318
20819,37003,50-54,1296,1387,2683
20820,37003,55-59,1399,1417,2816
20821,37003,60-64,1277,1302,2579
20822,37003,65+,4095,3467,7562
20823,37005,15-19,251,263,514
20824,37005,20-24,271,247,518
20825,37005,25-29,246,282,528
20826,37005,30-34,254,251,505
20827,37005,35-39,245,292,537
20828,37005,40-44,270,282,552
20829,37005,45-49,317,330,647
20830,37005,50-54,387,392,779
20831,37005,55-59,417,422,839
20832,37005,60-64,484,480,964
20833,37005,65+,1669,1474,3143
20834,37007,15-19,620,622,1242
20835,37007,20-24,621,705,1326
20836,37007,25-29,679,886,1565
20837,37007,30-34,656,861,1517
20838,37007,35-39,579,699,1278
20839,37007,40-44,630,685,1315
20840,37007,45-49,622,665,1287
20841,37007,50-54,752,705,1457
20842,37007,55-59,796,747,1543
20843,37007,60-64,772,788,1560
20844,37007,65+,2394,1946,4340
20845,37009,15-19,642,683,1325
20846,37009,20-24,637,623,1260
20847,37009,25-29,573,674,1247
20848,37009,30-34,648,679,1327
20849,37009,35-39,670,704,1374
20850,37009,40-44,770,789,1559
20851,37009,45-49,784,791,1575
20852,37009,50-54,875,932,1807
20853,37009,55-59,1057,1046,2103
20854,37009,60-64,1166,1115,2281
20855,37009,65+,3872,3318,7190
20856,37011,15-19,500,481,981
20857,37011,20-24,485,604,1089
20858,37011,25-29,435,680,1115
20859,37011,30-34,393,726,1119
20860,37011,35-39,405,727,1132
20861,37011,40-44,442,693,1135
20862,37011,45-49,455,752,1207
20863,37011,50-54,527,756,1283
20864,37011,55-59,575,708,1283
20865,37011,60-64,695,675,1370
20866,37011,65+,2100,1936,4036
20867,37013,15-19,1244,1342,2586
20868,37013,20-24,1084,1113,2197
20869,37013,25-29,1167,1111,2278
20870,37013,30-34,1176,977,2153
20871,37013,35-39,1146,1025,2171
20872,37013,40-44,1309,1209,2518
20873,37013,45-49,1395,1298,2693
20874,37013,50-54,1471,1401,2872
20875,37013,55-59,1638,1576,3214
20876,37013,60-64,1909,1698,3607
20877,37013,65+,6076,5061,11137
20878,37015,15-19,414,477,891
20879,37015,20-24,390,622,1012
20880,37015,25-29,418,741,1159
20881,37015,30-34,439,674,1113
20882,37015,35-39,406,517,923
20883,37015,40-44,411,488,899
20884,37015,45-49,454,561,1015
20885,37015,50-54,536,487,1023
20886,37015,55-59,674,624,1298
20887,37015,60-64,743,696,1439
20888,37015,65+,2478,1835,4313
20889,37017,15-19,857,859,1716
20890,37017,20-24,803,777,1580
20891,37017,25-29,858,790,1648
20892,37017,30-34,779,771,1550
20893,37017,35-39,771,674,1445
20894,37017,40-44,857,796,1653
20895,37017,45-49,981,880,1861
20896,37017,50-54,981,895,1876
20897,37017,55-59,1099,960,2059
20898,37017,60-64,1252,1055,2307
20899,37017,65+,3822,3115,6937
20900,37019,15-19,2726,2864,5590
20901,37019,20-24,2745,2826,5571
20902,37019,25-29,3155,3166,6321
20903,37019,30-34,3380,3258,6638
20904,37019,35-39,3447,3206,6653
20905,37019,40-44,3449,3303,6752
20906,37019,45-49,3525,3381,6906
20907,37019,50-54,4412,3923,8335
20908,37019,55-59,6156,4964,11120
20909,37019,60-64,8575,6896,15471
20910,37019,65+,25138,22858,47996
20911,37021,15-19,7195,7474,14669
20912,37021,20-24,7498,7109,14607
20913,37021,25-29,9062,8590,17652
20914,37021,30-34,10003,9484,19487
20915,37021,35-39,9672,9280,18952
20916,37021,40-44,9439,9206,18645
20917,37021,45-49,8331,8644,16975
20918,37021,50-54,8748,8546,17294
20919,37021,55-59,9178,8395,17573
20920,37021,60-64,10159,8595,18754
20921,37021,65+,31882,25247,57129
20922,37023,15-19,2181,3074,5255
20923,37023,20-24,2128,2702,4830
20924,37023,25-29,2540,2870,5410
20925,37023,30-34,2632,2753,5385
20926,37023,35-39,2339,2399,4738
20927,37023,40-44,2475,2442,4917
20928,37023,45-49,2739,2768,5507
20929,37023,50-54,3207,3279,6486
20930,37023,55-59,3444,3466,6910
20931,37023,60-64,3509,3305,6814
20932,37023,65+,10159,8419,18578
20933,37025,15-19,7818,8448,16266
20934,37025,20-24,6619,6556,13175
20935,37025,25-29,6977,6971,13948
20936,37025,30-34,8030,7204,15234
20937,37025,35-39,8723,7998,16721
20938,37025,40-44,8568,8367,16935
20939,37025,45-49,8267,7960,16227
20940,37025,50-54,8292,8199,16491
20941,37025,55-59,7364,7244,14608
20942,37025,60-64,6654,6236,12890
20943,37025,65+,17419,13695,31114
20944,37027,15-19,2225,2277,4502
20945,37027,20-24,2113,2272,4385
20946,37027,25-29,2310,2439,4749
20947,37027,30-34,2402,2390,4792
20948,37027,35-39,2116,2193,4309
20949,37027,40-44,2240,2344,4584
20950,37027,45-49,2450,2614,5064
20951,37027,50-54,3018,3054,6072
20952,37027,55-59,3081,3184,6265
20953,37027,60-64,3004,2895,5899
20954,37027,65+,9067,7660,16727
20955,37029,15-19,354,349,703
20956,37029,20-24,240,263,503
20957,37029,25-29,281,278,559
20958,37029,30-34,329,347,676
20959,37029,35-39,409,396,805
20960,37029,40-44,361,395,756
20961,37029,45-49,343,347,690
20962,37029,50-54,379,380,759
20963,37029,55-59,383,451,834
20964,37029,60-64,356,368,724
20965,37029,65+,931,853,1784
20966,37031,15-19,1636,1874,3510
20967,37031,20-24,1454,1586,3040
20968,37031,25-29,1461,1762,3223
20969,37031,30-34,1728,1693,3421
20970,37031,35-39,1870,1895,3765
20971,37031,40-44,2016,1922,3938
20972,37031,45-49,1902,1889,3791
20973,37031,50-54,2404,2266,4670
20974,37031,55-59,2868,2617,5485
20975,37031,60-64,3366,2973,6339
20976,37031,65+,9624,8382,18006
20977,37033,15-19,573,630,1203
20978,37033,20-24,493,659,1152
20979,37033,25-29,587,802,1389
20980,37033,30-34,562,738,1300
20981,37033,35-39,541,663,1204
20982,37033,40-44,560,678,1238
20983,37033,45-49,644,795,1439
20984,37033,50-54,783,811,1594
20985,37033,55-59,870,855,1725
20986,37033,60-64,922,872,1794
20987,37033,65+,2908,2369,5277
20988,37035,15-19,5013,5328,10341
20989,37035,20-24,4757,4863,9620
20990,37035,25-29,4858,5011,9869
20991,37035,30-34,4928,4725,9653
20992,37035,35-39,4618,4637,9255
20993,37035,40-44,4845,4752,9597
20994,37035,45-49,5146,5082,10228
20995,37035,50-54,5775,5709,11484
20996,37035,55-59,5841,5926,11767
20997,37035,60-64,5711,5544,11255
20998,37035,65+,16537,13387,29924
20999,37037,15-19,2222,2239,4461
21000,37037,20-24,1694,1792,3486
21001,37037,25-29,1615,1592,3207
21002,37037,30-34,1847,1804,3651
21003,37037,35-39,2198,2034,4232
21004,37037,40-44,2363,2277,4640
21005,37037,45-49,2530,2407,4937
21006,37037,50-54,2828,2784,5612
21007,37037,55-59,2990,2864,5854
21008,37037,60-64,3148,2911,6059
21009,37037,65+,10872,8821,19693
21010,37039,15-19,662,682,1344
21011,37039,20-24,585,672,1257
21012,37039,25-29,625,635,1260
21013,37039,30-34,651,636,1287
21014,37039,35-39,649,636,1285
21015,37039,40-44,731,681,1412
21016,37039,45-49,795,782,1577
21017,37039,50-54,951,964,1915
21018,37039,55-59,1146,1088,2234
21019,37039,60-64,1374,1266,2640
21020,37039,65+,4821,4380,9201
21021,37041,15-19,383,393,776
21022,37041,20-24,342,358,700
21023,37041,25-29,316,396,712
21024,37041,30-34,335,321,656
21025,37041,35-39,372,359,731
21026,37041,40-44,403,369,772
21027,37041,45-49,388,338,726
21028,37041,50-54,404,365,769
21029,37041,55-59,559,464,1023
21030,37041,60-64,619,533,1152
21031,37041,65+,1947,1555,3502
21032,37043,15-19,252,284,536
21033,37043,20-24,216,241,457
21034,37043,25-29,219,252,471
21035,37043,30-34,258,226,484
21036,37043,35-39,229,274,503
21037,37043,40-44,275,264,539
21038,37043,45-49,292,289,581
21039,37043,50-54,363,337,700
21040,37043,55-59,437,385,822
21041,37043,60-64,578,509,1087
21042,37043,65+,1960,1731,3691
21043,37045,15-19,3221,3322,6543
21044,37045,20-24,3134,3104,6238
21045,37045,25-29,3172,3052,6224
21046,37045,30-34,3260,2972,6232
21047,37045,35-39,2793,2575,5368
21048,37045,40-44,2931,2601,5532
21049,37045,45-49,2988,2854,5842
21050,37045,50-54,3687,3384,7071
21051,37045,55-59,3689,3530,7219
21052,37045,60-64,3502,3294,6796
21053,37045,65+,10503,8268,18771
21054,37047,15-19,1472,1601,3073
21055,37047,20-24,1385,1667,3052
21056,37047,25-29,1385,1718,3103
21057,37047,30-34,1470,1686,3156
21058,37047,35-39,1330,1562,2892
21059,37047,40-44,1374,1525,2899
21060,37047,45-49,1510,1538,3048
21061,37047,50-54,1586,1572,3158
21062,37047,55-59,1782,1693,3475
21063,37047,60-64,1860,1660,3520
21064,37047,65+,5772,4538,10310
21065,37049,15-19,2759,3176,5935
21066,37049,20-24,3261,5518,8779
21067,37049,25-29,3158,3897,7055
21068,37049,30-34,3122,3156,6278
21069,37049,35-39,2797,2996,5793
21070,37049,40-44,2699,2740,5439
21071,37049,45-49,2470,2447,4917
21072,37049,50-54,2697,2463,5160
21073,37049,55-59,3171,2834,6005
21074,37049,60-64,3648,3161,6809
21075,37049,65+,11283,9179,20462
21076,37051,15-19,10645,12267,22912
21077,37051,20-24,13183,19410,32593
21078,37051,25-29,13903,16324,30227
21079,37051,30-34,12914,12881,25795
21080,37051,35-39,11501,10779,22280
21081,37051,40-44,10182,8974,19156
21082,37051,45-49,9005,7743,16748
21083,37051,50-54,9204,7731,16935
21084,37051,55-59,9787,8000,17787
21085,37051,60-64,9355,7967,17322
21086,37051,65+,24319,18001,42320
21087,37053,15-19,875,832,1707
21088,37053,20-24,588,686,1274
21089,37053,25-29,762,794,1556
21090,37053,30-34,1030,1026,2056
21091,37053,35-39,1038,1004,2042
21092,37053,40-44,870,934,1804
21093,37053,45-49,875,912,1787
21094,37053,50-54,1013,1048,2061
21095,37053,55-59,1216,1151,2367
21096,37053,60-64,1199,1253,2452
21097,37053,65+,2656,2469,5125
21098,37055,15-19,1027,1071,2098
21099,37055,20-24,800,809,1609
21100,37055,25-29,835,906,1741
21101,37055,30-34,948,932,1880
21102,37055,35-39,1158,1108,2266
21103,37055,40-44,1162,1180,2342
21104,37055,45-49,1125,1127,2252
21105,37055,50-54,1324,1331,2655
21106,37055,55-59,1577,1415,2992
21107,37055,60-64,1913,1663,3576
21108,37055,65+,4590,4249,8839
21109,37057,15-19,5005,5432,10437
21110,37057,20-24,4670,4714,9384
21111,37057,25-29,5137,5068,10205
21112,37057,30-34,5317,5056,10373
21113,37057,35-39,4949,4734,9683
21114,37057,40-44,5124,4899,10023
21115,37057,45-49,5507,5196,10703
21116,37057,50-54,6374,6471,12845
21117,37057,55-59,6438,6303,12741
21118,37057,60-64,6094,6094,12188
21119,37057,65+,17437,14576,32013
21120,37059,15-19,1260,1346,2606
21121,37059,20-24,1130,1168,2298
21122,37059,25-29,1100,1139,2239
21123,37059,30-34,1187,1101,2288
21124,37059,35-39,1219,1191,2410
21125,37059,40-44,1228,1170,2398
21126,37059,45-49,1381,1330,2711
21127,37059,50-54,1656,1592,3248
21128,37059,55-59,1707,1629,3336
21129,37059,60-64,1620,1587,3207
21130,37059,65+,5132,4296,9428
21131,37061,15-19,1492,1776,3268
21132,37061,20-24,1392,1492,2884
21133,37061,25-29,1316,1315,2631
21134,37061,30-34,1408,1299,2707
21135,37061,35-39,1339,1296,2635
21136,37061,40-44,1354,1399,2753
21137,37061,45-49,1446,1464,2910
21138,37061,50-54,1533,1474,3007
21139,37061,55-59,1688,1549,3237
21140,37061,60-64,1700,1622,3322
21141,37061,65+,5226,4331,9557
21142,37063,15-19,10757,10257,21014
21143,37063,20-24,11412,10551,21963
21144,37063,25-29,14985,13634,28619
21145,37063,30-34,15584,14903,30487
21146,37063,35-39,12596,12067,24663
21147,37063,40-44,11158,10710,21868
21148,37063,45-49,10009,9366,19375
21149,37063,50-54,10010,9313,19323
21150,37063,55-59,10050,8834,18884
21151,37063,60-64,10122,8308,18430
21152,37063,65+,26821,19941,46762
21153,37065,15-19,1483,1559,3042
21154,37065,20-24,1392,1317,2709
21155,37065,25-29,1547,1342,2889
21156,37065,30-34,1622,1280,2902
21157,37065,35-39,1371,1148,2519
21158,37065,40-44,1483,1191,2674
21159,37065,45-49,1448,1151,2599
21160,37065,50-54,1536,1340,2876
21161,37065,55-59,1826,1540,3366
21162,37065,60-64,2006,1612,3618
21163,37065,65+,5927,4275,10202
21164,37067,15-19,14255,13500,27755
21165,37067,20-24,13460,12207,25667
21166,37067,25-29,13065,12085,25150
21167,37067,30-34,13500,12221,25721
21168,37067,35-39,12421,11341,23762
21169,37067,40-44,12103,11013,23116
21170,37067,45-49,11982,10782,22764
21171,37067,50-54,12815,12097,24912
21172,37067,55-59,13437,12278,25715
21173,37067,60-64,13200,11564,24764
21174,37067,65+,36741,27672,64413
21175,37069,15-19,2137,2395,4532
21176,37069,20-24,1865,2152,4017
21177,37069,25-29,2091,2308,4399
21178,37069,30-34,2222,2256,4478
21179,37069,35-39,2181,2247,4428
21180,37069,40-44,2125,2221,4346
21181,37069,45-49,2361,2288,4649
21182,37069,50-54,2610,2589,5199
21183,37069,55-59,2704,2633,5337
21184,37069,60-64,2626,2515,5141
21185,37069,65+,6855,5614,12469
21186,37071,15-19,6882,7476,14358
21187,37071,20-24,6545,6606,13151
21188,37071,25-29,7481,7398,14879
21189,37071,30-34,8439,7800,16239
21190,37071,35-39,7578,7103,14681
21191,37071,40-44,7361,6851,14212
21192,37071,45-49,7911,7234,15145
21193,37071,50-54,8459,8171,16630
21194,37071,55-59,8239,7882,16121
21195,37071,60-64,7713,7191,14904
21196,37071,65+,21571,16376,37947
21197,37073,15-19,292,319,611
21198,37073,20-24,222,259,481
21199,37073,25-29,281,279,560
21200,37073,30-34,280,299,579
21201,37073,35-39,294,272,566
21202,37073,40-44,268,268,536
21203,37073,45-49,305,258,563
21204,37073,50-54,382,375,757
21205,37073,55-59,460,457,917
21206,37073,60-64,444,445,889
21207,37073,65+,1227,1043,2270
21208,37075,15-19,227,257,484
21209,37075,20-24,187,238,425
21210,37075,25-29,208,205,413
21211,37075,30-34,232,222,454
21212,37075,35-39,206,199,405
21213,37075,40-44,230,227,457
21214,37075,45-49,199,232,431
21215,37075,50-54,249,256,505
21216,37075,55-59,282,296,578
21217,37075,60-64,314,284,598
21218,37075,65+,1061,934,1995
21219,37077,15-19,1728,2200,3928
21220,37077,20-24,1500,2009,3509
21221,37077,25-29,1783,1846,3629
21222,37077,30-34,1909,1982,3891
21223,37077,35-39,1760,2025,3785
21224,37077,40-44,1850,1953,3803
21225,37077,45-49,1981,2124,4105
21226,37077,50-54,2242,2461,4703
21227,37077,55-59,2368,2503,4871
21228,37077,60-64,2248,2239,4487
21229,37077,65+,6012,5091,11103
21230,37079,15-19,538,601,1139
21231,37079,20-24,522,806,1328
21232,37079,25-29,510,944,1454
21233,37079,30-34,479,910,1389
21234,37079,35-39,515,877,1392
21235,37079,40-44,516,878,1394
21236,37079,45-49,565,790,1355
21237,37079,50-54,527,710,1237
21238,37079,55-59,643,711,1354
21239,37079,60-64,689,726,1415
21240,37079,65+,2000,1600,3600
21241,37081,15-19,21911,19987,41898
21242,37081,20-24,20085,18372,38457
21243,37081,25-29,18882,17491,36373
21244,37081,30-34,19654,17142,36796
21245,37081,35-39,17890,15810,33700
21246,37081,40-44,17582,15874,33456
21247,37081,45-49,17160,15396,32556
21248,37081,50-54,18739,17429,36168
21249,37081,55-59,18177,16847,35024
21250,37081,60-64,17337,15798,33135
21251,37081,65+,48788,37468,86256
21252,37083,15-19,1391,1510,2901
21253,37083,20-24,1275,1304,2579
21254,37083,25-29,1307,1400,2707
21255,37083,30-34,1438,1407,2845
21256,37083,35-39,1315,1340,2655
21257,37083,40-44,1303,1313,2616
21258,37083,45-49,1321,1213,2534
21259,37083,50-54,1583,1473,3056
21260,37083,55-59,1909,1779,3688
21261,37083,60-64,1930,1735,3665
21262,37083,65+,6029,4530,10559
21263,37085,15-19,4522,4528,9050
21264,37085,20-24,4198,4049,8247
21265,37085,25-29,4821,4982,9803
21266,37085,30-34,5370,5573,10943
21267,37085,35-39,5026,5191,10217
21268,37085,40-44,4308,4452,8760
21269,37085,45-49,4086,4014,8100
21270,37085,50-54,4013,4165,8178
21271,37085,55-59,4007,4037,8044
21272,37085,60-64,3725,3640,7365
21273,37085,65+,10168,7925,18093
21274,37087,15-19,1460,1630,3090
21275,37087,20-24,1412,1469,2881
21276,37087,25-29,1734,1759,3493
21277,37087,30-34,1916,1897,3813
21278,37087,35-39,1769,1672,3441
21279,37087,40-44,1750,1692,3442
21280,37087,45-49,1855,1839,3694
21281,37087,50-54,2134,2018,4152
21282,37087,55-59,2441,2254,4695
21283,37087,60-64,2685,2304,4989
21284,37087,65+,8545,7109,15654
21285,37089,15-19,3022,3089,6111
21286,37089,20-24,2576,2624,5200
21287,37089,25-29,2903,2843,5746
21288,37089,30-34,3238,3102,6340
21289,37089,35-39,3343,3244,6587
21290,37089,40-44,3365,3240,6605
21291,37089,45-49,3428,3330,6758
21292,37089,50-54,3830,3924,7754
21293,37089,55-59,4280,3867,8147
21294,37089,60-64,4796,4144,8940
21295,37089,65+,17060,13992,31052
21296,37091,15-19,789,865,1654
21297,37091,20-24,619,714,1333
21298,37091,25-29,542,675,1217
21299,37091,30-34,563,670,1233
21300,37091,35-39,567,676,1243
21301,37091,40-44,552,674,1226
21302,37091,45-49,535,613,1148
21303,37091,50-54,633,623,1256
21304,37091,55-59,772,771,1543
21305,37091,60-64,897,790,1687
21306,37091,65+,2654,1936,4590
21307,37093,15-19,1521,1721,3242
21308,37093,20-24,1571,1619,3190
21309,37093,25-29,2111,2205,4316
21310,37093,30-34,2345,2358,4703
21311,37093,35-39,2088,2067,4155
21312,37093,40-44,1828,1673,3501
21313,37093,45-49,1523,1475,2998
21314,37093,50-54,1517,1479,2996
21315,37093,55-59,1616,1502,3118
21316,37093,60-64,1491,1348,2839
21317,37093,65+,3209,2618,5827
21318,37095,15-19,114,97,211
21319,37095,20-24,74,151,225
21320,37095,25-29,86,174,260
21321,37095,30-34,89,192,281
21322,37095,35-39,102,191,293
21323,37095,40-44,99,183,282
21324,37095,45-49,133,176,309
21325,37095,50-54,136,157,293
21326,37095,55-59,158,148,306
21327,37095,60-64,192,182,374
21328,37095,65+,588,495,1083
21329,37097,15-19,6155,6503,12658
21330,37097,20-24,5309,5576,10885
21331,37097,25-29,5674,5805,11479
21332,37097,30-34,5929,6040,11969
21333,37097,35-39,6092,5808,11900
21334,37097,40-44,6173,6051,12224
21335,37097,45-49,6559,6416,12975
21336,37097,50-54,7273,7255,14528
21337,37097,55-59,7227,7092,14319
21338,37097,60-64,6659,6382,13041
21339,37097,65+,16827,14284,31111
21340,37099,15-19,2148,1981,4129
21341,37099,20-24,2571,2517,5088
21342,37099,25-29,1141,1133,2274
21343,37099,30-34,1149,1261,2410
21344,37099,35-39,1079,1200,2279
21345,37099,40-44,1167,1097,2264
21346,37099,45-49,1065,1133,2198
21347,37099,50-54,1209,1242,2451
21348,37099,55-59,1371,1262,2633
21349,37099,60-64,1486,1433,2919
21350,37099,65+,4809,4081,8890
21351,37101,15-19,7444,8104,15548
21352,37101,20-24,6115,6353,12468
21353,37101,25-29,6908,6704,13612
21354,37101,30-34,7842,7459,15301
21355,37101,35-39,7846,7601,15447
21356,37101,40-44,8089,7755,15844
21357,37101,45-49,7972,7798,15770
21358,37101,50-54,8444,8209,16653
21359,37101,55-59,7561,7664,15225
21360,37101,60-64,6762,6481,13243
21361,37101,65+,17352,13789,31141
21362,37103,15-19,237,222,459
21363,37103,20-24,235,230,465
21364,37103,25-29,236,262,498
21365,37103,30-34,256,290,546
21366,37103,35-39,249,256,505
21367,37103,40-44,263,240,503
21368,37103,45-49,241,272,513
21369,37103,50-54,297,300,597
21370,37103,55-59,385,353,738
21371,37103,60-64,423,351,774
21372,37103,65+,1230,1033,2263
21373,37105,15-19,1967,2185,4152
21374,37105,20-24,1804,1838,3642
21375,37105,25-29,2032,2013,4045
21376,37105,30-34,2110,2057,4167
21377,37105,35-39,1951,1935,3886
21378,37105,40-44,1994,2020,4014
21379,37105,45-49,1910,1822,3732
21380,37105,50-54,2148,2169,4317
21381,37105,55-59,2257,2172,4429
21382,37105,60-64,2144,2043,4187
21383,37105,65+,6071,4920,10991
21384,37107,15-19,1588,1808,3396
21385,37107,20-24,1508,1535,3043
21386,37107,25-29,1623,1633,3256
21387,37107,30-34,1656,1460,3116
21388,37107,35-39,1535,1361,2896
21389,37107,40-44,1562,1434,2996
21390,37107,45-49,1582,1505,3087
21391,37107,50-54,1774,1583,3357
21392,37107,55-59,2012,1867,3879
21393,37107,60-64,2183,1918,4101
21394,37107,65+,6533,4883,11416
21395,37109,15-19,2486,2806,5292
21396,37109,20-24,2219,2291,4510
21397,37109,25-29,2339,2454,4793
21398,37109,30-34,2689,2628,5317
21399,37109,35-39,2575,2689,5264
21400,37109,40-44,2815,2724,5539
21401,37109,45-49,3048,3062,6110
21402,37109,50-54,3405,3540,6945
21403,37109,55-59,3505,3650,7155
21404,37109,60-64,3368,3386,6754
21405,37109,65+,9116,7748,16864
21406,37111,15-19,1143,1349,2492
21407,37111,20-24,1154,1250,2404
21408,37111,25-29,1273,1439,2712
21409,37111,30-34,1285,1394,2679
21410,37111,35-39,1184,1285,2469
21411,37111,40-44,1262,1352,2614
21412,37111,45-49,1408,1510,2918
21413,37111,50-54,1526,1616,3142
21414,37111,55-59,1675,1604,3279
21415,37111,60-64,1706,1608,3314
21416,37111,65+,5211,4372,9583
21417,37113,15-19,976,1010,1986
21418,37113,20-24,817,885,1702
21419,37113,25-29,873,895,1768
21420,37113,30-34,952,898,1850
21421,37113,35-39,1024,915,1939
21422,37113,40-44,955,918,1873
21423,37113,45-49,920,933,1853
21424,37113,50-54,1094,1132,2226
21425,37113,55-59,1440,1280,2720
21426,37113,60-64,1650,1502,3152
21427,37113,65+,5884,5047,10931
21428,37115,15-19,630,712,1342
21429,37115,20-24,637,719,1356
21430,37115,25-29,582,568,1150
21431,37115,30-34,672,652,1324
21432,37115,35-39,624,597,1221
21433,37115,40-44,660,641,1301
21434,37115,45-49,645,681,1326
21435,37115,50-54,686,719,1405
21436,37115,55-59,759,765,1524
21437,37115,60-64,865,774,1639
21438,37115,65+,2647,2244,4891
21439,37117,15-19,605,574,1179
21440,37117,20-24,576,562,1138
21441,37117,25-29,572,575,1147
21442,37117,30-34,613,522,1135
21443,37117,35-39,559,498,1057
21444,37117,40-44,566,508,1074
21445,37117,45-49,623,530,1153
21446,37117,50-54,752,657,1409
21447,37117,55-59,826,741,1567
21448,37117,60-64,880,870,1750
21449,37117,65+,3082,2390,5472
21450,37119,15-19,35761,35402,71163
21451,37119,20-24,37435,34910,72345
21452,37119,25-29,48608,46375,94983
21453,37119,30-34,49484,47323,96807
21454,37119,35-39,43480,42540,86020
21455,37119,40-44,41248,38375,79623
21456,37119,45-49,38846,35276,74122
21457,37119,50-54,38266,35919,74185
21458,37119,55-59,35005,32316,67321
21459,37119,60-64,31277,28136,59413
21460,37119,65+,76476,56804,133280
21461,37121,15-19,357,411,768
21462,37121,20-24,321,372,693
21463,37121,25-29,380,415,795
21464,37121,30-34,432,439,871
21465,37121,35-39,389,390,779
21466,37121,40-44,387,438,825
21467,37121,45-49,420,442,862
21468,37121,50-54,488,546,1034
21469,37121,55-59,596,536,1132
21470,37121,60-64,606,552,1158
21471,37121,65+,2022,1759,3781
21472,37123,15-19,814,832,1646
21473,37123,20-24,775,755,1530
21474,37123,25-29,719,757,1476
21475,37123,30-34,721,680,1401
21476,37123,35-39,681,607,1288
21477,37123,40-44,720,719,1439
21478,37123,45-49,796,768,1564
21479,37123,50-54,869,805,1674
21480,37123,55-59,900,944,1844
21481,37123,60-64,1006,921,1927
21482,37123,65+,2980,2586,5566
21483,37125,15-19,2694,2817,5511
21484,37125,20-24,2215,2269,4484
21485,37125,25-29,2717,2686,5403
21486,37125,30-34,3417,3306,6723
21487,37125,35-39,3410,3542,6952
21488,37125,40-44,2906,2975,5881
21489,37125,45-49,2913,2673,5586
21490,37125,50-54,2921,2811,5732
21491,37125,55-59,3369,3091,6460
21492,37125,60-64,3717,3356,7073
21493,37125,65+,13302,11005,24307
21494,37127,15-19,3014,3195,6209
21495,37127,20-24,2865,2986,5851
21496,37127,25-29,3006,2846,5852
21497,37127,30-34,2902,2823,5725
21498,37127,35-39,2707,2576,5283
21499,37127,40-44,2808,2615,5423
21500,37127,45-49,3044,2795,5839
21501,37127,50-54,3240,3127,6367
21502,37127,55-59,3518,3266,6784
21503,37127,60-64,3407,3188,6595
21504,37127,65+,10334,7881,18215
21505,37129,15-19,8006,7189,15195
21506,37129,20-24,10833,9783,20616
21507,37129,25-29,7778,7490,15268
21508,37129,30-34,7084,7222,14306
21509,37129,35-39,7426,6809,14235
21510,37129,40-44,7409,7043,14452
21511,37129,45-49,6930,6830,13760
21512,37129,50-54,7483,7005,14488
21513,37129,55-59,7687,7065,14752
21514,37129,60-64,8376,6930,15306
21515,37129,65+,24317,18919,43236
21516,37131,15-19,385,448,833
21517,37131,20-24,366,422,788
21518,37131,25-29,406,472,878
21519,37131,30-34,439,482,921
21520,37131,35-39,395,362,757
21521,37131,40-44,388,401,789
21522,37131,45-49,448,445,893
21523,37131,50-54,537,524,1061
21524,37131,55-59,722,639,1361
21525,37131,60-64,833,721,1554
21526,37131,65+,2699,2146,4845
21527,37133,15-19,5418,10824,16242
21528,37133,20-24,8977,25580,34557
21529,37133,25-29,8221,11348,19569
21530,37133,30-34,7729,8314,16043
21531,37133,35-39,6537,7044,13581
21532,37133,40-44,5004,4956,9960
21533,37133,45-49,4039,4016,8055
21534,37133,50-54,4036,3544,7580
21535,37133,55-59,4462,3862,8324
21536,37133,60-64,4483,3952,8435
21537,37133,65+,11153,9229,20382
21538,37135,15-19,7874,6976,14850
21539,37135,20-24,10049,8140,18189
21540,37135,25-29,4734,4449,9183
21541,37135,30-34,4133,3980,8113
21542,37135,35-39,4182,3913,8095
21543,37135,40-44,4584,4223,8807
21544,37135,45-49,4502,4301,8803
21545,37135,50-54,4735,4685,9420
21546,37135,55-59,4619,4356,8975
21547,37135,60-64,4730,4126,8856
21548,37135,65+,12778,10547,23325
21549,37137,15-19,262,294,556
21550,37137,20-24,229,295,524
21551,37137,25-29,241,318,559
21552,37137,30-34,261,386,647
21553,37137,35-39,312,393,705
21554,37137,40-44,269,319,588
21555,37137,45-49,273,352,625
21556,37137,50-54,343,412,755
21557,37137,55-59,508,446,954
21558,37137,60-64,639,591,1230
21559,37137,65+,1977,1798,3775
21560,37139,15-19,1339,1385,2724
21561,37139,20-24,1362,1433,2795
21562,37139,25-29,1245,1439,2684
21563,37139,30-34,1366,1494,2860
21564,37139,35-39,1338,1322,2660
21565,37139,40-44,1256,1173,2429
21566,37139,45-49,1099,1095,2194
21567,37139,50-54,1194,1163,2357
21568,37139,55-59,1400,1308,2708
21569,37139,60-64,1512,1333,2845
21570,37139,65+,4144,3140,7284
21571,37141,15-19,1763,1883,3646
21572,37141,20-24,1446,1529,2975
21573,37141,25-29,1563,1752,3315
21574,37141,30-34,1873,1900,3773
21575,37141,35-39,2009,2084,4093
21576,37141,40-44,2136,2100,4236
21577,37141,45-49,1965,2179,4144
21578,37141,50-54,2159,2237,4396
21579,37141,55-59,2248,2271,4519
21580,37141,60-64,2332,2249,4581
21581,37141,65+,6184,5378,11562
21582,37143,15-19,338,335,673
21583,37143,20-24,274,291,565
21584,37143,25-29,324,273,597
21585,37143,30-34,371,327,698
21586,37143,35-39,339,334,673
21587,37143,40-44,363,329,692
21588,37143,45-49,302,324,626
21589,37143,50-54,425,412,837
21590,37143,55-59,542,466,1008
21591,37143,60-64,576,545,1121
21592,37143,65+,1946,1706,3652
21593,37145,15-19,1041,1170,2211
21594,37145,20-24,1024,1047,2071
21595,37145,25-29,1178,1137,2315
21596,37145,30-34,1125,1118,2243
21597,37145,35-39,1056,1034,2090
21598,37145,40-44,1071,1076,2147
21599,37145,45-49,1266,1209,2475
21600,37145,50-54,1403,1307,2710
21601,37145,55-59,1555,1453,3008
21602,37145,60-64,1597,1539,3136
21603,37145,65+,4563,3605,8168
21604,37147,15-19,7613,6964,14577
21605,37147,20-24,11605,9952,21557
21606,37147,25-29,6526,5813,12339
21607,37147,30-34,5814,5404,11218
21608,37147,35-39,5408,4698,10106
21609,37147,40-44,5341,4700,10041
21610,37147,45-49,4910,4267,9177
21611,37147,50-54,5011,4495,9506
21612,37147,55-59,5069,4307,9376
21613,37147,60-64,5168,4306,9474
21614,37147,65+,13992,10610,24602
21615,37149,15-19,459,499,958
21616,37149,20-24,406,466,872
21617,37149,25-29,416,414,830
21618,37149,30-34,436,406,842
21619,37149,35-39,425,429,854
21620,37149,40-44,444,464,908
21621,37149,45-49,538,521,1059
21622,37149,50-54,695,642,1337
21623,37149,55-59,745,759,1504
21624,37149,60-64,936,819,1755
21625,37149,65+,3463,2783,6246
21626,37151,15-19,4403,4830,9233
21627,37151,20-24,4120,4291,8411
21628,37151,25-29,4341,4517,8858
21629,37151,30-34,4454,4427,8881
21630,37151,35-39,4027,4090,8117
21631,37151,40-44,4305,4097,8402
21632,37151,45-49,4594,4546,9140
21633,37151,50-54,5257,5436,10693
21634,37151,55-59,5249,5358,10607
21635,37151,60-64,5016,5127,10143
21636,37151,65+,14385,11996,26381
21637,37153,15-19,1347,1408,2755
21638,37153,20-24,1203,1436,2639
21639,37153,25-29,1377,1331,2708
21640,37153,30-34,1346,1263,2609
21641,37153,35-39,1166,1084,2250
21642,37153,40-44,1300,1228,2528
21643,37153,45-49,1392,1238,2630
21644,37153,50-54,1415,1417,2832
21645,37153,55-59,1414,1423,2837
21646,37153,60-64,1472,1392,2864
21647,37153,65+,4333,3442,7775
21648,37155,15-19,4391,4436,8827
21649,37155,20-24,3955,4027,7982
21650,37155,25-29,3730,3697,7427
21651,37155,30-34,3757,3442,7199
21652,37155,35-39,3433,3079,6512
21653,37155,40-44,3588,3298,6886
21654,37155,45-49,3678,3340,7018
21655,37155,50-54,3677,3489,7166
21656,37155,55-59,3706,3526,7232
21657,37155,60-64,3858,3362,7220
21658,37155,65+,10562,7999,18561
21659,37157,15-19,2479,2647,5126
21660,37157,20-24,2383,2450,4833
21661,37157,25-29,2678,2635,5313
21662,37157,30-34,2738,2636,5374
21663,37157,35-39,2487,2327,4814
21664,37157,40-44,2577,2414,4991
21665,37157,45-49,2899,2744,5643
21666,37157,50-54,3337,3210,6547
21667,37157,55-59,3657,3405,7062
21668,37157,60-64,3710,3495,7205
21669,37157,65+,10698,8610,19308
21670,37159,15-19,4567,5094,9661
21671,37159,20-24,4559,4734,9293
21672,37159,25-29,4538,4673,9211
21673,37159,30-34,4703,4629,9332
21674,37159,35-39,4261,4322,8583
21675,37159,40-44,4457,4340,8797
21676,37159,45-49,4402,4567,8969
21677,37159,50-54,5089,5036,10125
21678,37159,55-59,5415,5224,10639
21679,37159,60-64,5244,5144,10388
21680,37159,65+,14578,12085,26663
21681,37161,15-19,1848,1858,3706
21682,37161,20-24,1707,1742,3449
21683,37161,25-29,1822,1745,3567
21684,37161,30-34,1826,1724,3550
21685,37161,35-39,1708,1636,3344
21686,37161,40-44,1847,1817,3664
21687,37161,45-49,2010,1941,3951
21688,37161,50-54,2401,2301,4702
21689,37161,55-59,2420,2377,4797
21690,37161,60-64,2567,2338,4905
21691,37161,65+,7874,6462,14336
21692,37163,15-19,1889,2045,3934
21693,37163,20-24,1751,1769,3520
21694,37163,25-29,1718,1771,3489
21695,37163,30-34,1655,1733,3388
21696,37163,35-39,1585,1632,3217
21697,37163,40-44,1720,1724,3444
21698,37163,45-49,1785,1891,3676
21699,37163,50-54,1916,1903,3819
21700,37163,55-59,1846,2018,3864
21701,37163,60-64,1986,1848,3834
21702,37163,65+,6148,4722,10870
21703,37165,15-19,1024,1130,2154
21704,37165,20-24,1060,1156,2216
21705,37165,25-29,1027,1249,2276
21706,37165,30-34,963,1159,2122
21707,37165,35-39,909,1091,2000
21708,37165,40-44,926,951,1877
21709,37165,45-49,968,1138,2106
21710,37165,50-54,1019,1010,2029
21711,37165,55-59,1080,1069,2149
21712,37165,60-64,1111,1022,2133
21713,37165,65+,3651,2720,6371
21714,37167,15-19,1920,1945,3865
21715,37167,20-24,1710,1926,3636
21716,37167,25-29,1937,2043,3980
21717,37167,30-34,2018,2210,4228
21718,37167,35-39,1873,1928,3801
21719,37167,40-44,1762,1824,3586
21720,37167,45-49,1774,1894,3668
21721,37167,50-54,2140,2162,4302
21722,37167,55-59,2229,2376,4605
21723,37167,60-64,2166,2103,4269
21724,37167,65+,6647,5560,12207
21725,37169,15-19,1165,1204,2369
21726,37169,20-24,1085,1167,2252
21727,37169,25-29,1224,1290,2514
21728,37169,30-34,1278,1176,2454
21729,37169,35-39,1204,1173,2377
21730,37169,40-44,1189,1181,2370
21731,37169,45-49,1413,1426,2839
21732,37169,50-54,1759,1731,3490
21733,37169,55-59,1808,1864,3672
21734,37169,60-64,1809,1748,3557
21735,37169,65+,5432,4610,10042
21736,37171,15-19,2028,2239,4267
21737,37171,20-24,1993,2040,4033
21738,37171,25-29,1985,2122,4107
21739,37171,30-34,1952,2012,3964
21740,37171,35-39,1851,1840,3691
21741,37171,40-44,2027,1887,3914
21742,37171,45-49,2292,2284,4576
21743,37171,50-54,2552,2526,5078
21744,37171,55-59,2691,2632,5323
21745,37171,60-64,2533,2500,5033
21746,37171,65+,8277,6636,14913
21747,37173,15-19,416,424,840
21748,37173,20-24,408,411,819
21749,37173,25-29,464,440,904
21750,37173,30-34,499,424,923
21751,37173,35-39,421,385,806
21752,37173,40-44,433,392,825
21753,37173,45-49,445,399,844
21754,37173,50-54,479,440,919
21755,37173,55-59,486,476,962
21756,37173,60-64,514,437,951
21757,37173,65+,1494,1183,2677
21758,37175,15-19,810,877,1687
21759,37175,20-24,739,932,1671
21760,37175,25-29,731,800,1531
21761,37175,30-34,827,760,1587
21762,37175,35-39,857,786,1643
21763,37175,40-44,831,811,1642
21764,37175,45-49,888,905,1793
21765,37175,50-54,960,900,1860
21766,37175,55-59,1294,1053,2347
21767,37175,60-64,1524,1296,2820
21768,37175,65+,5516,4860,10376
21769,37177,15-19,67,95,162
21770,37177,20-24,64,118,182
21771,37177,25-29,73,139,212
21772,37177,30-34,65,146,211
21773,37177,35-39,70,114,184
21774,37177,40-44,76,138,214
21775,37177,45-49,85,103,188
21776,37177,50-54,93,94,187
21777,37177,55-59,119,104,223
21778,37177,60-64,127,136,263
21779,37177,65+,368,334,702
21780,37179,15-19,10145,10746,20891
21781,37179,20-24,7260,7655,14915
21782,37179,25-29,5795,5748,11543
21783,37179,30-34,6237,5941,12178
21784,37179,35-39,7703,7124,14827
21785,37179,40-44,9220,8442,17662
21786,37179,45-49,9430,9375,18805
21787,37179,50-54,9771,10118,19889
21788,37179,55-59,8106,8699,16805
21789,37179,60-64,6964,7028,13992
21790,37179,65+,17722,14426,32148
21791,37181,15-19,1391,1400,2791
21792,37181,20-24,1261,1275,2536
21793,37181,25-29,1353,1264,2617
21794,37181,30-34,1340,1213,2553
21795,37181,35-39,1251,948,2199
21796,37181,40-44,1244,1063,2307
21797,37181,45-49,1230,1093,2323
21798,37181,50-54,1446,1305,2751
21799,37181,55-59,1516,1329,2845
21800,37181,60-64,1595,1272,2867
21801,37181,65+,4710,3460,8170
21802,37183,15-19,39692,40748,80440
21803,37183,20-24,36376,35268,71644
21804,37183,25-29,41446,39795,81241
21805,37183,30-34,44099,42115,86214
21806,37183,35-39,44045,42278,86323
21807,37183,40-44,43872,41785,85657
21808,37183,45-49,41126,40465,81591
21809,37183,50-54,40225,39948,80173
21810,37183,55-59,36637,35241,71878
21811,37183,60-64,32419,30186,62605
21812,37183,65+,81167,63302,144469
21813,37185,15-19,485,448,933
21814,37185,20-24,426,495,921
21815,37185,25-29,463,552,1015
21816,37185,30-34,458,574,1032
21817,37185,35-39,437,508,945
21818,37185,40-44,482,541,1023
21819,37185,45-49,433,500,933
21820,37185,50-54,539,566,1105
21821,37185,55-59,741,734,1475
21822,37185,60-64,827,768,1595
21823,37185,65+,2758,2285,5043
21824,37187,15-19,313,284,597
21825,37187,20-24,255,269,524
21826,37187,25-29,283,296,579
21827,37187,30-34,267,265,532
21828,37187,35-39,255,230,485
21829,37187,40-44,274,242,516
21830,37187,45-49,293,242,535
21831,37187,50-54,430,292,722
21832,37187,55-59,415,387,802
21833,37187,60-64,477,422,899
21834,37187,65+,1608,1299,2907
21835,37189,15-19,3060,2711,5771
21836,37189,20-24,5047,5241,10288
21837,37189,25-29,1518,1660,3178
21838,37189,30-34,1251,1307,2558
21839,37189,35-39,1241,1361,2602
21840,37189,40-44,1285,1391,2676
21841,37189,45-49,1318,1368,2686
21842,37189,50-54,1410,1498,2908
21843,37189,55-59,1631,1538,3169
21844,37189,60-64,1817,1636,3453
21845,37189,65+,4976,4485,9461
21846,37191,15-19,3772,3953,7725
21847,37191,20-24,3764,4542,8306
21848,37191,25-29,3860,4200,8060
21849,37191,30-34,3853,3814,7667
21850,37191,35-39,3520,3432,6952
21851,37191,40-44,3337,3170,6507
21852,37191,45-49,3433,3102,6535
21853,37191,50-54,3602,3365,6967
21854,37191,55-59,3779,3792,7571
21855,37191,60-64,3943,3500,7443
21856,37191,65+,11237,8764,20001
21857,37193,15-19,1858,2034,3892
21858,37193,20-24,1773,1856,3629
21859,37193,25-29,1790,1883,3673
21860,37193,30-34,1844,1771,3615
21861,37193,35-39,1643,1726,3369
21862,37193,40-44,1809,1878,3687
21863,37193,45-49,2041,2053,4094
21864,37193,50-54,2210,2280,4490
21865,37193,55-59,2464,2448,4912
21866,37193,60-64,2489,2455,4944
21867,37193,65+,8109,6737,14846
21868,37195,15-19,2602,2606,5208
21869,37195,20-24,2473,2353,4826
21870,37195,25-29,2413,2364,4777
21871,37195,30-34,2469,2138,4607
21872,37195,35-39,2315,2169,4484
21873,37195,40-44,2376,2113,4489
21874,37195,45-49,2466,2099,4565
21875,37195,50-54,2627,2418,5045
21876,37195,55-59,2863,2584,5447
21877,37195,60-64,2801,2520,5321
21878,37195,65+,8435,6417,14852
21879,37197,15-19,974,1148,2122
21880,37197,20-24,1014,1074,2088
21881,37197,25-29,1036,1178,2214
21882,37197,30-34,989,1042,2031
21883,37197,35-39,971,894,1865
21884,37197,40-44,1030,1042,2072
21885,37197,45-49,1107,1142,2249
21886,37197,50-54,1403,1449,2852
21887,37197,55-59,1524,1444,2968
21888,37197,60-64,1340,1396,2736
21889,37197,65+,4196,3504,7700
21890,37199,15-19,416,532,948
21891,37199,20-24,450,424,874
21892,37199,25-29,505,530,1035
21893,37199,30-34,511,513,1024
21894,37199,35-39,480,514,994
21895,37199,40-44,506,491,997
21896,37199,45-49,548,578,1126
21897,37199,50-54,624,634,1258
21898,37199,55-59,692,668,1360
21899,37199,60-64,732,656,1388
21900,37199,65+,2681,2275,4956
21901,38001,15-19,53,60,113
21902,38001,20-24,45,51,96
21903,38001,25-29,46,46,92
21904,38001,30-34,55,58,113
21905,38001,35-39,59,62,121
21906,38001,40-44,45,64,109
21907,38001,45-49,51,39,90
21908,38001,50-54,52,49,101
21909,38001,55-59,79,74,153
21910,38001,60-64,87,102,189
21911,38001,65+,332,301,633
21912,38003,15-19,352,427,779
21913,38003,20-24,354,361,715
21914,38003,25-29,252,320,572
21915,38003,30-34,273,325,598
21916,38003,35-39,276,314,590
21917,38003,40-44,280,311,591
21918,38003,45-49,256,290,546
21919,38003,50-54,301,325,626
21920,38003,55-59,342,352,694
21921,38003,60-64,416,438,854
21922,38003,65+,1341,1160,2501
21923,38005,15-19,258,258,516
21924,38005,20-24,138,162,300
21925,38005,25-29,155,164,319
21926,38005,30-34,165,152,317
21927,38005,35-39,141,155,296
21928,38005,40-44,127,149,276
21929,38005,45-49,123,109,232
21930,38005,50-54,135,139,274
21931,38005,55-59,145,156,301
21932,38005,60-64,183,184,367
21933,38005,65+,430,429,859
21934,38007,15-19,26,21,47
21935,38007,20-24,18,14,32
21936,38007,25-29,22,20,42
21937,38007,30-34,22,40,62
21938,38007,35-39,26,46,72
21939,38007,40-44,29,29,58
21940,38007,45-49,18,33,51
21941,38007,50-54,24,26,50
21942,38007,55-59,37,39,76
21943,38007,60-64,29,35,64
21944,38007,65+,107,126,233
21945,38009,15-19,224,212,436
21946,38009,20-24,129,196,325
21947,38009,25-29,149,165,314
21948,38009,30-34,156,189,345
21949,38009,35-39,150,185,335
21950,38009,40-44,160,166,326
21951,38009,45-49,135,153,288
21952,38009,50-54,167,173,340
21953,38009,55-59,202,225,427
21954,38009,60-64,247,278,525
21955,38009,65+,788,764,1552
21956,38011,15-19,84,90,174
21957,38011,20-24,61,69,130
21958,38011,25-29,66,71,137
21959,38011,30-34,68,83,151
21960,38011,35-39,73,94,167
21961,38011,40-44,80,105,185
21962,38011,45-49,71,80,151
21963,38011,50-54,64,68,132
21964,38011,55-59,85,95,180
21965,38011,60-64,119,110,229
21966,38011,65+,360,320,680
21967,38013,15-19,55,69,124
21968,38013,20-24,37,47,84
21969,38013,25-29,43,60,103
21970,38013,30-34,63,67,130
21971,38013,35-39,59,64,123
21972,38013,40-44,56,68,124
21973,38013,45-49,47,54,101
21974,38013,50-54,65,54,119
21975,38013,55-59,50,99,149
21976,38013,60-64,79,102,181
21977,38013,65+,243,224,467
21978,38015,15-19,3418,3368,6786
21979,38015,20-24,2920,3099,6019
21980,38015,25-29,2999,3304,6303
21981,38015,30-34,3277,3545,6822
21982,38015,35-39,3410,3822,7232
21983,38015,40-44,2991,3481,6472
21984,38015,45-49,2618,2768,5386
21985,38015,50-54,2519,2749,5268
21986,38015,55-59,2899,2971,5870
21987,38015,60-64,3281,3023,6304
21988,38015,65+,9333,7660,16993
21989,38017,15-19,6098,6222,12320
21990,38017,20-24,9674,9807,19481
21991,38017,25-29,7821,8195,16016
21992,38017,30-34,7043,7943,14986
21993,38017,35-39,6680,7526,14206
21994,38017,40-44,5671,6435,12106
21995,38017,45-49,4584,5048,9632
21996,38017,50-54,4531,4920,9451
21997,38017,55-59,4582,4857,9439
21998,38017,60-64,4768,4508,9276
21999,38017,65+,12953,10973,23926
22000,38019,15-19,86,107,193
22001,38019,20-24,90,84,174
22002,38019,25-29,86,102,188
22003,38019,30-34,64,85,149
22004,38019,35-39,88,104,192
22005,38019,40-44,82,87,169
22006,38019,45-49,76,84,160
22007,38019,50-54,91,109,200
22008,38019,55-59,128,130,258
22009,38019,60-64,128,168,296
22010,38019,65+,500,497,997
22011,38021,15-19,166,186,352
22012,38021,20-24,145,148,293
22013,38021,25-29,128,132,260
22014,38021,30-34,108,123,231
22015,38021,35-39,126,124,250
22016,38021,40-44,130,147,277
22017,38021,45-49,122,130,252
22018,38021,50-54,138,150,288
22019,38021,55-59,159,146,305
22020,38021,60-64,167,195,362
22021,38021,65+,570,496,1066
22022,38023,15-19,65,59,124
22023,38023,20-24,37,47,84
22024,38023,25-29,47,48,95
22025,38023,30-34,52,68,120
22026,38023,35-39,58,67,125
22027,38023,40-44,56,55,111
22028,38023,45-49,45,50,95
22029,38023,50-54,44,48,92
22030,38023,55-59,90,86,176
22031,38023,60-64,82,96,178
22032,38023,65+,272,273,545
22033,38025,15-19,103,125,228
22034,38025,20-24,75,92,167
22035,38025,25-29,117,133,250
22036,38025,30-34,126,182,308
22037,38025,35-39,109,152,261
22038,38025,40-44,99,137,236
22039,38025,45-49,89,101,190
22040,38025,50-54,86,126,212
22041,38025,55-59,129,154,283
22042,38025,60-64,135,163,298
22043,38025,65+,337,361,698
22044,38027,15-19,72,68,140
22045,38027,20-24,45,56,101
22046,38027,25-29,50,61,111
22047,38027,30-34,61,67,128
22048,38027,35-39,62,71,133
22049,38027,40-44,59,69,128
22050,38027,45-49,59,51,110
22051,38027,50-54,58,54,112
22052,38027,55-59,88,94,182
22053,38027,60-64,90,94,184
22054,38027,65+,286,239,525
22055,38029,15-19,99,101,200
22056,38029,20-24,71,74,145
22057,38029,25-29,73,91,164
22058,38029,30-34,49,69,118
22059,38029,35-39,69,73,142
22060,38029,40-44,68,71,139
22061,38029,45-49,80,84,164
22062,38029,50-54,95,88,183
22063,38029,55-59,130,132,262
22064,38029,60-64,126,173,299
22065,38029,65+,459,455,914
22066,38031,15-19,93,90,183
22067,38031,20-24,75,75,150
22068,38031,25-29,96,107,203
22069,38031,30-34,73,107,180
22070,38031,35-39,78,99,177
22071,38031,40-44,81,98,179
22072,38031,45-49,93,93,186
22073,38031,50-54,88,100,188
22074,38031,55-59,115,110,225
22075,38031,60-64,118,168,286
22076,38031,65+,425,352,777
22077,38033,15-19,53,57,110
22078,38033,20-24,34,35,69
22079,38033,25-29,38,57,95
22080,38033,30-34,39,41,80
22081,38033,35-39,51,38,89
22082,38033,40-44,55,66,121
22083,38033,45-49,45,42,87
22084,38033,50-54,40,47,87
22085,38033,55-59,58,58,116
22086,38033,60-64,83,76,159
22087,38033,65+,253,233,486
22088,38035,15-19,2533,2775,5308
22089,38035,20-24,5076,5685,10761
22090,38035,25-29,2621,3333,5954
22091,38035,30-34,2349,2877,5226
22092,38035,35-39,2177,2483,4660
22093,38035,40-44,1746,2017,3763
22094,38035,45-49,1498,1647,3145
22095,38035,50-54,1555,1613,3168
22096,38035,55-59,1786,1759,3545
22097,38035,60-64,1890,1928,3818
22098,38035,65+,5459,4525,9984
22099,38037,15-19,58,49,107
22100,38037,20-24,39,40,79
22101,38037,25-29,48,56,104
22102,38037,30-34,42,39,81
22103,38037,35-39,65,59,124
22104,38037,40-44,43,62,105
22105,38037,45-49,44,68,112
22106,38037,50-54,62,70,132
22107,38037,55-59,83,85,168
22108,38037,60-64,95,110,205
22109,38037,65+,331,365,696
22110,38039,15-19,51,65,116
22111,38039,20-24,37,57,94
22112,38039,25-29,49,64,113
22113,38039,30-34,45,39,84
22114,38039,35-39,63,58,121
22115,38039,40-44,48,63,111
22116,38039,45-49,53,59,112
22117,38039,50-54,54,54,108
22118,38039,55-59,71,76,147
22119,38039,60-64,90,95,185
22120,38039,65+,354,332,686
22121,38041,15-19,62,66,128
22122,38041,20-24,72,53,125
22123,38041,25-29,66,59,125
22124,38041,30-34,81,70,151
22125,38041,35-39,62,76,138
22126,38041,40-44,64,56,120
22127,38041,45-49,59,52,111
22128,38041,50-54,56,63,119
22129,38041,55-59,82,73,155
22130,38041,60-64,90,107,197
22131,38041,65+,280,288,568
22132,38043,15-19,59,60,119
22133,38043,20-24,49,48,97
22134,38043,25-29,53,63,116
22135,38043,30-34,51,67,118
22136,38043,35-39,61,75,136
22137,38043,40-44,59,62,121
22138,38043,45-49,61,65,126
22139,38043,50-54,63,69,132
22140,38043,55-59,67,78,145
22141,38043,60-64,88,96,184
22142,38043,65+,316,328,644
22143,38045,15-19,106,142,248
22144,38045,20-24,80,88,168
22145,38045,25-29,85,88,173
22146,38045,30-34,89,88,177
22147,38045,35-39,102,84,186
22148,38045,40-44,92,114,206
22149,38045,45-49,101,110,211
22150,38045,50-54,86,116,202
22151,38045,55-59,132,150,282
22152,38045,60-64,188,185,373
22153,38045,65+,560,565,1125
22154,38047,15-19,62,55,117
22155,38047,20-24,49,37,86
22156,38047,25-29,45,51,96
22157,38047,30-34,40,40,80
22158,38047,35-39,41,51,92
22159,38047,40-44,31,42,73
22160,38047,45-49,50,51,101
22161,38047,50-54,42,47,89
22162,38047,55-59,61,70,131
22163,38047,60-64,71,82,153
22164,38047,65+,240,253,493
22165,38049,15-19,146,162,308
22166,38049,20-24,83,118,201
22167,38049,25-29,119,124,243
22168,38049,30-34,124,134,258
22169,38049,35-39,152,192,344
22170,38049,40-44,158,183,341
22171,38049,45-49,123,148,271
22172,38049,50-54,148,167,315
22173,38049,55-59,192,201,393
22174,38049,60-64,176,216,392
22175,38049,65+,583,548,1131
22176,38051,15-19,60,71,131
22177,38051,20-24,36,44,80
22178,38051,25-29,55,64,119
22179,38051,30-34,54,53,107
22180,38051,35-39,75,71,146
22181,38051,40-44,51,51,102
22182,38051,45-49,41,62,103
22183,38051,50-54,56,68,124
22184,38051,55-59,95,98,193
22185,38051,60-64,114,130,244
22186,38051,65+,426,324,750
22187,38053,15-19,494,542,1036
22188,38053,20-24,359,398,757
22189,38053,25-29,521,570,1091
22190,38053,30-34,528,645,1173
22191,38053,35-39,446,593,1039
22192,38053,40-44,416,452,868
22193,38053,45-49,278,366,644
22194,38053,50-54,344,368,712
22195,38053,55-59,334,392,726
22196,38053,60-64,328,374,702
22197,38053,65+,661,693,1354
22198,38055,15-19,263,296,559
22199,38055,20-24,196,194,390
22200,38055,25-29,201,215,416
22201,38055,30-34,254,261,515
22202,38055,35-39,251,302,553
22203,38055,40-44,257,291,548
22204,38055,45-49,251,265,516
22205,38055,50-54,256,291,547
22206,38055,55-59,300,335,635
22207,38055,60-64,447,428,875
22208,38055,65+,1181,1237,2418
22209,38057,15-19,219,279,498
22210,38057,20-24,158,188,346
22211,38057,25-29,162,210,372
22212,38057,30-34,203,237,440
22213,38057,35-39,247,270,517
22214,38057,40-44,231,264,495
22215,38057,45-49,197,220,417
22216,38057,50-54,219,248,467
22217,38057,55-59,293,312,605
22218,38057,60-64,339,413,752
22219,38057,65+,938,878,1816
22220,38059,15-19,873,916,1789
22221,38059,20-24,862,917,1779
22222,38059,25-29,1171,1221,2392
22223,38059,30-34,1217,1346,2563
22224,38059,35-39,1144,1310,2454
22225,38059,40-44,992,1114,2106
22226,38059,45-49,900,978,1878
22227,38059,50-54,898,962,1860
22228,38059,55-59,1013,1017,2030
22229,38059,60-64,1122,1165,2287
22230,38059,65+,3082,2650,5732
22231,38061,15-19,296,329,625
22232,38061,20-24,235,397,632
22233,38061,25-29,286,413,699
22234,38061,30-34,342,408,750
22235,38061,35-39,286,379,665
22236,38061,40-44,263,333,596
22237,38061,45-49,252,295,547
22238,38061,50-54,249,251,500
22239,38061,55-59,231,297,528
22240,38061,60-64,253,333,586
22241,38061,65+,559,550,1109
22242,38063,15-19,82,83,165
22243,38063,20-24,61,64,125
22244,38063,25-29,55,99,154
22245,38063,30-34,77,86,163
22246,38063,35-39,69,89,158
22247,38063,40-44,78,74,152
22248,38063,45-49,65,66,131
22249,38063,50-54,76,82,158
22250,38063,55-59,118,109,227
22251,38063,60-64,140,177,317
22252,38063,65+,396,392,788
22253,38065,15-19,54,66,120
22254,38065,20-24,27,41,68
22255,38065,25-29,29,29,58
22256,38065,30-34,46,55,101
22257,38065,35-39,48,61,109
22258,38065,40-44,51,53,104
22259,38065,45-49,43,54,97
22260,38065,50-54,38,49,87
22261,38065,55-59,69,72,141
22262,38065,60-64,83,85,168
22263,38065,65+,202,241,443
22264,38067,15-19,192,195,387
22265,38067,20-24,116,140,256
22266,38067,25-29,145,173,318
22267,38067,30-34,171,185,356
22268,38067,35-39,196,260,456
22269,38067,40-44,161,237,398
22270,38067,45-49,143,176,319
22271,38067,50-54,173,175,348
22272,38067,55-59,233,239,472
22273,38067,60-64,282,301,583
22274,38067,65+,813,869,1682
22275,38069,15-19,122,113,235
22276,38069,20-24,62,117,179
22277,38069,25-29,95,114,209
22278,38069,30-34,81,102,183
22279,38069,35-39,108,119,227
22280,38069,40-44,113,118,231
22281,38069,45-49,98,100,198
22282,38069,50-54,96,117,213
22283,38069,55-59,122,157,279
22284,38069,60-64,158,139,297
22285,38069,65+,521,436,957
22286,38071,15-19,355,380,735
22287,38071,20-24,296,352,648
22288,38071,25-29,304,401,705
22289,38071,30-34,304,377,681
22290,38071,35-39,320,358,678
22291,38071,40-44,281,317,598
22292,38071,45-49,255,288,543
22293,38071,50-54,312,290,602
22294,38071,55-59,388,413,801
22295,38071,60-64,441,434,875
22296,38071,65+,1207,1112,2319
22297,38073,15-19,143,198,341
22298,38073,20-24,143,158,301
22299,38073,25-29,126,174,300
22300,38073,30-34,137,152,289
22301,38073,35-39,141,157,298
22302,38073,40-44,182,179,361
22303,38073,45-49,145,185,330
22304,38073,50-54,169,201,370
22305,38073,55-59,210,218,428
22306,38073,60-64,204,197,401
22307,38073,65+,599,610,1209
22308,38075,15-19,64,75,139
22309,38075,20-24,42,51,93
22310,38075,25-29,57,60,117
22311,38075,30-34,52,73,125
22312,38075,35-39,61,91,152
22313,38075,40-44,54,52,106
22314,38075,45-49,59,57,116
22315,38075,50-54,72,63,135
22316,38075,55-59,82,97,179
22317,38075,60-64,89,113,202
22318,38075,65+,249,248,497
22319,38077,15-19,624,730,1354
22320,38077,20-24,637,818,1455
22321,38077,25-29,451,488,939
22322,38077,30-34,456,503,959
22323,38077,35-39,455,498,953
22324,38077,40-44,404,469,873
22325,38077,45-49,358,391,749
22326,38077,50-54,388,413,801
22327,38077,55-59,528,489,1017
22328,38077,60-64,535,649,1184
22329,38077,65+,1650,1568,3218
22330,38079,15-19,503,554,1057
22331,38079,20-24,314,345,659
22332,38079,25-29,344,358,702
22333,38079,30-34,354,331,685
22334,38079,35-39,360,350,710
22335,38079,40-44,345,345,690
22336,38079,45-49,286,288,574
22337,38079,50-54,350,276,626
22338,38079,55-59,377,368,745
22339,38079,60-64,357,365,722
22340,38079,65+,795,661,1456
22341,38081,15-19,92,111,203
22342,38081,20-24,82,90,172
22343,38081,25-29,95,163,258
22344,38081,30-34,95,115,210
22345,38081,35-39,89,113,202
22346,38081,40-44,87,124,211
22347,38081,45-49,87,114,201
22348,38081,50-54,105,114,219
22349,38081,55-59,128,143,271
22350,38081,60-64,141,160,301
22351,38081,65+,423,446,869
22352,38083,15-19,25,37,62
22353,38083,20-24,19,16,35
22354,38083,25-29,20,34,54
22355,38083,30-34,34,20,54
22356,38083,35-39,28,37,65
22357,38083,40-44,32,26,58
22358,38083,45-49,19,29,48
22359,38083,50-54,39,45,84
22360,38083,55-59,44,35,79
22361,38083,60-64,47,60,107
22362,38083,65+,216,213,429
22363,38085,15-19,176,188,364
22364,38085,20-24,142,125,267
22365,38085,25-29,103,102,205
22366,38085,30-34,95,115,210
22367,38085,35-39,94,105,199
22368,38085,40-44,98,83,181
22369,38085,45-49,114,104,218
22370,38085,50-54,117,106,223
22371,38085,55-59,118,105,223
22372,38085,60-64,92,94,186
22373,38085,65+,162,165,327
22374,38087,15-19,14,16,30
22375,38087,20-24,8,22,30
22376,38087,25-29,17,16,33
22377,38087,30-34,10,12,22
22378,38087,35-39,19,21,40
22379,38087,40-44,18,25,43
22380,38087,45-49,13,15,28
22381,38087,50-54,16,22,38
22382,38087,55-59,23,28,51
22383,38087,60-64,29,45,74
22384,38087,65+,90,93,183
22385,38089,15-19,951,1041,1992
22386,38089,20-24,928,930,1858
22387,38089,25-29,1121,1195,2316
22388,38089,30-34,1338,1533,2871
22389,38089,35-39,1144,1410,2554
22390,38089,40-44,914,1097,2011
22391,38089,45-49,703,846,1549
22392,38089,50-54,726,915,1641
22393,38089,55-59,926,946,1872
22394,38089,60-64,945,998,1943
22395,38089,65+,2420,2145,4565
22396,38091,15-19,37,51,88
22397,38091,20-24,41,38,79
22398,38091,25-29,34,44,78
22399,38091,30-34,51,48,99
22400,38091,35-39,45,49,94
22401,38091,40-44,38,47,85
22402,38091,45-49,43,46,89
22403,38091,50-54,42,61,103
22404,38091,55-59,59,74,133
22405,38091,60-64,67,76,143
22406,38091,65+,222,252,474
22407,38093,15-19,682,715,1397
22408,38093,20-24,718,810,1528
22409,38093,25-29,578,756,1334
22410,38093,30-34,571,728,1299
22411,38093,35-39,600,744,1344
22412,38093,40-44,588,718,1306
22413,38093,45-49,530,594,1124
22414,38093,50-54,570,660,1230
22415,38093,55-59,670,713,1383
22416,38093,60-64,807,867,1674
22417,38093,65+,2311,1959,4270
22418,38095,15-19,51,63,114
22419,38095,20-24,31,43,74
22420,38095,25-29,41,63,104
22421,38095,30-34,46,41,87
22422,38095,35-39,63,62,125
22423,38095,40-44,44,41,85
22424,38095,45-49,40,32,72
22425,38095,50-54,61,74,135
22426,38095,55-59,85,108,193
22427,38095,60-64,77,114,191
22428,38095,65+,298,263,561
22429,38097,15-19,252,305,557
22430,38097,20-24,205,253,458
22431,38097,25-29,192,265,457
22432,38097,30-34,245,236,481
22433,38097,35-39,217,245,462
22434,38097,40-44,201,213,414
22435,38097,45-49,210,235,445
22436,38097,50-54,223,224,447
22437,38097,55-59,249,301,550
22438,38097,60-64,282,300,582
22439,38097,65+,854,747,1601
22440,38099,15-19,282,338,620
22441,38099,20-24,262,298,560
22442,38099,25-29,255,255,510
22443,38099,30-34,254,285,539
22444,38099,35-39,288,302,590
22445,38099,40-44,272,303,575
22446,38099,45-49,283,286,569
22447,38099,50-54,272,333,605
22448,38099,55-59,383,412,795
22449,38099,60-64,386,456,842
22450,38099,65+,1173,1079,2252
22451,38101,15-19,2030,2567,4597
22452,38101,20-24,2641,4147,6788
22453,38101,25-29,2824,3382,6206
22454,38101,30-34,2473,2987,5460
22455,38101,35-39,2311,2750,5061
22456,38101,40-44,1890,2095,3985
22457,38101,45-49,1620,1698,3318
22458,38101,50-54,1531,1682,3213
22459,38101,55-59,1759,1731,3490
22460,38101,60-64,1801,1827,3628
22461,38101,65+,4987,4287,9274
22462,38103,15-19,90,107,197
22463,38103,20-24,63,83,146
22464,38103,25-29,72,79,151
22465,38103,30-34,90,93,183
22466,38103,35-39,93,103,196
22467,38103,40-44,81,84,165
22468,38103,45-49,74,80,154
22469,38103,50-54,129,123,252
22470,38103,55-59,156,149,305
22471,38103,60-64,176,184,360
22472,38103,65+,572,538,1110
22473,38105,15-19,1146,1225,2371
22474,38105,20-24,991,1136,2127
22475,38105,25-29,1478,1723,3201
22476,38105,30-34,1608,2060,3668
22477,38105,35-39,1349,1672,3021
22478,38105,40-44,1004,1361,2365
22479,38105,45-49,825,1109,1934
22480,38105,50-54,903,1082,1985
22481,38105,55-59,947,1041,1988
22482,38105,60-64,828,1105,1933
22483,38105,65+,1957,1842,3799
22484,39001,15-19,867,963,1830
22485,39001,20-24,742,717,1459
22486,39001,25-29,772,747,1519
22487,39001,30-34,789,759,1548
22488,39001,35-39,740,683,1423
22489,39001,40-44,845,833,1678
22490,39001,45-49,886,850,1736
22491,39001,50-54,931,961,1892
22492,39001,55-59,967,952,1919
22493,39001,60-64,988,1011,1999
22494,39001,65+,2625,2471,5096
22495,39003,15-19,3309,3969,7278
22496,39003,20-24,3155,3777,6932
22497,39003,25-29,2886,3432,6318
22498,39003,30-34,2974,3270,6244
22499,39003,35-39,2898,3021,5919
22500,39003,40-44,3044,3107,6151
22501,39003,45-49,2719,2901,5620
22502,39003,50-54,2852,3167,6019
22503,39003,55-59,3262,3282,6544
22504,39003,60-64,3462,3327,6789
22505,39003,65+,10141,8397,18538
22506,39005,15-19,1905,1859,3764
22507,39005,20-24,1899,1815,3714
22508,39005,25-29,1466,1546,3012
22509,39005,30-34,1400,1448,2848
22510,39005,35-39,1511,1549,3060
22511,39005,40-44,1421,1496,2917
22512,39005,45-49,1423,1447,2870
22513,39005,50-54,1637,1614,3251
22514,39005,55-59,1704,1701,3405
22515,39005,60-64,1937,1791,3728
22516,39005,65+,5520,4698,10218
22517,39007,15-19,2843,3103,5946
22518,39007,20-24,2450,2899,5349
22519,39007,25-29,2635,3115,5750
22520,39007,30-34,2693,3009,5702
22521,39007,35-39,2625,2852,5477
22522,39007,40-44,2693,2772,5465
22523,39007,45-49,2776,2954,5730
22524,39007,50-54,3212,3379,6591
22525,39007,55-59,3486,3578,7064
22526,39007,60-64,3643,3618,7261
22527,39007,65+,10404,9083,19487
22528,39009,15-19,4250,3798,8048
22529,39009,20-24,5474,5578,11052
22530,39009,25-29,1652,1949,3601
22531,39009,30-34,1657,1830,3487
22532,39009,35-39,1562,1678,3240
22533,39009,40-44,1640,1688,3328
22534,39009,45-49,1414,1523,2937
22535,39009,50-54,1640,1605,3245
22536,39009,55-59,1745,1716,3461
22537,39009,60-64,1755,1767,3522
22538,39009,65+,4802,4048,8850
22539,39011,15-19,1424,1525,2949
22540,39011,20-24,1258,1320,2578
22541,39011,25-29,1270,1420,2690
22542,39011,30-34,1335,1404,2739
22543,39011,35-39,1314,1305,2619
22544,39011,40-44,1346,1403,2749
22545,39011,45-49,1281,1371,2652
22546,39011,50-54,1411,1416,2827
22547,39011,55-59,1572,1564,3136
22548,39011,60-64,1604,1697,3301
22549,39011,65+,4725,4026,8751
22550,39013,15-19,1610,1914,3524
22551,39013,20-24,1465,2115,3580
22552,39013,25-29,1697,2259,3956
22553,39013,30-34,1865,2363,4228
22554,39013,35-39,1847,2152,3999
22555,39013,40-44,1791,2116,3907
22556,39013,45-49,1826,2100,3926
22557,39013,50-54,2053,2279,4332
22558,39013,55-59,2328,2279,4607
22559,39013,60-64,2669,2602,5271
22560,39013,65+,7811,6447,14258
22561,39015,15-19,1278,1449,2727
22562,39015,20-24,1103,1121,2224
22563,39015,25-29,1275,1274,2549
22564,39015,30-34,1195,1279,2474
22565,39015,35-39,1283,1218,2501
22566,39015,40-44,1332,1330,2662
22567,39015,45-49,1329,1425,2754
22568,39015,50-54,1446,1421,2867
22569,39015,55-59,1571,1695,3266
22570,39015,60-64,1658,1612,3270
22571,39015,65+,4327,3887,8214
22572,39017,15-19,15322,15281,30603
22573,39017,20-24,16676,16904,33580
22574,39017,25-29,11356,11325,22681
22575,39017,30-34,11518,11450,22968
22576,39017,35-39,12187,11992,24179
22577,39017,40-44,12037,11978,24015
22578,39017,45-49,11168,11184,22352
22579,39017,50-54,12281,12128,24409
22580,39017,55-59,12677,12617,25294
22581,39017,60-64,12797,12232,25029
22582,39017,65+,32969,27422,60391
22583,39019,15-19,774,834,1608
22584,39019,20-24,631,671,1302
22585,39019,25-29,664,716,1380
22586,39019,30-34,699,679,1378
22587,39019,35-39,687,729,1416
22588,39019,40-44,713,791,1504
22589,39019,45-49,791,830,1621
22590,39019,50-54,849,900,1749
22591,39019,55-59,1018,1053,2071
22592,39019,60-64,1080,1142,2222
22593,39019,65+,3088,2830,5918
22594,39021,15-19,1229,1338,2567
22595,39021,20-24,1011,1123,2134
22596,39021,25-29,1181,1256,2437
22597,39021,30-34,1138,1168,2306
22598,39021,35-39,1131,1132,2263
22599,39021,40-44,1080,1124,2204
22600,39021,45-49,1152,1144,2296
22601,39021,50-54,1320,1396,2716
22602,39021,55-59,1399,1438,2837
22603,39021,60-64,1395,1404,2799
22604,39021,65+,3928,3323,7251
22605,39023,15-19,4467,4565,9032
22606,39023,20-24,4232,4203,8435
22607,39023,25-29,3950,3952,7902
22608,39023,30-34,4091,3937,8028
22609,39023,35-39,3999,3810,7809
22610,39023,40-44,3908,3629,7537
22611,39023,45-49,3828,3740,7568
22612,39023,50-54,4366,4390,8756
22613,39023,55-59,4666,4577,9243
22614,39023,60-64,4876,4513,9389
22615,39023,65+,14787,12081,26868
22616,39025,15-19,6227,6813,13040
22617,39025,20-24,5731,6026,11757
22618,39025,25-29,6398,6465,12863
22619,39025,30-34,6654,6834,13488
22620,39025,35-39,6490,6872,13362
22621,39025,40-44,6627,6677,13304
22622,39025,45-49,6305,6095,12400
22623,39025,50-54,6936,7097,14033
22624,39025,55-59,7401,7325,14726
22625,39025,60-64,7813,7408,15221
22626,39025,65+,20200,16872,37072
22627,39027,15-19,1380,1516,2896
22628,39027,20-24,1385,1402,2787
22629,39027,25-29,1223,1237,2460
22630,39027,30-34,1223,1219,2442
22631,39027,35-39,1205,1242,2447
22632,39027,40-44,1286,1293,2579
22633,39027,45-49,1245,1207,2452
22634,39027,50-54,1364,1318,2682
22635,39027,55-59,1433,1477,2910
22636,39027,60-64,1503,1494,2997
22637,39027,65+,4134,3416,7550
22638,39029,15-19,2715,2993,5708
22639,39029,20-24,2496,2747,5243
22640,39029,25-29,2625,3103,5728
22641,39029,30-34,2752,3152,5904
22642,39029,35-39,2675,3269,5944
22643,39029,40-44,2731,3301,6032
22644,39029,45-49,2884,3271,6155
22645,39029,50-54,3182,3549,6731
22646,39029,55-59,3587,3664,7251
22647,39029,60-64,4037,4056,8093
22648,39029,65+,11722,9913,21635
22649,39031,15-19,1116,1236,2352
22650,39031,20-24,932,957,1889
22651,39031,25-29,1032,1024,2056
22652,39031,30-34,1109,1019,2128
22653,39031,35-39,1040,1077,2117
22654,39031,40-44,1038,1045,2083
22655,39031,45-49,1012,1043,2055
22656,39031,50-54,1135,1158,2293
22657,39031,55-59,1241,1264,2505
22658,39031,60-64,1322,1303,2625
22659,39031,65+,3945,3338,7283
22660,39033,15-19,1225,1318,2543
22661,39033,20-24,1154,1143,2297
22662,39033,25-29,1155,1287,2442
22663,39033,30-34,1170,1174,2344
22664,39033,35-39,1154,1116,2270
22665,39033,40-44,1260,1130,2390
22666,39033,45-49,1261,1324,2585
22667,39033,50-54,1350,1415,2765
22668,39033,55-59,1384,1413,2797
22669,39033,60-64,1523,1458,2981
22670,39033,65+,4916,3995,8911
22671,39035,15-19,36359,37687,74046
22672,39035,20-24,38721,37553,76274
22673,39035,25-29,45799,43915,89714
22674,39035,30-34,45603,43616,89219
22675,39035,35-39,40617,38436,79053
22676,39035,40-44,37531,35520,73051
22677,39035,45-49,35366,32756,68122
22678,39035,50-54,40016,37320,77336
22679,39035,55-59,43958,39732,83690
22680,39035,60-64,47003,42691,89694
22681,39035,65+,135214,102326,237540
22682,39037,15-19,1635,1718,3353
22683,39037,20-24,1354,1473,2827
22684,39037,25-29,1368,1503,2871
22685,39037,30-34,1373,1432,2805
22686,39037,35-39,1376,1408,2784
22687,39037,40-44,1514,1541,3055
22688,39037,45-49,1388,1473,2861
22689,39037,50-54,1591,1678,3269
22690,39037,55-59,1848,1813,3661
22691,39037,60-64,1848,1861,3709
22692,39037,65+,5601,4707,10308
22693,39039,15-19,1292,1385,2677
22694,39039,20-24,1110,1186,2296
22695,39039,25-29,1029,1107,2136
22696,39039,30-34,1119,1127,2246
22697,39039,35-39,1165,1187,2352
22698,39039,40-44,1182,1198,2380
22699,39039,45-49,1068,1099,2167
22700,39039,50-54,1151,1192,2343
22701,39039,55-59,1191,1171,2362
22702,39039,60-64,1378,1313,2691
22703,39039,65+,3949,3480,7429
22704,39041,15-19,7852,8558,16410
22705,39041,20-24,5964,6190,12154
22706,39041,25-29,4694,4650,9344
22707,39041,30-34,6193,5791,11984
22708,39041,35-39,8285,7982,16267
22709,39041,40-44,8625,8848,17473
22710,39041,45-49,8126,8539,16665
22711,39041,50-54,7992,8417,16409
22712,39041,55-59,6968,7089,14057
22713,39041,60-64,6402,6288,12690
22714,39041,65+,17286,14913,32199
22715,39043,15-19,2086,2254,4340
22716,39043,20-24,2016,2105,4121
22717,39043,25-29,2103,2259,4362
22718,39043,30-34,2138,2149,4287
22719,39043,35-39,2113,2047,4160
22720,39043,40-44,2097,1947,4044
22721,39043,45-49,1998,2003,4001
22722,39043,50-54,2528,2329,4857
22723,39043,55-59,2706,2621,5327
22724,39043,60-64,3073,2852,5925
22725,39043,65+,9227,7948,17175
22726,39045,15-19,5154,5631,10785
22727,39045,20-24,4304,5010,9314
22728,39045,25-29,4354,4803,9157
22729,39045,30-34,5073,4973,10046
22730,39045,35-39,5464,5245,10709
22731,39045,40-44,5360,5335,10695
22732,39045,45-49,5133,5309,10442
22733,39045,50-54,5416,5680,11096
22734,39045,55-59,5479,5509,10988
22735,39045,60-64,5196,5075,10271
22736,39045,65+,14210,11738,25948
22737,39047,15-19,879,981,1860
22738,39047,20-24,811,812,1623
22739,39047,25-29,820,872,1692
22740,39047,30-34,865,875,1740
22741,39047,35-39,872,822,1694
22742,39047,40-44,888,873,1761
22743,39047,45-49,927,872,1799
22744,39047,50-54,974,968,1942
22745,39047,55-59,938,993,1931
22746,39047,60-64,1027,985,2012
22747,39047,65+,2905,2367,5272
22748,39049,15-19,42291,43278,85569
22749,39049,20-24,45484,43574,89058
22750,39049,25-29,57684,56659,114343
22751,39049,30-34,59562,59392,118954
22752,39049,35-39,49733,50084,99817
22753,39049,40-44,43332,43231,86563
22754,39049,45-49,38085,37376,75461
22755,39049,50-54,38603,38639,77242
22756,39049,55-59,38028,36572,74600
22757,39049,60-64,38314,34773,73087
22758,39049,65+,94706,72926,167632
22759,39051,15-19,1304,1470,2774
22760,39051,20-24,1138,1222,2360
22761,39051,25-29,1186,1182,2368
22762,39051,30-34,1197,1238,2435
22763,39051,35-39,1222,1233,2455
22764,39051,40-44,1265,1343,2608
22765,39051,45-49,1251,1243,2494
22766,39051,50-54,1364,1361,2725
22767,39051,55-59,1466,1475,2941
22768,39051,60-64,1569,1562,3131
22769,39051,65+,4388,3676,8064
22770,39053,15-19,903,974,1877
22771,39053,20-24,787,909,1696
22772,39053,25-29,806,831,1637
22773,39053,30-34,818,857,1675
22774,39053,35-39,844,848,1692
22775,39053,40-44,835,838,1673
22776,39053,45-49,867,847,1714
22777,39053,50-54,858,912,1770
22778,39053,55-59,997,971,1968
22779,39053,60-64,1130,1031,2161
22780,39053,65+,3113,2582,5695
22781,39055,15-19,3177,3400,6577
22782,39055,20-24,2545,2812,5357
22783,39055,25-29,2110,2385,4495
22784,39055,30-34,2120,2195,4315
22785,39055,35-39,2377,2467,4844
22786,39055,40-44,2639,2665,5304
22787,39055,45-49,2732,2802,5534
22788,39055,50-54,3353,3433,6786
22789,39055,55-59,3595,3633,7228
22790,39055,60-64,3752,3733,7485
22791,39055,65+,10880,9642,20522
22792,39057,15-19,6253,6071,12324
22793,39057,20-24,6538,6774,13312
22794,39057,25-29,5364,5824,11188
22795,39057,30-34,5361,5576,10937
22796,39057,35-39,5264,5504,10768
22797,39057,40-44,4823,4962,9785
22798,39057,45-49,4420,4355,8775
22799,39057,50-54,5093,4885,9978
22800,39057,55-59,5532,5491,11023
22801,39057,60-64,5791,5560,11351
22802,39057,65+,16349,13890,30239
22803,39059,15-19,1102,1189,2291
22804,39059,20-24,982,1062,2044
22805,39059,25-29,1150,1230,2380
22806,39059,30-34,1129,1196,2325
22807,39059,35-39,1074,1103,2177
22808,39059,40-44,1034,1112,2146
22809,39059,45-49,1090,1070,2160
22810,39059,50-54,1263,1304,2567
22811,39059,55-59,1338,1367,2705
22812,39059,60-64,1440,1380,2820
22813,39059,65+,4115,3641,7756
22814,39061,15-19,27120,28235,55355
22815,39061,20-24,26527,26486,53013
22816,39061,25-29,30933,30411,61344
22817,39061,30-34,31830,30732,62562
22818,39061,35-39,28494,27058,55552
22819,39061,40-44,25099,23976,49075
22820,39061,45-49,22280,21343,43623
22821,39061,50-54,24774,23611,48385
22822,39061,55-59,27041,25364,52405
22823,39061,60-64,27953,25626,53579
22824,39061,65+,74973,58007,132980
22825,39063,15-19,2386,2401,4787
22826,39063,20-24,2292,2363,4655
22827,39063,25-29,2338,2550,4888
22828,39063,30-34,2451,2584,5035
22829,39063,35-39,2241,2473,4714
22830,39063,40-44,2152,2222,4374
22831,39063,45-49,2170,2172,4342
22832,39063,50-54,2254,2404,4658
22833,39063,55-59,2482,2567,5049
22834,39063,60-64,2574,2556,5130
22835,39063,65+,7449,6059,13508
22836,39065,15-19,1227,1336,2563
22837,39065,20-24,1667,1606,3273
22838,39065,25-29,832,907,1739
22839,39065,30-34,718,774,1492
22840,39065,35-39,829,812,1641
22841,39065,40-44,843,842,1685
22842,39065,45-49,831,885,1716
22843,39065,50-54,895,905,1800
22844,39065,55-59,938,959,1897
22845,39065,60-64,923,993,1916
22846,39065,65+,2696,2263,4959
22847,39067,15-19,435,440,875
22848,39067,20-24,330,374,704
22849,39067,25-29,370,356,726
22850,39067,30-34,386,421,807
22851,39067,35-39,399,356,755
22852,39067,40-44,443,399,842
22853,39067,45-49,424,414,838
22854,39067,50-54,440,490,930
22855,39067,55-59,565,538,1103
22856,39067,60-64,598,630,1228
22857,39067,65+,1683,1521,3204
22858,39069,15-19,854,909,1763
22859,39069,20-24,707,781,1488
22860,39069,25-29,735,789,1524
22861,39069,30-34,789,819,1608
22862,39069,35-39,863,778,1641
22863,39069,40-44,838,863,1701
22864,39069,45-49,792,819,1611
22865,39069,50-54,843,898,1741
22866,39069,55-59,941,934,1875
22867,39069,60-64,985,1051,2036
22868,39069,65+,2860,2480,5340
22869,39071,15-19,1346,1459,2805
22870,39071,20-24,1115,1195,2310
22871,39071,25-29,1249,1235,2484
22872,39071,30-34,1284,1222,2506
22873,39071,35-39,1198,1232,2430
22874,39071,40-44,1311,1339,2650
22875,39071,45-49,1275,1286,2561
22876,39071,50-54,1458,1504,2962
22877,39071,55-59,1480,1442,2922
22878,39071,60-64,1550,1519,3069
22879,39071,65+,4409,3771,8180
22880,39073,15-19,811,842,1653
22881,39073,20-24,707,745,1452
22882,39073,25-29,805,774,1579
22883,39073,30-34,808,825,1633
22884,39073,35-39,762,789,1551
22885,39073,40-44,858,841,1699
22886,39073,45-49,867,863,1730
22887,39073,50-54,951,1015,1966
22888,39073,55-59,1044,1026,2070
22889,39073,60-64,1087,1088,2175
22890,39073,65+,2894,2657,5551
22891,39075,15-19,1796,1833,3629
22892,39075,20-24,1528,1627,3155
22893,39075,25-29,1420,1519,2939
22894,39075,30-34,1347,1426,2773
22895,39075,35-39,1245,1199,2444
22896,39075,40-44,1178,1237,2415
22897,39075,45-49,1168,1163,2331
22898,39075,50-54,1136,1218,2354
22899,39075,55-59,1200,1206,2406
22900,39075,60-64,1180,1278,2458
22901,39075,65+,3360,2894,6254
22902,39077,15-19,1876,2020,3896
22903,39077,20-24,1621,1682,3303
22904,39077,25-29,1696,1879,3575
22905,39077,30-34,1660,1765,3425
22906,39077,35-39,1690,1733,3423
22907,39077,40-44,1759,1727,3486
22908,39077,45-49,1662,1774,3436
22909,39077,50-54,1861,1924,3785
22910,39077,55-59,2083,2039,4122
22911,39077,60-64,2100,1961,4061
22912,39077,65+,5773,4763,10536
22913,39079,15-19,1002,1090,2092
22914,39079,20-24,857,923,1780
22915,39079,25-29,966,974,1940
22916,39079,30-34,1004,1037,2041
22917,39079,35-39,984,1009,1993
22918,39079,40-44,1038,985,2023
22919,39079,45-49,993,1007,2000
22920,39079,50-54,1061,1079,2140
22921,39079,55-59,1082,1077,2159
22922,39079,60-64,1141,1036,2177
22923,39079,65+,3225,2584,5809
22924,39081,15-19,2090,1977,4067
22925,39081,20-24,2092,2053,4145
22926,39081,25-29,1827,1810,3637
22927,39081,30-34,1906,1893,3799
22928,39081,35-39,1613,1686,3299
22929,39081,40-44,1735,1765,3500
22930,39081,45-49,1904,1812,3716
22931,39081,50-54,2020,2134,4154
22932,39081,55-59,2354,2197,4551
22933,39081,60-64,2606,2513,5119
22934,39081,65+,7878,6524,14402
22935,39083,15-19,2390,2417,4807
22936,39083,20-24,2453,2423,4876
22937,39083,25-29,1649,1679,3328
22938,39083,30-34,1776,1723,3499
22939,39083,35-39,1787,1728,3515
22940,39083,40-44,1732,1788,3520
22941,39083,45-49,1622,1687,3309
22942,39083,50-54,1862,1896,3758
22943,39083,55-59,2054,2049,4103
22944,39083,60-64,2325,2169,4494
22945,39083,65+,6363,5481,11844
22946,39085,15-19,6672,7033,13705
22947,39085,20-24,6223,6447,12670
22948,39085,25-29,7016,7183,14199
22949,39085,30-34,7107,7230,14337
22950,39085,35-39,6804,7065,13869
22951,39085,40-44,6613,6787,13400
22952,39085,45-49,6728,6777,13505
22953,39085,50-54,7928,7822,15750
22954,39085,55-59,8651,8312,16963
22955,39085,60-64,9456,8941,18397
22956,39085,65+,27244,21644,48888
22957,39087,15-19,1646,1817,3463
22958,39087,20-24,1466,1566,3032
22959,39087,25-29,1717,1735,3452
22960,39087,30-34,1763,1715,3478
22961,39087,35-39,1764,1653,3417
22962,39087,40-44,1862,1755,3617
22963,39087,45-49,1786,1788,3574
22964,39087,50-54,2041,2035,4076
22965,39087,55-59,2068,1926,3994
22966,39087,60-64,2107,2033,4140
22967,39087,65+,6121,4971,11092
22968,39089,15-19,5834,6093,11927
22969,39089,20-24,5329,5476,10805
22970,39089,25-29,5080,5215,10295
22971,39089,30-34,5707,5467,11174
22972,39089,35-39,6017,5703,11720
22973,39089,40-44,5590,5658,11248
22974,39089,45-49,5318,5330,10648
22975,39089,50-54,6109,6092,12201
22976,39089,55-59,6375,6326,12701
22977,39089,60-64,6264,6259,12523
22978,39089,65+,16916,13972,30888
22979,39091,15-19,1440,1478,2918
22980,39091,20-24,1184,1313,2497
22981,39091,25-29,1292,1377,2669
22982,39091,30-34,1286,1293,2579
22983,39091,35-39,1350,1239,2589
22984,39091,40-44,1407,1374,2781
22985,39091,45-49,1382,1392,2774
22986,39091,50-54,1484,1578,3062
22987,39091,55-59,1688,1685,3373
22988,39091,60-64,1685,1747,3432
22989,39091,65+,4714,4058,8772
22990,39093,15-19,9695,10315,20010
22991,39093,20-24,8767,9597,18364
22992,39093,25-29,8780,9180,17960
22993,39093,30-34,9213,9424,18637
22994,39093,35-39,9503,9492,18995
22995,39093,40-44,9694,9784,19478
22996,39093,45-49,9539,9727,19266
22997,39093,50-54,10407,10727,21134
22998,39093,55-59,11116,10884,22000
22999,39093,60-64,11636,10978,22614
23000,39093,65+,33379,27368,60747
23001,39095,15-19,13538,14113,27651
23002,39095,20-24,13100,13076,26176
23003,39095,25-29,15173,14662,29835
23004,39095,30-34,15646,15228,30874
23005,39095,35-39,13576,12923,26499
23006,39095,40-44,12727,12048,24775
23007,39095,45-49,12669,11786,24455
23008,39095,50-54,13489,12877,26366
23009,39095,55-59,14359,13587,27946
23010,39095,60-64,15153,14096,29249
23011,39095,65+,40993,32319,73312
23012,39097,15-19,1168,1443,2611
23013,39097,20-24,997,1416,2413
23014,39097,25-29,1184,1735,2919
23015,39097,30-34,1255,1946,3201
23016,39097,35-39,1267,1947,3214
23017,39097,40-44,1232,1915,3147
23018,39097,45-49,1275,1794,3069
23019,39097,50-54,1390,1806,3196
23020,39097,55-59,1516,1685,3201
23021,39097,60-64,1422,1550,2972
23022,39097,65+,3843,3306,7149
23023,39099,15-19,6341,6979,13320
23024,39099,20-24,6551,7028,13579
23025,39099,25-29,6749,7376,14125
23026,39099,30-34,6476,7308,13784
23027,39099,35-39,6259,6545,12804
23028,39099,40-44,6464,6674,13138
23029,39099,45-49,6218,6373,12591
23030,39099,50-54,6955,7086,14041
23031,39099,55-59,7739,7559,15298
23032,39099,60-64,9035,8181,17216
23033,39099,65+,27653,21876,49529
23034,39101,15-19,1680,1925,3605
23035,39101,20-24,1647,2264,3911
23036,39101,25-29,1884,2428,4312
23037,39101,30-34,1929,2495,4424
23038,39101,35-39,1696,2416,4112
23039,39101,40-44,1750,2362,4112
23040,39101,45-49,1703,2348,4051
23041,39101,50-54,1880,2442,4322
23042,39101,55-59,1972,2338,4310
23043,39101,60-64,2175,2280,4455
23044,39101,65+,6507,5544,12051
23045,39103,15-19,5634,6109,11743
23046,39103,20-24,4743,5059,9802
23047,39103,25-29,4652,4783,9435
23048,39103,30-34,5095,5113,10208
23049,39103,35-39,5683,5781,11464
23050,39103,40-44,5874,5927,11801
23051,39103,45-49,5725,5847,11572
23052,39103,50-54,6576,6644,13220
23053,39103,55-59,6909,6845,13754
23054,39103,60-64,6663,6655,13318
23055,39103,65+,18795,16095,34890
23056,39105,15-19,693,694,1387
23057,39105,20-24,537,541,1078
23058,39105,25-29,536,552,1088
23059,39105,30-34,590,592,1182
23060,39105,35-39,696,603,1299
23061,39105,40-44,664,773,1437
23062,39105,45-49,711,671,1382
23063,39105,50-54,743,794,1537
23064,39105,55-59,787,855,1642
23065,39105,60-64,880,809,1689
23066,39105,65+,2445,2176,4621
23067,39107,15-19,1311,1446,2757
23068,39107,20-24,1123,1241,2364
23069,39107,25-29,1166,1177,2343
23070,39107,30-34,1158,1321,2479
23071,39107,35-39,1176,1286,2462
23072,39107,40-44,1094,1186,2280
23073,39107,45-49,1034,1111,2145
23074,39107,50-54,1202,1187,2389
23075,39107,55-59,1370,1401,2771
23076,39107,60-64,1489,1538,3027
23077,39107,65+,4252,3782,8034
23078,39109,15-19,3219,3537,6756
23079,39109,20-24,2715,2848,5563
23080,39109,25-29,2987,3055,6042
23081,39109,30-34,3340,3382,6722
23082,39109,35-39,3501,3635,7136
23083,39109,40-44,3379,3400,6779
23084,39109,45-49,3193,3248,6441
23085,39109,50-54,3583,3683,7266
23086,39109,55-59,3639,3722,7361
23087,39109,60-64,3884,3704,7588
23088,39109,65+,11495,9431,20926
23089,39111,15-19,346,373,719
23090,39111,20-24,328,348,676
23091,39111,25-29,312,379,691
23092,39111,30-34,344,322,666
23093,39111,35-39,351,371,722
23094,39111,40-44,364,387,751
23095,39111,45-49,388,386,774
23096,39111,50-54,408,481,889
23097,39111,55-59,468,494,962
23098,39111,60-64,526,536,1062
23099,39111,65+,1636,1525,3161
23100,39113,15-19,16544,17378,33922
23101,39113,20-24,17884,17843,35727
23102,39113,25-29,18582,18267,36849
23103,39113,30-34,18819,18170,36989
23104,39113,35-39,16914,16317,33231
23105,39113,40-44,15889,15034,30923
23106,39113,45-49,14824,13985,28809
23107,39113,50-54,16575,15708,32283
23108,39113,55-59,17967,16961,34928
23109,39113,60-64,18742,17117,35859
23110,39113,65+,55738,42404,98142
23111,39115,15-19,398,444,842
23112,39115,20-24,305,397,702
23113,39115,25-29,340,379,719
23114,39115,30-34,355,351,706
23115,39115,35-39,366,402,768
23116,39115,40-44,443,389,832
23117,39115,45-49,397,394,791
23118,39115,50-54,444,454,898
23119,39115,55-59,517,513,1030
23120,39115,60-64,537,569,1106
23121,39115,65+,1601,1451,3052
23122,39117,15-19,1128,1178,2306
23123,39117,20-24,800,949,1749
23124,39117,25-29,925,1006,1931
23125,39117,30-34,1035,1008,2043
23126,39117,35-39,1027,1020,2047
23127,39117,40-44,1071,1149,2220
23128,39117,45-49,1128,1164,2292
23129,39117,50-54,1233,1297,2530
23130,39117,55-59,1261,1365,2626
23131,39117,60-64,1375,1322,2697
23132,39117,65+,3435,3059,6494
23133,39119,15-19,2566,2665,5231
23134,39119,20-24,2686,2757,5443
23135,39119,25-29,2766,2810,5576
23136,39119,30-34,2670,2594,5264
23137,39119,35-39,2593,2486,5079
23138,39119,40-44,2600,2529,5129
23139,39119,45-49,2559,2472,5031
23140,39119,50-54,2803,2802,5605
23141,39119,55-59,2935,2861,5796
23142,39119,60-64,3144,2920,6064
23143,39119,65+,8876,7039,15915
23144,39121,15-19,329,327,656
23145,39121,20-24,284,291,575
23146,39121,25-29,332,329,661
23147,39121,30-34,317,328,645
23148,39121,35-39,289,335,624
23149,39121,40-44,297,303,600
23150,39121,45-49,258,359,617
23151,39121,50-54,298,539,837
23152,39121,55-59,341,662,1003
23153,39121,60-64,373,1272,1645
23154,39121,65+,1557,2512,4069
23155,39123,15-19,1091,1124,2215
23156,39123,20-24,877,974,1851
23157,39123,25-29,857,972,1829
23158,39123,30-34,988,1000,1988
23159,39123,35-39,1016,1046,2062
23160,39123,40-44,1026,1075,2101
23161,39123,45-49,1089,1103,2192
23162,39123,50-54,1276,1349,2625
23163,39123,55-59,1608,1584,3192
23164,39123,60-64,1827,1861,3688
23165,39123,65+,5481,5097,10578
23166,39125,15-19,619,641,1260
23167,39125,20-24,487,527,1014
23168,39125,25-29,537,543,1080
23169,39125,30-34,498,504,1002
23170,39125,35-39,565,563,1128
23171,39125,40-44,515,571,1086
23172,39125,45-49,539,551,1090
23173,39125,50-54,618,601,1219
23174,39125,55-59,647,680,1327
23175,39125,60-64,657,691,1348
23176,39125,65+,1907,1721,3628
23177,39127,15-19,1062,1111,2173
23178,39127,20-24,909,987,1896
23179,39127,25-29,1034,1017,2051
23180,39127,30-34,1081,1043,2124
23181,39127,35-39,1040,1108,2148
23182,39127,40-44,1085,1084,2169
23183,39127,45-49,1020,1134,2154
23184,39127,50-54,1201,1222,2423
23185,39127,55-59,1292,1302,2594
23186,39127,60-64,1249,1323,2572
23187,39127,65+,3283,2974,6257
23188,39129,15-19,1752,1999,3751
23189,39129,20-24,1434,2259,3693
23190,39129,25-29,1629,2295,3924
23191,39129,30-34,1792,2344,4136
23192,39129,35-39,1741,2295,4036
23193,39129,40-44,1849,2174,4023
23194,39129,45-49,1749,2187,3936
23195,39129,50-54,1922,2259,4181
23196,39129,55-59,1865,2140,4005
23197,39129,60-64,1858,1908,3766
23198,39129,65+,5266,4275,9541
23199,39131,15-19,802,951,1753
23200,39131,20-24,720,794,1514
23201,39131,25-29,763,818,1581
23202,39131,30-34,791,782,1573
23203,39131,35-39,771,712,1483
23204,39131,40-44,770,819,1589
23205,39131,45-49,887,865,1752
23206,39131,50-54,825,892,1717
23207,39131,55-59,970,958,1928
23208,39131,60-64,987,959,1946
23209,39131,65+,2687,2284,4971
23210,39133,15-19,6751,5948,12699
23211,39133,20-24,9520,8452,17972
23212,39133,25-29,4938,5126,10064
23213,39133,30-34,4324,4512,8836
23214,39133,35-39,4386,4587,8973
23215,39133,40-44,4419,4512,8931
23216,39133,45-49,4385,4392,8777
23217,39133,50-54,5214,5170,10384
23218,39133,55-59,5701,5607,11308
23219,39133,60-64,5916,5791,11707
23220,39133,65+,15208,13472,28680
23221,39135,15-19,1287,1346,2633
23222,39135,20-24,1008,1138,2146
23223,39135,25-29,1082,1119,2201
23224,39135,30-34,1151,1131,2282
23225,39135,35-39,1181,1194,2375
23226,39135,40-44,1256,1211,2467
23227,39135,45-49,1215,1251,2466
23228,39135,50-54,1338,1415,2753
23229,39135,55-59,1485,1482,2967
23230,39135,60-64,1555,1528,3083
23231,39135,65+,4323,3797,8120
23232,39137,15-19,1074,1171,2245
23233,39137,20-24,877,936,1813
23234,39137,25-29,854,920,1774
23235,39137,30-34,960,972,1932
23236,39137,35-39,997,1021,2018
23237,39137,40-44,997,1044,2041
23238,39137,45-49,906,950,1856
23239,39137,50-54,983,1066,2049
23240,39137,55-59,1196,1201,2397
23241,39137,60-64,1247,1311,2558
23242,39137,65+,3320,2990,6310
23243,39139,15-19,3535,3946,7481
23244,39139,20-24,3246,4205,7451
23245,39139,25-29,3592,4732,8324
23246,39139,30-34,3585,4378,7963
23247,39139,35-39,3338,4059,7397
23248,39139,40-44,3543,4049,7592
23249,39139,45-49,3410,3818,7228
23250,39139,50-54,3630,3957,7587
23251,39139,55-59,4030,3956,7986
23252,39139,60-64,4360,4173,8533
23253,39139,65+,13923,11142,25065
23254,39141,15-19,2116,2381,4497
23255,39141,20-24,1942,2414,4356
23256,39141,25-29,2167,2757,4924
23257,39141,30-34,2083,2806,4889
23258,39141,35-39,2071,2816,4887
23259,39141,40-44,2296,2874,5170
23260,39141,45-49,2224,2858,5082
23261,39141,50-54,2415,2985,5400
23262,39141,55-59,2585,2872,5457
23263,39141,60-64,2752,2693,5445
23264,39141,65+,7347,6190,13537
23265,39143,15-19,1733,1910,3643
23266,39143,20-24,1550,1660,3210
23267,39143,25-29,1696,1667,3363
23268,39143,30-34,1698,1742,3440
23269,39143,35-39,1754,1797,3551
23270,39143,40-44,1742,1850,3592
23271,39143,45-49,1671,1733,3404
23272,39143,50-54,1834,1940,3774
23273,39143,55-59,2063,2095,4158
23274,39143,60-64,2192,2238,4430
23275,39143,65+,6315,5297,11612
23276,39145,15-19,2250,2461,4711
23277,39145,20-24,2052,2443,4495
23278,39145,25-29,2101,2448,4549
23279,39145,30-34,2220,2539,4759
23280,39145,35-39,2133,2236,4369
23281,39145,40-44,2256,2260,4516
23282,39145,45-49,2324,2246,4570
23283,39145,50-54,2338,2310,4648
23284,39145,55-59,2491,2350,4841
23285,39145,60-64,2663,2380,5043
23286,39145,65+,7663,6107,13770
23287,39147,15-19,1998,2227,4225
23288,39147,20-24,1782,2072,3854
23289,39147,25-29,1563,1642,3205
23290,39147,30-34,1560,1649,3209
23291,39147,35-39,1550,1589,3139
23292,39147,40-44,1614,1795,3409
23293,39147,45-49,1536,1554,3090
23294,39147,50-54,1554,1624,3178
23295,39147,55-59,1825,1869,3694
23296,39147,60-64,2016,1923,3939
23297,39147,65+,5597,4791,10388
23298,39149,15-19,1575,1717,3292
23299,39149,20-24,1329,1485,2814
23300,39149,25-29,1400,1426,2826
23301,39149,30-34,1339,1375,2714
23302,39149,35-39,1348,1418,2766
23303,39149,40-44,1359,1389,2748
23304,39149,45-49,1419,1411,2830
23305,39149,50-54,1502,1621,3123
23306,39149,55-59,1687,1796,3483
23307,39149,60-64,1622,1745,3367
23308,39149,65+,4468,3873,8341
23309,39151,15-19,11358,12015,23373
23310,39151,20-24,11113,11206,22319
23311,39151,25-29,11178,11231,22409
23312,39151,30-34,11614,11330,22944
23313,39151,35-39,11014,11086,22100
23314,39151,40-44,11088,10822,21910
23315,39151,45-49,10668,10252,20920
23316,39151,50-54,12059,12140,24199
23317,39151,55-59,13015,12593,25608
23318,39151,60-64,14044,13066,27110
23319,39151,65+,41746,33470,75216
23320,39153,15-19,15523,16284,31807
23321,39153,20-24,15661,15964,31625
23322,39153,25-29,18028,17991,36019
23323,39153,30-34,18261,17758,36019
23324,39153,35-39,16967,16630,33597
23325,39153,40-44,16251,15903,32154
23326,39153,45-49,15523,15244,30767
23327,39153,50-54,18050,17540,35590
23328,39153,55-59,19286,18231,37517
23329,39153,60-64,20072,18685,38757
23330,39153,65+,56732,44947,101679
23331,39155,15-19,5624,6030,11654
23332,39155,20-24,5477,5746,11223
23333,39155,25-29,5912,6291,12203
23334,39155,30-34,5771,5996,11767
23335,39155,35-39,5526,5465,10991
23336,39155,40-44,5552,5611,11163
23337,39155,45-49,5749,5716,11465
23338,39155,50-54,6568,6483,13051
23339,39155,55-59,7254,6829,14083
23340,39155,60-64,7899,7465,15364
23341,39155,65+,24527,19992,44519
23342,39157,15-19,2702,2903,5605
23343,39157,20-24,2517,2680,5197
23344,39157,25-29,2670,2879,5549
23345,39157,30-34,2667,2655,5322
23346,39157,35-39,2670,2884,5554
23347,39157,40-44,2615,2806,5421
23348,39157,45-49,2566,2629,5195
23349,39157,50-54,2828,2874,5702
23350,39157,55-59,3077,3126,6203
23351,39157,60-64,3438,3295,6733
23352,39157,65+,10205,8306,18511
23353,39159,15-19,2024,2190,4214
23354,39159,20-24,1870,1636,3506
23355,39159,25-29,2127,1782,3909
23356,39159,30-34,2527,2096,4623
23357,39159,35-39,2686,2322,5008
23358,39159,40-44,2611,2374,4985
23359,39159,45-49,2322,2269,4591
23360,39159,50-54,2325,2272,4597
23361,39159,55-59,2100,2169,4269
23362,39159,60-64,1885,1903,3788
23363,39159,65+,4571,3903,8474
23364,39161,15-19,910,893,1803
23365,39161,20-24,762,788,1550
23366,39161,25-29,874,916,1790
23367,39161,30-34,823,832,1655
23368,39161,35-39,786,834,1620
23369,39161,40-44,871,947,1818
23370,39161,45-49,788,822,1610
23371,39161,50-54,839,899,1738
23372,39161,55-59,960,974,1934
23373,39161,60-64,1047,988,2035
23374,39161,65+,3102,2602,5704
23375,39163,15-19,375,401,776
23376,39163,20-24,349,366,715
23377,39163,25-29,349,401,750
23378,39163,30-34,331,396,727
23379,39163,35-39,323,296,619
23380,39163,40-44,401,384,785
23381,39163,45-49,418,452,870
23382,39163,50-54,468,433,901
23383,39163,55-59,465,476,941
23384,39163,60-64,512,532,1044
23385,39163,65+,1254,1112,2366
23386,39165,15-19,8196,8891,17087
23387,39165,20-24,6404,7714,14118
23388,39165,25-29,6056,7073,13129
23389,39165,30-34,7103,7797,14900
23390,39165,35-39,8343,8808,17151
23391,39165,40-44,8473,8681,17154
23392,39165,45-49,8101,8600,16701
23393,39165,50-54,8862,9096,17958
23394,39165,55-59,8525,8654,17179
23395,39165,60-64,8013,7939,15952
23396,39165,65+,20284,17208,37492
23397,39167,15-19,1838,1855,3693
23398,39167,20-24,1728,1787,3515
23399,39167,25-29,1623,1767,3390
23400,39167,30-34,1685,1655,3340
23401,39167,35-39,1659,1770,3429
23402,39167,40-44,1702,1705,3407
23403,39167,45-49,1796,1668,3464
23404,39167,50-54,1893,1925,3818
23405,39167,55-59,2091,2049,4140
23406,39167,60-64,2363,2283,4646
23407,39167,65+,6946,6052,12998
23408,39169,15-19,4061,4297,8358
23409,39169,20-24,3655,3947,7602
23410,39169,25-29,3333,3523,6856
23411,39169,30-34,3391,3579,6970
23412,39169,35-39,3303,3381,6684
23413,39169,40-44,3204,3274,6478
23414,39169,45-49,3190,3217,6407
23415,39169,50-54,3416,3339,6755
23416,39169,55-59,3761,3841,7602
23417,39169,60-64,3990,3934,7924
23418,39169,65+,11732,10091,21823
23419,39171,15-19,1121,1215,2336
23420,39171,20-24,959,1112,2071
23421,39171,25-29,1010,1087,2097
23422,39171,30-34,1053,1091,2144
23423,39171,35-39,1057,1186,2243
23424,39171,40-44,1096,1158,2254
23425,39171,45-49,1004,1101,2105
23426,39171,50-54,1106,1114,2220
23427,39171,55-59,1260,1257,2517
23428,39171,60-64,1391,1396,2787
23429,39171,65+,3986,3346,7332
23430,39173,15-19,5708,5499,11207
23431,39173,20-24,7998,7793,15791
23432,39173,25-29,4138,4553,8691
23433,39173,30-34,3787,3973,7760
23434,39173,35-39,3746,4012,7758
23435,39173,40-44,3654,3900,7554
23436,39173,45-49,3546,3716,7262
23437,39173,50-54,3700,3754,7454
23438,39173,55-59,3932,3801,7733
23439,39173,60-64,4063,3985,8048
23440,39173,65+,11631,9658,21289
23441,39175,15-19,657,718,1375
23442,39175,20-24,528,597,1125
23443,39175,25-29,571,644,1215
23444,39175,30-34,587,580,1167
23445,39175,35-39,647,649,1296
23446,39175,40-44,657,685,1342
23447,39175,45-49,651,673,1324
23448,39175,50-54,676,693,1369
23449,39175,55-59,764,793,1557
23450,39175,60-64,803,786,1589
23451,39175,65+,2436,1993,4429
23452,40001,15-19,681,724,1405
23453,40001,20-24,539,574,1113
23454,40001,25-29,566,547,1113
23455,40001,30-34,580,547,1127
23456,40001,35-39,590,577,1167
23457,40001,40-44,552,600,1152
23458,40001,45-49,603,600,1203
23459,40001,50-54,586,603,1189
23460,40001,55-59,643,661,1304
23461,40001,60-64,623,582,1205
23462,40001,65+,1596,1456,3052
23463,40003,15-19,126,150,276
23464,40003,20-24,103,110,213
23465,40003,25-29,105,163,268
23466,40003,30-34,141,194,335
23467,40003,35-39,120,355,475
23468,40003,40-44,115,361,476
23469,40003,45-49,111,314,425
23470,40003,50-54,118,297,415
23471,40003,55-59,141,216,357
23472,40003,60-64,161,220,381
23473,40003,65+,572,576,1148
23474,40005,15-19,405,447,852
23475,40005,20-24,347,420,767
23476,40005,25-29,386,557,943
23477,40005,30-34,396,507,903
23478,40005,35-39,422,531,953
23479,40005,40-44,370,523,893
23480,40005,45-49,359,455,814
23481,40005,50-54,386,415,801
23482,40005,55-59,447,444,891
23483,40005,60-64,474,480,954
23484,40005,65+,1551,1305,2856
23485,40007,15-19,204,220,424
23486,40007,20-24,110,137,247
23487,40007,25-29,137,135,272
23488,40007,30-34,122,150,272
23489,40007,35-39,132,145,277
23490,40007,40-44,154,152,306
23491,40007,45-49,127,132,259
23492,40007,50-54,142,153,295
23493,40007,55-59,172,162,334
23494,40007,60-64,166,181,347
23495,40007,65+,488,495,983
23496,40009,15-19,645,754,1399
23497,40009,20-24,492,842,1334
23498,40009,25-29,599,954,1553
23499,40009,30-34,687,966,1653
23500,40009,35-39,665,968,1633
23501,40009,40-44,606,846,1452
23502,40009,45-49,559,720,1279
23503,40009,50-54,538,669,1207
23504,40009,55-59,590,637,1227
23505,40009,60-64,658,648,1306
23506,40009,65+,1846,1523,3369
23507,40011,15-19,297,281,578
23508,40011,20-24,230,226,456
23509,40011,25-29,206,230,436
23510,40011,30-34,227,230,457
23511,40011,35-39,248,231,479
23512,40011,40-44,223,237,460
23513,40011,45-49,227,236,463
23514,40011,50-54,227,270,497
23515,40011,55-59,258,307,565
23516,40011,60-64,316,312,628
23517,40011,65+,935,783,1718
23518,40013,15-19,1534,1529,3063
23519,40013,20-24,1608,1599,3207
23520,40013,25-29,1610,1597,3207
23521,40013,30-34,1711,1771,3482
23522,40013,35-39,1510,1500,3010
23523,40013,40-44,1419,1359,2778
23524,40013,45-49,1297,1307,2604
23525,40013,50-54,1417,1352,2769
23526,40013,55-59,1412,1345,2757
23527,40013,60-64,1447,1278,2725
23528,40013,65+,4557,3673,8230
23529,40015,15-19,834,898,1732
23530,40015,20-24,632,919,1551
23531,40015,25-29,654,1091,1745
23532,40015,30-34,687,1040,1727
23533,40015,35-39,749,973,1722
23534,40015,40-44,709,970,1679
23535,40015,45-49,629,856,1485
23536,40015,50-54,694,844,1538
23537,40015,55-59,838,818,1656
23538,40015,60-64,858,840,1698
23539,40015,65+,2503,1998,4501
23540,40017,15-19,5367,5475,10842
23541,40017,20-24,4360,4444,8804
23542,40017,25-29,5537,5473,11010
23543,40017,30-34,6332,6324,12656
23544,40017,35-39,6437,6782,13219
23545,40017,40-44,5660,5939,11599
23546,40017,45-49,4811,5126,9937
23547,40017,50-54,4703,4695,9398
23548,40017,55-59,4670,4483,9153
23549,40017,60-64,4544,4339,8883
23550,40017,65+,11961,9850,21811
23551,40019,15-19,1544,1645,3189
23552,40019,20-24,1457,1415,2872
23553,40019,25-29,1556,1576,3132
23554,40019,30-34,1520,1560,3080
23555,40019,35-39,1496,1545,3041
23556,40019,40-44,1464,1464,2928
23557,40019,45-49,1398,1407,2805
23558,40019,50-54,1363,1398,2761
23559,40019,55-59,1554,1475,3029
23560,40019,60-64,1598,1469,3067
23561,40019,65+,4717,3564,8281
23562,40021,15-19,1798,1757,3555
23563,40021,20-24,2557,2582,5139
23564,40021,25-29,1565,1520,3085
23565,40021,30-34,1385,1314,2699
23566,40021,35-39,1409,1485,2894
23567,40021,40-44,1391,1350,2741
23568,40021,45-49,1246,1200,2446
23569,40021,50-54,1295,1235,2530
23570,40021,55-59,1490,1332,2822
23571,40021,60-64,1580,1351,2931
23572,40021,65+,4393,3814,8207
23573,40023,15-19,454,452,906
23574,40023,20-24,397,373,770
23575,40023,25-29,401,371,772
23576,40023,30-34,426,400,826
23577,40023,35-39,386,377,763
23578,40023,40-44,425,351,776
23579,40023,45-49,391,389,780
23580,40023,50-54,444,396,840
23581,40023,55-59,526,421,947
23582,40023,60-64,533,496,1029
23583,40023,65+,1580,1397,2977
23584,40025,15-19,75,70,145
23585,40025,20-24,51,56,107
23586,40025,25-29,51,40,91
23587,40025,30-34,46,48,94
23588,40025,35-39,77,55,132
23589,40025,40-44,44,63,107
23590,40025,45-49,50,60,110
23591,40025,50-54,48,63,111
23592,40025,55-59,77,84,161
23593,40025,60-64,65,69,134
23594,40025,65+,295,274,569
23595,40027,15-19,11005,11486,22491
23596,40027,20-24,15552,16347,31899
23597,40027,25-29,10037,11438,21475
23598,40027,30-34,10056,10453,20509
23599,40027,35-39,10382,10644,21026
23600,40027,40-44,9655,9937,19592
23601,40027,45-49,8306,8672,16978
23602,40027,50-54,8212,8282,16494
23603,40027,55-59,8313,8224,16537
23604,40027,60-64,8794,8084,16878
23605,40027,65+,23722,19459,43181
23606,40029,15-19,166,194,360
23607,40029,20-24,142,161,303
23608,40029,25-29,142,176,318
23609,40029,30-34,155,135,290
23610,40029,35-39,141,134,275
23611,40029,40-44,139,163,302
23612,40029,45-49,168,147,315
23613,40029,50-54,146,142,288
23614,40029,55-59,158,174,332
23615,40029,60-64,183,178,361
23616,40029,65+,624,487,1111
23617,40031,15-19,3911,4890,8801
23618,40031,20-24,4197,6314,10511
23619,40031,25-29,4442,5676,10118
23620,40031,30-34,4468,5251,9719
23621,40031,35-39,4122,4555,8677
23622,40031,40-44,3584,3861,7445
23623,40031,45-49,3032,3126,6158
23624,40031,50-54,3060,3079,6139
23625,40031,55-59,3358,3412,6770
23626,40031,60-64,3549,3382,6931
23627,40031,65+,8729,7353,16082
23628,40033,15-19,170,165,335
23629,40033,20-24,129,164,293
23630,40033,25-29,142,143,285
23631,40033,30-34,147,141,288
23632,40033,35-39,148,156,304
23633,40033,40-44,164,152,316
23634,40033,45-49,130,152,282
23635,40033,50-54,178,196,374
23636,40033,55-59,203,197,400
23637,40033,60-64,239,213,452
23638,40033,65+,583,528,1111
23639,40035,15-19,392,451,843
23640,40035,20-24,364,467,831
23641,40035,25-29,389,473,862
23642,40035,30-34,408,492,900
23643,40035,35-39,349,461,810
23644,40035,40-44,391,460,851
23645,40035,45-49,403,449,852
23646,40035,50-54,418,480,898
23647,40035,55-59,482,489,971
23648,40035,60-64,479,489,968
23649,40035,65+,1556,1181,2737
23650,40037,15-19,2221,2329,4550
23651,40037,20-24,1992,2139,4131
23652,40037,25-29,2154,2209,4363
23653,40037,30-34,2212,2217,4429
23654,40037,35-39,2177,2232,4409
23655,40037,40-44,2175,2244,4419
23656,40037,45-49,2131,2065,4196
23657,40037,50-54,2322,2270,4592
23658,40037,55-59,2471,2480,4951
23659,40037,60-64,2508,2443,4951
23660,40037,65+,7221,5989,13210
23661,40039,15-19,1221,1184,2405
23662,40039,20-24,1704,1762,3466
23663,40039,25-29,859,919,1778
23664,40039,30-34,801,795,1596
23665,40039,35-39,891,891,1782
23666,40039,40-44,801,843,1644
23667,40039,45-49,609,680,1289
23668,40039,50-54,673,659,1332
23669,40039,55-59,694,737,1431
23670,40039,60-64,789,777,1566
23671,40039,65+,2234,1783,4017
23672,40041,15-19,1157,1215,2372
23673,40041,20-24,1048,1015,2063
23674,40041,25-29,1060,1084,2144
23675,40041,30-34,1069,1035,2104
23676,40041,35-39,1061,978,2039
23677,40041,40-44,1086,1081,2167
23678,40041,45-49,1105,1072,2177
23679,40041,50-54,1341,1298,2639
23680,40041,55-59,1517,1456,2973
23681,40041,60-64,1694,1624,3318
23682,40041,65+,5286,5021,10307
23683,40043,15-19,150,150,300
23684,40043,20-24,101,102,203
23685,40043,25-29,116,128,244
23686,40043,30-34,127,131,258
23687,40043,35-39,129,143,272
23688,40043,40-44,124,128,252
23689,40043,45-49,109,114,223
23690,40043,50-54,124,126,250
23691,40043,55-59,138,153,291
23692,40043,60-64,169,147,316
23693,40043,65+,447,382,829
23694,40045,15-19,127,130,257
23695,40045,20-24,85,88,173
23696,40045,25-29,94,110,204
23697,40045,30-34,77,92,169
23698,40045,35-39,97,109,206
23699,40045,40-44,112,116,228
23700,40045,45-49,109,126,235
23701,40045,50-54,95,122,217
23702,40045,55-59,112,114,226
23703,40045,60-64,136,133,269
23704,40045,65+,478,395,873
23705,40047,15-19,2016,2173,4189
23706,40047,20-24,1743,2161,3904
23707,40047,25-29,1915,2181,4096
23708,40047,30-34,1962,2094,4056
23709,40047,35-39,2054,2183,4237
23710,40047,40-44,1913,1956,3869
23711,40047,45-49,1453,1604,3057
23712,40047,50-54,1614,1679,3293
23713,40047,55-59,1835,1953,3788
23714,40047,60-64,1945,1886,3831
23715,40047,65+,5663,4633,10296
23716,40049,15-19,815,880,1695
23717,40049,20-24,681,754,1435
23718,40049,25-29,763,730,1493
23719,40049,30-34,791,747,1538
23720,40049,35-39,818,873,1691
23721,40049,40-44,799,838,1637
23722,40049,45-49,734,794,1528
23723,40049,50-54,736,786,1522
23724,40049,55-59,819,737,1556
23725,40049,60-64,871,838,1709
23726,40049,65+,2501,2113,4614
23727,40051,15-19,1802,2043,3845
23728,40051,20-24,1505,1623,3128
23729,40051,25-29,1436,1549,2985
23730,40051,30-34,1715,1693,3408
23731,40051,35-39,1912,1804,3716
23732,40051,40-44,1858,1911,3769
23733,40051,45-49,1684,1713,3397
23734,40051,50-54,1672,1790,3462
23735,40051,55-59,1937,1886,3823
23736,40051,60-64,1925,1981,3906
23737,40051,65+,5110,4410,9520
23738,40053,15-19,130,128,258
23739,40053,20-24,89,102,191
23740,40053,25-29,102,83,185
23741,40053,30-34,104,127,231
23742,40053,35-39,136,134,270
23743,40053,40-44,120,125,245
23744,40053,45-49,100,112,212
23745,40053,50-54,106,114,220
23746,40053,55-59,138,149,287
23747,40053,60-64,143,156,299
23748,40053,65+,473,432,905
23749,40055,15-19,140,160,300
23750,40055,20-24,114,230,344
23751,40055,25-29,114,328,442
23752,40055,30-34,113,298,411
23753,40055,35-39,141,265,406
23754,40055,40-44,135,249,384
23755,40055,45-49,126,232,358
23756,40055,50-54,114,223,337
23757,40055,55-59,167,175,342
23758,40055,60-64,154,172,326
23759,40055,65+,548,411,959
23760,40057,15-19,82,83,165
23761,40057,20-24,51,56,107
23762,40057,25-29,62,64,126
23763,40057,30-34,54,79,133
23764,40057,35-39,76,72,148
23765,40057,40-44,56,65,121
23766,40057,45-49,67,74,141
23767,40057,50-54,82,65,147
23768,40057,55-59,82,83,165
23769,40057,60-64,79,82,161
23770,40057,65+,264,244,508
23771,40059,15-19,116,98,214
23772,40059,20-24,61,93,154
23773,40059,25-29,64,59,123
23774,40059,30-34,68,86,154
23775,40059,35-39,127,117,244
23776,40059,40-44,112,122,234
23777,40059,45-49,67,94,161
23778,40059,50-54,71,91,162
23779,40059,55-59,107,122,229
23780,40059,60-64,118,126,244
23781,40059,65+,337,288,625
23782,40061,15-19,335,405,740
23783,40061,20-24,310,321,631
23784,40061,25-29,318,327,645
23785,40061,30-34,346,297,643
23786,40061,35-39,369,360,729
23787,40061,40-44,314,383,697
23788,40061,45-49,340,320,660
23789,40061,50-54,343,352,695
23790,40061,55-59,405,341,746
23791,40061,60-64,410,375,785
23792,40061,65+,1254,1128,2382
23793,40063,15-19,355,444,799
23794,40063,20-24,328,516,844
23795,40063,25-29,351,629,980
23796,40063,30-34,344,603,947
23797,40063,35-39,315,568,883
23798,40063,40-44,331,460,791
23799,40063,45-49,336,452,788
23800,40063,50-54,347,457,804
23801,40063,55-59,425,432,857
23802,40063,60-64,397,399,796
23803,40063,65+,1361,1121,2482
23804,40065,15-19,752,773,1525
23805,40065,20-24,834,1031,1865
23806,40065,25-29,866,938,1804
23807,40065,30-34,900,953,1853
23808,40065,35-39,817,885,1702
23809,40065,40-44,705,709,1414
23810,40065,45-49,666,645,1311
23811,40065,50-54,648,621,1269
23812,40065,55-59,743,691,1434
23813,40065,60-64,709,766,1475
23814,40065,65+,2068,1728,3796
23815,40067,15-19,163,167,330
23816,40067,20-24,123,148,271
23817,40067,25-29,125,139,264
23818,40067,30-34,168,170,338
23819,40067,35-39,145,153,298
23820,40067,40-44,147,152,299
23821,40067,45-49,144,156,300
23822,40067,50-54,161,157,318
23823,40067,55-59,181,178,359
23824,40067,60-64,184,201,385
23825,40067,65+,615,522,1137
23826,40069,15-19,366,391,757
23827,40069,20-24,280,311,591
23828,40069,25-29,288,284,572
23829,40069,30-34,324,309,633
23830,40069,35-39,301,307,608
23831,40069,40-44,286,303,589
23832,40069,45-49,274,324,598
23833,40069,50-54,295,328,623
23834,40069,55-59,340,304,644
23835,40069,60-64,342,313,655
23836,40069,65+,1070,922,1992
23837,40071,15-19,1503,1586,3089
23838,40071,20-24,1218,1328,2546
23839,40071,25-29,1325,1379,2704
23840,40071,30-34,1294,1318,2612
23841,40071,35-39,1226,1359,2585
23842,40071,40-44,1250,1355,2605
23843,40071,45-49,1130,1142,2272
23844,40071,50-54,1102,1221,2323
23845,40071,55-59,1315,1325,2640
23846,40071,60-64,1405,1420,2825
23847,40071,65+,4670,3809,8479
23848,40073,15-19,517,575,1092
23849,40073,20-24,425,465,890
23850,40073,25-29,416,439,855
23851,40073,30-34,465,462,927
23852,40073,35-39,510,491,1001
23853,40073,40-44,469,501,970
23854,40073,45-49,400,439,839
23855,40073,50-54,378,438,816
23856,40073,55-59,493,485,978
23857,40073,60-64,499,504,1003
23858,40073,65+,1330,1159,2489
23859,40075,15-19,261,281,542
23860,40075,20-24,211,247,458
23861,40075,25-29,237,230,467
23862,40075,30-34,219,242,461
23863,40075,35-39,240,227,467
23864,40075,40-44,233,245,478
23865,40075,45-49,202,218,420
23866,40075,50-54,231,230,461
23867,40075,55-59,314,303,617
23868,40075,60-64,355,324,679
23869,40075,65+,876,796,1672
23870,40077,15-19,329,355,684
23871,40077,20-24,272,314,586
23872,40077,25-29,264,266,530
23873,40077,30-34,268,243,511
23874,40077,35-39,243,276,519
23875,40077,40-44,248,274,522
23876,40077,45-49,250,236,486
23877,40077,50-54,264,277,541
23878,40077,55-59,285,328,613
23879,40077,60-64,334,326,660
23880,40077,65+,1008,1029,2037
23881,40079,15-19,1609,1742,3351
23882,40079,20-24,1367,1519,2886
23883,40079,25-29,1400,1561,2961
23884,40079,30-34,1425,1519,2944
23885,40079,35-39,1450,1516,2966
23886,40079,40-44,1396,1604,3000
23887,40079,45-49,1304,1487,2791
23888,40079,50-54,1429,1491,2920
23889,40079,55-59,1582,1554,3136
23890,40079,60-64,1601,1518,3119
23891,40079,65+,4701,3972,8673
23892,40081,15-19,1090,1178,2268
23893,40081,20-24,869,901,1770
23894,40081,25-29,942,975,1917
23895,40081,30-34,1009,960,1969
23896,40081,35-39,1071,990,2061
23897,40081,40-44,1018,1079,2097
23898,40081,45-49,975,949,1924
23899,40081,50-54,999,1093,2092
23900,40081,55-59,1215,1222,2437
23901,40081,60-64,1206,1196,2402
23902,40081,65+,3388,3066,6454
23903,40083,15-19,1982,2055,4037
23904,40083,20-24,1544,1660,3204
23905,40083,25-29,1338,1305,2643
23906,40083,30-34,1495,1483,2978
23907,40083,35-39,1759,1764,3523
23908,40083,40-44,1628,1694,3322
23909,40083,45-49,1517,1637,3154
23910,40083,50-54,1568,1511,3079
23911,40083,55-59,1760,1689,3449
23912,40083,60-64,1834,1735,3569
23913,40083,65+,4520,4191,8711
23914,40085,15-19,363,314,677
23915,40085,20-24,316,300,616
23916,40085,25-29,306,297,603
23917,40085,30-34,300,352,652
23918,40085,35-39,313,335,648
23919,40085,40-44,296,297,593
23920,40085,45-49,304,294,598
23921,40085,50-54,298,323,621
23922,40085,55-59,312,292,604
23923,40085,60-64,322,330,652
23924,40085,65+,945,943,1888
23925,40087,15-19,1521,1531,3052
23926,40087,20-24,1146,1205,2351
23927,40087,25-29,1213,1194,2407
23928,40087,30-34,1335,1293,2628
23929,40087,35-39,1606,1603,3209
23930,40087,40-44,1482,1533,3015
23931,40087,45-49,1374,1418,2792
23932,40087,50-54,1314,1352,2666
23933,40087,55-59,1445,1437,2882
23934,40087,60-64,1408,1346,2754
23935,40087,65+,3581,3221,6802
23936,40089,15-19,940,1042,1982
23937,40089,20-24,907,894,1801
23938,40089,25-29,920,963,1883
23939,40089,30-34,967,930,1897
23940,40089,35-39,910,894,1804
23941,40089,40-44,889,826,1715
23942,40089,45-49,894,881,1775
23943,40089,50-54,926,932,1858
23944,40089,55-59,1026,966,1992
23945,40089,60-64,996,906,1902
23946,40089,65+,3009,2566,5575
23947,40091,15-19,509,599,1108
23948,40091,20-24,426,470,896
23949,40091,25-29,494,489,983
23950,40091,30-34,492,448,940
23951,40091,35-39,505,563,1068
23952,40091,40-44,526,483,1009
23953,40091,45-49,544,503,1047
23954,40091,50-54,582,582,1164
23955,40091,55-59,719,675,1394
23956,40091,60-64,801,794,1595
23957,40091,65+,2583,2310,4893
23958,40093,15-19,265,245,510
23959,40093,20-24,183,183,366
23960,40093,25-29,189,178,367
23961,40093,30-34,191,195,386
23962,40093,35-39,223,222,445
23963,40093,40-44,239,262,501
23964,40093,45-49,193,193,386
23965,40093,50-54,204,204,408
23966,40093,55-59,231,232,463
23967,40093,60-64,265,308,573
23968,40093,65+,889,747,1636
23969,40095,15-19,489,482,971
23970,40095,20-24,391,452,843
23971,40095,25-29,419,441,860
23972,40095,30-34,393,389,782
23973,40095,35-39,411,418,829
23974,40095,40-44,451,405,856
23975,40095,45-49,437,423,860
23976,40095,50-54,455,482,937
23977,40095,55-59,540,527,1067
23978,40095,60-64,610,593,1203
23979,40095,65+,1756,1662,3418
23980,40097,15-19,1122,1308,2430
23981,40097,20-24,1125,1161,2286
23982,40097,25-29,1189,1197,2386
23983,40097,30-34,1196,1173,2369
23984,40097,35-39,1173,1143,2316
23985,40097,40-44,1183,1238,2421
23986,40097,45-49,1129,1177,2306
23987,40097,50-54,1191,1277,2468
23988,40097,55-59,1236,1321,2557
23989,40097,60-64,1412,1344,2756
23990,40097,65+,3878,3426,7304
23991,40099,15-19,401,485,886
23992,40099,20-24,340,401,741
23993,40099,25-29,369,372,741
23994,40099,30-34,371,369,740
23995,40099,35-39,435,426,861
23996,40099,40-44,426,418,844
23997,40099,45-49,399,416,815
23998,40099,50-54,428,410,838
23999,40099,55-59,446,469,915
24000,40099,60-64,486,484,970
24001,40099,65+,1436,1298,2734
24002,40101,15-19,2237,2404,4641
24003,40101,20-24,2050,2239,4289
24004,40101,25-29,2027,2069,4096
24005,40101,30-34,2205,2015,4220
24006,40101,35-39,2172,2052,4224
24007,40101,40-44,2144,2051,4195
24008,40101,45-49,1926,1897,3823
24009,40101,50-54,1921,1869,3790
24010,40101,55-59,2055,2014,4069
24011,40101,60-64,2214,2012,4226
24012,40101,65+,6179,5025,11204
24013,40103,15-19,341,346,687
24014,40103,20-24,278,300,578
24015,40103,25-29,268,289,557
24016,40103,30-34,328,294,622
24017,40103,35-39,356,334,690
24018,40103,40-44,302,345,647
24019,40103,45-49,288,299,587
24020,40103,50-54,368,371,739
24021,40103,55-59,374,363,737
24022,40103,60-64,383,389,772
24023,40103,65+,1186,1036,2222
24024,40105,15-19,288,266,554
24025,40105,20-24,215,247,462
24026,40105,25-29,254,277,531
24027,40105,30-34,279,264,543
24028,40105,35-39,275,300,575
24029,40105,40-44,260,275,535
24030,40105,45-49,274,285,559
24031,40105,50-54,282,289,571
24032,40105,55-59,329,340,669
24033,40105,60-64,360,364,724
24034,40105,65+,988,818,1806
24035,40107,15-19,319,366,685
24036,40107,20-24,304,359,663
24037,40107,25-29,290,414,704
24038,40107,30-34,271,425,696
24039,40107,35-39,306,411,717
24040,40107,40-44,298,440,738
24041,40107,45-49,288,416,704
24042,40107,50-54,337,428,765
24043,40107,55-59,334,404,738
24044,40107,60-64,349,385,734
24045,40107,65+,1063,916,1979
24046,40109,15-19,25916,27099,53015
24047,40109,20-24,26610,26574,53184
24048,40109,25-29,29743,29746,59489
24049,40109,30-34,30334,29067,59401
24050,40109,35-39,28749,28663,57412
24051,40109,40-44,25870,25229,51099
24052,40109,45-49,22969,22091,45060
24053,40109,50-54,22084,22112,44196
24054,40109,55-59,23542,22183,45725
24055,40109,60-64,24055,22213,46268
24056,40109,65+,63707,50635,114342
24057,40111,15-19,1258,1354,2612
24058,40111,20-24,1052,1300,2352
24059,40111,25-29,1099,1157,2256
24060,40111,30-34,1142,1147,2289
24061,40111,35-39,1063,1077,2140
24062,40111,40-44,1087,1033,2120
24063,40111,45-49,1052,1018,2070
24064,40111,50-54,1012,1109,2121
24065,40111,55-59,1209,1166,2375
24066,40111,60-64,1277,1183,2460
24067,40111,65+,3815,3061,6876
24068,40113,15-19,1340,1426,2766
24069,40113,20-24,1117,1378,2495
24070,40113,25-29,1167,1384,2551
24071,40113,30-34,1285,1416,2701
24072,40113,35-39,1296,1408,2704
24073,40113,40-44,1314,1448,2762
24074,40113,45-49,1234,1364,2598
24075,40113,50-54,1403,1405,2808
24076,40113,55-59,1695,1648,3343
24077,40113,60-64,1783,1674,3457
24078,40113,65+,5105,4521,9626
24079,40115,15-19,1045,1136,2181
24080,40115,20-24,934,1060,1994
24081,40115,25-29,923,927,1850
24082,40115,30-34,980,900,1880
24083,40115,35-39,847,851,1698
24084,40115,40-44,842,812,1654
24085,40115,45-49,812,829,1641
24086,40115,50-54,885,902,1787
24087,40115,55-59,968,867,1835
24088,40115,60-64,961,916,1877
24089,40115,65+,3039,2440,5479
24090,40117,15-19,496,540,1036
24091,40117,20-24,391,421,812
24092,40117,25-29,397,471,868
24093,40117,30-34,452,434,886
24094,40117,35-39,475,458,933
24095,40117,40-44,449,485,934
24096,40117,45-49,470,460,930
24097,40117,50-54,510,536,1046
24098,40117,55-59,540,570,1110
24099,40117,60-64,526,516,1042
24100,40117,65+,1650,1450,3100
24101,40119,15-19,4094,4078,8172
24102,40119,20-24,7473,8881,16354
24103,40119,25-29,2664,3245,5909
24104,40119,30-34,2170,2477,4647
24105,40119,35-39,2327,2349,4676
24106,40119,40-44,2008,2185,4193
24107,40119,45-49,1795,1863,3658
24108,40119,50-54,1629,1731,3360
24109,40119,55-59,1898,1729,3627
24110,40119,60-64,1957,1907,3864
24111,40119,65+,5918,4906,10824
24112,40121,15-19,1246,1385,2631
24113,40121,20-24,1020,1300,2320
24114,40121,25-29,1236,1601,2837
24115,40121,30-34,1253,1571,2824
24116,40121,35-39,1279,1551,2830
24117,40121,40-44,1217,1411,2628
24118,40121,45-49,1162,1297,2459
24119,40121,50-54,1198,1316,2514
24120,40121,55-59,1405,1424,2829
24121,40121,60-64,1464,1396,2860
24122,40121,65+,4742,3960,8702
24123,40123,15-19,1422,1365,2787
24124,40123,20-24,1446,1437,2883
24125,40123,25-29,1321,1172,2493
24126,40123,30-34,1335,1266,2601
24127,40123,35-39,1174,1266,2440
24128,40123,40-44,1133,1131,2264
24129,40123,45-49,1029,951,1980
24130,40123,50-54,1021,1010,2031
24131,40123,55-59,1172,1068,2240
24132,40123,60-64,1172,1104,2276
24133,40123,65+,3551,2756,6307
24134,40125,15-19,2473,2562,5035
24135,40125,20-24,2476,2374,4850
24136,40125,25-29,2390,2155,4545
24137,40125,30-34,2484,2210,4694
24138,40125,35-39,2470,2172,4642
24139,40125,40-44,2422,2228,4650
24140,40125,45-49,2283,2127,4410
24141,40125,50-54,2337,2128,4465
24142,40125,55-59,2429,2330,4759
24143,40125,60-64,2437,2187,4624
24144,40125,65+,6622,5546,12168
24145,40127,15-19,292,350,642
24146,40127,20-24,246,277,523
24147,40127,25-29,307,270,577
24148,40127,30-34,318,282,600
24149,40127,35-39,299,320,619
24150,40127,40-44,286,328,614
24151,40127,45-49,268,272,540
24152,40127,50-54,357,305,662
24153,40127,55-59,403,401,804
24154,40127,60-64,416,419,835
24155,40127,65+,1333,1169,2502
24156,40129,15-19,130,118,248
24157,40129,20-24,73,77,150
24158,40129,25-29,77,95,172
24159,40129,30-34,87,79,166
24160,40129,35-39,111,96,207
24161,40129,40-44,101,108,209
24162,40129,45-49,76,102,178
24163,40129,50-54,88,96,184
24164,40129,55-59,114,117,231
24165,40129,60-64,113,126,239
24166,40129,65+,420,339,759
24167,40131,15-19,3033,3272,6305
24168,40131,20-24,2807,2937,5744
24169,40131,25-29,2901,3116,6017
24170,40131,30-34,3027,3074,6101
24171,40131,35-39,3244,3094,6338
24172,40131,40-44,2883,2963,5846
24173,40131,45-49,2915,2896,5811
24174,40131,50-54,3128,3217,6345
24175,40131,55-59,3374,3329,6703
24176,40131,60-64,3316,3383,6699
24177,40131,65+,8721,7731,16452
24178,40133,15-19,836,878,1714
24179,40133,20-24,725,792,1517
24180,40133,25-29,636,649,1285
24181,40133,30-34,671,664,1335
24182,40133,35-39,720,647,1367
24183,40133,40-44,778,699,1477
24184,40133,45-49,662,658,1320
24185,40133,50-54,669,715,1384
24186,40133,55-59,793,771,1564
24187,40133,60-64,823,771,1594
24188,40133,65+,2340,1954,4294
24189,40135,15-19,1212,1291,2503
24190,40135,20-24,1123,1161,2284
24191,40135,25-29,1193,1253,2446
24192,40135,30-34,1196,1156,2352
24193,40135,35-39,1124,1111,2235
24194,40135,40-44,1173,1097,2270
24195,40135,45-49,1223,1199,2422
24196,40135,50-54,1257,1221,2478
24197,40135,55-59,1391,1384,2775
24198,40135,60-64,1299,1317,2616
24199,40135,65+,3957,3335,7292
24200,40137,15-19,1369,1428,2797
24201,40137,20-24,1108,1146,2254
24202,40137,25-29,1204,1185,2389
24203,40137,30-34,1312,1251,2563
24204,40137,35-39,1310,1309,2619
24205,40137,40-44,1337,1297,2634
24206,40137,45-49,1218,1222,2440
24207,40137,50-54,1215,1215,2430
24208,40137,55-59,1517,1400,2917
24209,40137,60-64,1624,1529,3153
24210,40137,65+,4873,3951,8824
24211,40139,15-19,726,904,1630
24212,40139,20-24,692,920,1612
24213,40139,25-29,602,712,1314
24214,40139,30-34,625,793,1418
24215,40139,35-39,571,768,1339
24216,40139,40-44,579,757,1336
24217,40139,45-49,566,590,1156
24218,40139,50-54,530,693,1223
24219,40139,55-59,525,688,1213
24220,40139,60-64,503,561,1064
24221,40139,65+,1283,1270,2553
24222,40141,15-19,220,262,482
24223,40141,20-24,184,230,414
24224,40141,25-29,167,213,380
24225,40141,30-34,191,216,407
24226,40141,35-39,173,220,393
24227,40141,40-44,196,233,429
24228,40141,45-49,175,197,372
24229,40141,50-54,217,224,441
24230,40141,55-59,240,263,503
24231,40141,60-64,250,237,487
24232,40141,65+,733,670,1403
24233,40143,15-19,21906,22993,44899
24234,40143,20-24,21441,21446,42887
24235,40143,25-29,23714,23576,47290
24236,40143,30-34,24613,24059,48672
24237,40143,35-39,23684,23488,47172
24238,40143,40-44,21611,21495,43106
24239,40143,45-49,19804,19326,39130
24240,40143,50-54,19714,19539,39253
24241,40143,55-59,19866,19189,39055
24242,40143,60-64,20748,18838,39586
24243,40143,65+,56996,44365,101361
24244,40145,15-19,2594,2807,5401
24245,40145,20-24,2221,2307,4528
24246,40145,25-29,2616,2652,5268
24247,40145,30-34,2951,2814,5765
24248,40145,35-39,2976,2869,5845
24249,40145,40-44,2850,2794,5644
24250,40145,45-49,2524,2609,5133
24251,40145,50-54,2576,2584,5160
24252,40145,55-59,2652,2702,5354
24253,40145,60-64,2810,2607,5417
24254,40145,65+,7520,6689,14209
24255,40147,15-19,1648,1782,3430
24256,40147,20-24,1458,1477,2935
24257,40147,25-29,1546,1521,3067
24258,40147,30-34,1672,1677,3349
24259,40147,35-39,1709,1802,3511
24260,40147,40-44,1523,1535,3058
24261,40147,45-49,1501,1388,2889
24262,40147,50-54,1496,1447,2943
24263,40147,55-59,1658,1462,3120
24264,40147,60-64,1876,1653,3529
24265,40147,65+,5775,4593,10368
24266,40149,15-19,318,389,707
24267,40149,20-24,267,254,521
24268,40149,25-29,309,309,618
24269,40149,30-34,315,317,632
24270,40149,35-39,353,355,708
24271,40149,40-44,326,324,650
24272,40149,45-49,278,265,543
24273,40149,50-54,301,309,610
24274,40149,55-59,358,357,715
24275,40149,60-64,391,417,808
24276,40149,65+,1171,951,2122
24277,40151,15-19,283,416,699
24278,40151,20-24,361,621,982
24279,40151,25-29,241,322,563
24280,40151,30-34,243,348,591
24281,40151,35-39,242,307,549
24282,40151,40-44,216,244,460
24283,40151,45-49,172,180,352
24284,40151,50-54,192,204,396
24285,40151,55-59,219,246,465
24286,40151,60-64,249,241,490
24287,40151,65+,779,728,1507
24288,40153,15-19,634,661,1295
24289,40153,20-24,537,678,1215
24290,40153,25-29,575,817,1392
24291,40153,30-34,565,792,1357
24292,40153,35-39,611,763,1374
24293,40153,40-44,588,798,1386
24294,40153,45-49,540,702,1242
24295,40153,50-54,513,600,1113
24296,40153,55-59,575,590,1165
24297,40153,60-64,632,648,1280
24298,40153,65+,1738,1551,3289
24299,41001,15-19,380,465,845
24300,41001,20-24,300,377,677
24301,41001,25-29,397,462,859
24302,41001,30-34,446,467,913
24303,41001,35-39,489,539,1028
24304,41001,40-44,421,488,909
24305,41001,45-49,391,432,823
24306,41001,50-54,457,477,934
24307,41001,55-59,560,555,1115
24308,41001,60-64,729,671,1400
24309,41001,65+,2278,2258,4536
24310,41003,15-19,4497,4502,8999
24311,41003,20-24,7091,8027,15118
24312,41003,25-29,3283,3759,7042
24313,41003,30-34,2731,2872,5603
24314,41003,35-39,2585,2628,5213
24315,41003,40-44,2485,2475,4960
24316,41003,45-49,2353,2284,4637
24317,41003,50-54,2401,2429,4830
24318,41003,55-59,2503,2322,4825
24319,41003,60-64,2978,2600,5578
24320,41003,65+,8897,7965,16862
24321,41005,15-19,12160,12827,24987
24322,41005,20-24,10701,11250,21951
24323,41005,25-29,11972,12518,24490
24324,41005,30-34,13357,13407,26764
24325,41005,35-39,14754,14584,29338
24326,41005,40-44,14863,14918,29781
24327,41005,45-49,13397,13740,27137
24328,41005,50-54,13929,14196,28125
24329,41005,55-59,13976,13831,27807
24330,41005,60-64,14662,13870,28532
24331,41005,65+,43627,37156,80783
24332,41007,15-19,1072,1081,2153
24333,41007,20-24,1087,1151,2238
24334,41007,25-29,1098,1164,2262
24335,41007,30-34,1287,1301,2588
24336,41007,35-39,1391,1342,2733
24337,41007,40-44,1387,1353,2740
24338,41007,45-49,1119,1153,2272
24339,41007,50-54,1149,1177,2326
24340,41007,55-59,1435,1380,2815
24341,41007,60-64,1670,1599,3269
24342,41007,65+,5261,4841,10102
24343,41009,15-19,1429,1547,2976
24344,41009,20-24,1246,1427,2673
24345,41009,25-29,1398,1538,2936
24346,41009,30-34,1665,1733,3398
24347,41009,35-39,1685,1735,3420
24348,41009,40-44,1743,1772,3515
24349,41009,45-49,1542,1626,3168
24350,41009,50-54,1812,1894,3706
24351,41009,55-59,1885,1931,3816
24352,41009,60-64,2049,1949,3998
24353,41009,65+,5547,5036,10583
24354,41011,15-19,1564,1594,3158
24355,41011,20-24,1424,1518,2942
24356,41011,25-29,1641,1674,3315
24357,41011,30-34,1798,1920,3718
24358,41011,35-39,1820,1876,3696
24359,41011,40-44,1835,1823,3658
24360,41011,45-49,1691,1681,3372
24361,41011,50-54,1871,1839,3710
24362,41011,55-59,2310,2182,4492
24363,41011,60-64,2876,2542,5418
24364,41011,65+,9261,8542,17803
24365,41013,15-19,589,691,1280
24366,41013,20-24,572,582,1154
24367,41013,25-29,645,608,1253
24368,41013,30-34,748,760,1508
24369,41013,35-39,711,773,1484
24370,41013,40-44,752,722,1474
24371,41013,45-49,703,750,1453
24372,41013,50-54,775,753,1528
24373,41013,55-59,896,835,1731
24374,41013,60-64,1066,1043,2109
24375,41013,65+,3275,3215,6490
24376,41015,15-19,420,456,876
24377,41015,20-24,356,422,778
24378,41015,25-29,456,515,971
24379,41015,30-34,515,583,1098
24380,41015,35-39,560,525,1085
24381,41015,40-44,556,527,1083
24382,41015,45-49,541,541,1082
24383,41015,50-54,678,632,1310
24384,41015,55-59,967,827,1794
24385,41015,60-64,1261,1110,2371
24386,41015,65+,4317,4100,8417
24387,41017,15-19,5230,5806,11036
24388,41017,20-24,4758,4922,9680
24389,41017,25-29,6290,6597,12887
24390,41017,30-34,7130,7280,14410
24391,41017,35-39,7366,7507,14873
24392,41017,40-44,6910,7052,13962
24393,41017,45-49,6271,6576,12847
24394,41017,50-54,6549,6545,13094
24395,41017,55-59,6575,6145,12720
24396,41017,60-64,7781,6989,14770
24397,41017,65+,22008,20098,42106
24398,41019,15-19,2807,3062,5869
24399,41019,20-24,2479,2624,5103
24400,41019,25-29,2987,3112,6099
24401,41019,30-34,3249,3241,6490
24402,41019,35-39,3189,3088,6277
24403,41019,40-44,3079,3260,6339
24404,41019,45-49,2779,2861,5640
24405,41019,50-54,3296,3178,6474
24406,41019,55-59,3925,3672,7597
24407,41019,60-64,4562,4156,8718
24408,41019,65+,15291,14210,29501
24409,41021,15-19,43,54,97
24410,41021,20-24,34,42,76
24411,41021,25-29,39,50,89
24412,41021,30-34,43,38,81
24413,41021,35-39,48,51,99
24414,41021,40-44,60,59,119
24415,41021,45-49,63,44,107
24416,41021,50-54,48,54,102
24417,41021,55-59,67,68,135
24418,41021,60-64,82,101,183
24419,41021,65+,299,280,579
24420,41023,15-19,143,175,318
24421,41023,20-24,143,136,279
24422,41023,25-29,163,177,340
24423,41023,30-34,192,188,380
24424,41023,35-39,207,194,401
24425,41023,40-44,195,208,403
24426,41023,45-49,168,189,357
24427,41023,50-54,200,159,359
24428,41023,55-59,235,232,467
24429,41023,60-64,286,294,580
24430,41023,65+,1139,1145,2284
24431,41025,15-19,155,252,407
24432,41025,20-24,138,215,353
24433,41025,25-29,186,227,413
24434,41025,30-34,246,209,455
24435,41025,35-39,215,238,453
24436,41025,40-44,209,236,445
24437,41025,45-49,206,174,380
24438,41025,50-54,221,202,423
24439,41025,55-59,254,221,475
24440,41025,60-64,313,320,633
24441,41025,65+,953,945,1898
24442,41027,15-19,763,828,1591
24443,41027,20-24,622,747,1369
24444,41027,25-29,687,762,1449
24445,41027,30-34,735,773,1508
24446,41027,35-39,846,774,1620
24447,41027,40-44,852,843,1695
24448,41027,45-49,723,791,1514
24449,41027,50-54,780,771,1551
24450,41027,55-59,742,815,1557
24451,41027,60-64,809,800,1609
24452,41027,65+,2127,1969,4096
24453,41029,15-19,6057,6301,12358
24454,41029,20-24,5665,5745,11410
24455,41029,25-29,6661,6728,13389
24456,41029,30-34,7338,7248,14586
24457,41029,35-39,7288,7264,14552
24458,41029,40-44,6933,6832,13765
24459,41029,45-49,6086,6137,12223
24460,41029,50-54,6424,6604,13028
24461,41029,55-59,7145,6723,13868
24462,41029,60-64,8215,7376,15591
24463,41029,65+,27498,23350,50848
24464,41031,15-19,748,763,1511
24465,41031,20-24,650,713,1363
24466,41031,25-29,677,856,1533
24467,41031,30-34,785,900,1685
24468,41031,35-39,719,833,1552
24469,41031,40-44,643,738,1381
24470,41031,45-49,643,741,1384
24471,41031,50-54,685,762,1447
24472,41031,55-59,804,845,1649
24473,41031,60-64,879,884,1763
24474,41031,65+,2497,2450,4947
24475,41033,15-19,2191,2507,4698
24476,41033,20-24,1907,2055,3962
24477,41033,25-29,2343,2446,4789
24478,41033,30-34,2546,2558,5104
24479,41033,35-39,2391,2480,4871
24480,41033,40-44,2492,2408,4900
24481,41033,45-49,2257,2300,4557
24482,41033,50-54,2617,2467,5084
24483,41033,55-59,3099,2818,5917
24484,41033,60-64,3781,3297,7078
24485,41033,65+,12601,10807,23408
24486,41035,15-19,1925,2230,4155
24487,41035,20-24,1843,1999,3842
24488,41035,25-29,2115,2202,4317
24489,41035,30-34,2274,2293,4567
24490,41035,35-39,2061,2098,4159
24491,41035,40-44,1907,1979,3886
24492,41035,45-49,1779,1881,3660
24493,41035,50-54,1939,1964,3903
24494,41035,55-59,2301,2143,4444
24495,41035,60-64,2531,2411,4942
24496,41035,65+,7965,7434,15399
24497,41037,15-19,191,224,415
24498,41037,20-24,152,187,339
24499,41037,25-29,173,238,411
24500,41037,30-34,188,253,441
24501,41037,35-39,217,252,469
24502,41037,40-44,215,290,505
24503,41037,45-49,222,298,520
24504,41037,50-54,209,291,500
24505,41037,55-59,247,294,541
24506,41037,60-64,306,297,603
24507,41037,65+,1030,1163,2193
24508,41039,15-19,12065,12236,24301
24509,41039,20-24,17516,17037,34553
24510,41039,25-29,12474,13198,25672
24511,41039,30-34,12158,12589,24747
24512,41039,35-39,11960,12216,24176
24513,41039,40-44,12069,12279,24348
24514,41039,45-49,10466,10633,21099
24515,41039,50-54,10677,10900,21577
24516,41039,55-59,11732,10973,22705
24517,41039,60-64,13320,11892,25212
24518,41039,65+,42498,36063,78561
24519,41041,15-19,1137,1271,2408
24520,41041,20-24,987,1075,2062
24521,41041,25-29,1048,1129,2177
24522,41041,30-34,1236,1188,2424
24523,41041,35-39,1384,1317,2701
24524,41041,40-44,1452,1349,2801
24525,41041,45-49,1296,1288,2584
24526,41041,50-54,1529,1484,3013
24527,41041,55-59,1926,1623,3549
24528,41041,60-64,2587,2161,4748
24529,41041,65+,8387,7356,15743
24530,41043,15-19,3648,3999,7647
24531,41043,20-24,3634,3619,7253
24532,41043,25-29,4281,4392,8673
24533,41043,30-34,4551,4515,9066
24534,41043,35-39,4305,4362,8667
24535,41043,40-44,3915,3938,7853
24536,41043,45-49,3566,3659,7225
24537,41043,50-54,3796,3909,7705
24538,41043,55-59,4204,4051,8255
24539,41043,60-64,4470,4225,8695
24540,41043,65+,13211,11658,24869
24541,41045,15-19,1068,1161,2229
24542,41045,20-24,881,1261,2142
24543,41045,25-29,835,1345,2180
24544,41045,30-34,845,1246,2091
24545,41045,35-39,783,1195,1978
24546,41045,40-44,786,1111,1897
24547,41045,45-49,723,1099,1822
24548,41045,50-54,722,997,1719
24549,41045,55-59,782,905,1687
24550,41045,60-64,848,932,1780
24551,41045,65+,2728,2577,5305
24552,41047,15-19,11306,12258,23564
24553,41047,20-24,10646,11571,22217
24554,41047,25-29,11609,12571,24180
24555,41047,30-34,12027,12771,24798
24556,41047,35-39,11365,12107,23472
24557,41047,40-44,10834,11712,22546
24558,41047,45-49,9801,10298,20099
24559,41047,50-54,10064,10502,20566
24560,41047,55-59,9943,10137,20080
24561,41047,60-64,10679,9941,20620
24562,41047,65+,30921,25515,56436
24563,41049,15-19,472,471,943
24564,41049,20-24,368,419,787
24565,41049,25-29,361,394,755
24566,41049,30-34,331,349,680
24567,41049,35-39,350,343,693
24568,41049,40-44,366,345,711
24569,41049,45-49,362,370,732
24570,41049,50-54,340,358,698
24571,41049,55-59,295,349,644
24572,41049,60-64,408,421,829
24573,41049,65+,1039,1011,2050
24574,41051,15-19,20067,20568,40635
24575,41051,20-24,23251,22323,45574
24576,41051,25-29,34623,32790,67413
24577,41051,30-34,39027,39058,78085
24578,41051,35-39,35794,36828,72622
24579,41051,40-44,32151,33233,65384
24580,41051,45-49,27250,29113,56363
24581,41051,50-54,25613,27366,52979
24582,41051,55-59,22377,23330,45707
24583,41051,60-64,22004,21481,43485
24584,41051,65+,63320,51952,115272
24585,41053,15-19,3361,3248,6609
24586,41053,20-24,3907,3781,7688
24587,41053,25-29,2803,3020,5823
24588,41053,30-34,2700,2677,5377
24589,41053,35-39,2857,2899,5756
24590,41053,40-44,2792,2722,5514
24591,41053,45-49,2467,2439,4906
24592,41053,50-54,2417,2463,4880
24593,41053,55-59,2527,2403,4930
24594,41053,60-64,2621,2461,5082
24595,41053,65+,8976,7537,16513
24596,41055,15-19,45,40,85
24597,41055,20-24,35,37,72
24598,41055,25-29,37,40,77
24599,41055,30-34,65,61,126
24600,41055,35-39,61,59,120
24601,41055,40-44,54,60,114
24602,41055,45-49,32,64,96
24603,41055,50-54,43,52,95
24604,41055,55-59,67,69,136
24605,41055,60-64,79,89,168
24606,41055,65+,244,250,494
24607,41057,15-19,663,772,1435
24608,41057,20-24,483,636,1119
24609,41057,25-29,663,752,1415
24610,41057,30-34,791,774,1565
24611,41057,35-39,800,824,1624
24612,41057,40-44,731,809,1540
24613,41057,45-49,667,735,1402
24614,41057,50-54,840,816,1656
24615,41057,55-59,912,940,1852
24616,41057,60-64,1221,1170,2391
24617,41057,65+,3943,3660,7603
24618,41059,15-19,2652,2822,5474
24619,41059,20-24,2247,2934,5181
24620,41059,25-29,2420,3222,5642
24621,41059,30-34,2511,3174,5685
24622,41059,35-39,2347,2914,5261
24623,41059,40-44,2286,2751,5037
24624,41059,45-49,2147,2529,4676
24625,41059,50-54,2199,2448,4647
24626,41059,55-59,2187,2454,4641
24627,41059,60-64,2245,2294,4539
24628,41059,65+,6645,6226,12871
24629,41061,15-19,930,992,1922
24630,41061,20-24,1052,1023,2075
24631,41061,25-29,708,803,1511
24632,41061,30-34,739,746,1485
24633,41061,35-39,808,815,1623
24634,41061,40-44,725,799,1524
24635,41061,45-49,655,641,1296
24636,41061,50-54,640,651,1291
24637,41061,55-59,735,703,1438
24638,41061,60-64,914,811,1725
24639,41061,65+,2940,2655,5595
24640,41063,15-19,190,193,383
24641,41063,20-24,123,98,221
24642,41063,25-29,145,135,280
24643,41063,30-34,228,191,419
24644,41063,35-39,253,216,469
24645,41063,40-44,214,209,423
24646,41063,45-49,151,199,350
24647,41063,50-54,211,179,390
24648,41063,55-59,271,223,494
24649,41063,60-64,341,309,650
24650,41063,65+,1118,1119,2237
24651,41065,15-19,695,817,1512
24652,41065,20-24,682,688,1370
24653,41065,25-29,838,900,1738
24654,41065,30-34,912,946,1858
24655,41065,35-39,863,935,1798
24656,41065,40-44,751,805,1556
24657,41065,45-49,721,713,1434
24658,41065,50-54,724,742,1466
24659,41065,55-59,838,782,1620
24660,41065,60-64,979,911,1890
24661,41065,65+,2922,2710,5632
24662,41067,15-19,17792,18806,36598
24663,41067,20-24,17567,17533,35100
24664,41067,25-29,22144,22781,44925
24665,41067,30-34,23730,25175,48905
24666,41067,35-39,23595,24888,48483
24667,41067,40-44,21989,22860,44849
24668,41067,45-49,20059,20524,40583
24669,41067,50-54,19378,19842,39220
24670,41067,55-59,17598,17544,35142
24671,41067,60-64,16937,16144,33081
24672,41067,65+,47855,38015,85870
24673,41069,15-19,25,40,65
24674,41069,20-24,27,31,58
24675,41069,25-29,27,25,52
24676,41069,30-34,32,24,56
24677,41069,35-39,31,37,68
24678,41069,40-44,26,35,61
24679,41069,45-49,29,45,74
24680,41069,50-54,38,25,63
24681,41069,55-59,67,49,116
24682,41069,60-64,79,71,150
24683,41069,65+,277,256,533
24684,41071,15-19,3684,3777,7461
24685,41071,20-24,3511,3632,7143
24686,41071,25-29,3193,3546,6739
24687,41071,30-34,3369,3723,7092
24688,41071,35-39,3450,3772,7222
24689,41071,40-44,3459,3684,7143
24690,41071,45-49,3052,3347,6399
24691,41071,50-54,3245,3416,6661
24692,41071,55-59,3248,3310,6558
24693,41071,60-64,3570,3327,6897
24694,41071,65+,10738,9222,19960
24695,42001,15-19,3347,3495,6842
24696,42001,20-24,3233,3275,6508
24697,42001,25-29,2713,2798,5511
24698,42001,30-34,2932,2969,5901
24699,42001,35-39,2834,2916,5750
24700,42001,40-44,2737,2865,5602
24701,42001,45-49,2896,2858,5754
24702,42001,50-54,3576,3583,7159
24703,42001,55-59,4030,3954,7984
24704,42001,60-64,4057,4004,8061
24705,42001,65+,12046,10344,22390
24706,42003,15-19,35106,36076,71182
24707,42003,20-24,36940,36094,73034
24708,42003,25-29,43728,44748,88476
24709,42003,30-34,47936,49137,97073
24710,42003,35-39,42701,44831,87532
24711,42003,40-44,36580,37579,74159
24712,42003,45-49,32861,32734,65595
24713,42003,50-54,37634,36547,74181
24714,42003,55-59,41938,38901,80839
24715,42003,60-64,46675,42853,89528
24716,42003,65+,138126,105841,243967
24717,42005,15-19,1644,1790,3434
24718,42005,20-24,1511,1669,3180
24719,42005,25-29,1682,1796,3478
24720,42005,30-34,1659,1761,3420
24721,42005,35-39,1807,1863,3670
24722,42005,40-44,1833,1855,3688
24723,42005,45-49,1912,1980,3892
24724,42005,50-54,2208,2296,4504
24725,42005,55-59,2462,2525,4987
24726,42005,60-64,2712,2856,5568
24727,42005,65+,8010,7081,15091
24728,42007,15-19,4492,4677,9169
24729,42007,20-24,4070,4282,8352
24730,42007,25-29,4656,4808,9464
24731,42007,30-34,4988,5010,9998
24732,42007,35-39,5057,5268,10325
24733,42007,40-44,4815,4979,9794
24734,42007,45-49,4547,4514,9061
24735,42007,50-54,5370,5325,10695
24736,42007,55-59,6445,6149,12594
24737,42007,60-64,6873,6555,13428
24738,42007,65+,20634,16547,37181
24739,42009,15-19,1244,1393,2637
24740,42009,20-24,1157,1264,2421
24741,42009,25-29,1215,1282,2497
24742,42009,30-34,1157,1370,2527
24743,42009,35-39,1195,1178,2373
24744,42009,40-44,1316,1332,2648
24745,42009,45-49,1409,1353,2762
24746,42009,50-54,1604,1743,3347
24747,42009,55-59,1784,1828,3612
24748,42009,60-64,1936,2076,4012
24749,42009,65+,5944,5253,11197
24750,42011,15-19,14890,15212,30102
24751,42011,20-24,13531,13832,27363
24752,42011,25-29,12696,13507,26203
24753,42011,30-34,13524,13940,27464
24754,42011,35-39,13174,13165,26339
24755,42011,40-44,12695,12615,25310
24756,42011,45-49,12473,12354,24827
24757,42011,50-54,14140,14029,28169
24758,42011,55-59,15383,15241,30624
24759,42011,60-64,14474,14611,29085
24760,42011,65+,41541,34563,76104
24761,42013,15-19,3604,3914,7518
24762,42013,20-24,3028,3257,6285
24763,42013,25-29,3408,3515,6923
24764,42013,30-34,3851,3971,7822
24765,42013,35-39,3537,3615,7152
24766,42013,40-44,3626,3607,7233
24767,42013,45-49,3399,3598,6997
24768,42013,50-54,3939,3993,7932
24769,42013,55-59,4231,4170,8401
24770,42013,60-64,4601,4499,9100
24771,42013,65+,14644,11448,26092
24772,42015,15-19,1670,1765,3435
24773,42015,20-24,1468,1517,2985
24774,42015,25-29,1700,1703,3403
24775,42015,30-34,1642,1732,3374
24776,42015,35-39,1608,1624,3232
24777,42015,40-44,1586,1559,3145
24778,42015,45-49,1565,1552,3117
24779,42015,50-54,1879,1922,3801
24780,42015,55-59,2290,2260,4550
24781,42015,60-64,2240,2371,4611
24782,42015,65+,6911,6318,13229
24783,42017,15-19,19087,20397,39484
24784,42017,20-24,17440,18485,35925
24785,42017,25-29,16989,17636,34625
24786,42017,30-34,17993,18412,36405
24787,42017,35-39,20098,20131,40229
24788,42017,40-44,19786,19850,39636
24789,42017,45-49,19409,19444,38853
24790,42017,50-54,23195,22987,46182
24791,42017,55-59,25951,25348,51299
24792,42017,60-64,25965,25382,51347
24793,42017,65+,69655,58392,128047
24794,42019,15-19,6174,6404,12578
24795,42019,20-24,5283,5348,10631
24796,42019,25-29,4832,5426,10258
24797,42019,30-34,5690,6010,11700
24798,42019,35-39,5965,6239,12204
24799,42019,40-44,5784,6081,11865
24800,42019,45-49,5558,5817,11375
24801,42019,50-54,6928,6995,13923
24802,42019,55-59,7402,7387,14789
24803,42019,60-64,7582,7588,15170
24804,42019,65+,20970,18010,38980
24805,42021,15-19,4131,4380,8511
24806,42021,20-24,3918,4178,8096
24807,42021,25-29,3280,3566,6846
24808,42021,30-34,3411,3607,7018
24809,42021,35-39,3355,3495,6850
24810,42021,40-44,3567,3679,7246
24811,42021,45-49,3731,3869,7600
24812,42021,50-54,4174,4362,8536
24813,42021,55-59,4601,4694,9295
24814,42021,60-64,5231,5171,10402
24815,42021,65+,16961,14059,31020
24816,42023,15-19,81,113,194
24817,42023,20-24,101,90,191
24818,42023,25-29,103,105,208
24819,42023,30-34,87,111,198
24820,42023,35-39,97,110,207
24821,42023,40-44,100,107,207
24822,42023,45-49,97,130,227
24823,42023,50-54,148,136,284
24824,42023,55-59,190,191,381
24825,42023,60-64,207,203,410
24826,42023,65+,688,623,1311
24827,42025,15-19,1772,1879,3651
24828,42025,20-24,1549,1698,3247
24829,42025,25-29,1637,1789,3426
24830,42025,30-34,1898,1992,3890
24831,42025,35-39,1868,1933,3801
24832,42025,40-44,1833,1984,3817
24833,42025,45-49,1945,1982,3927
24834,42025,50-54,2347,2443,4790
24835,42025,55-59,2565,2589,5154
24836,42025,60-64,2652,2665,5317
24837,42025,65+,7541,6810,14351
24838,42027,15-19,7532,7664,15196
24839,42027,20-24,11158,14190,25348
24840,42027,25-29,4332,5743,10075
24841,42027,30-34,4544,5874,10418
24842,42027,35-39,3962,5026,8988
24843,42027,40-44,3812,4800,8612
24844,42027,45-49,3717,4295,8012
24845,42027,50-54,4172,4752,8924
24846,42027,55-59,4599,4778,9377
24847,42027,60-64,4442,4661,9103
24848,42027,65+,13094,11474,24568
24849,42029,15-19,18845,19173,38018
24850,42029,20-24,16246,16075,32321
24851,42029,25-29,14304,15455,29759
24852,42029,30-34,16022,16288,32310
24853,42029,35-39,17269,17721,34990
24854,42029,40-44,17131,17448,34579
24855,42029,45-49,16557,16917,33474
24856,42029,50-54,18598,18679,37277
24857,42029,55-59,19501,19283,38784
24858,42029,60-64,18779,18340,37119
24859,42029,65+,50319,42334,92653
24860,42031,15-19,1494,1314,2808
24861,42031,20-24,1588,1532,3120
24862,42031,25-29,967,1015,1982
24863,42031,30-34,1085,1164,2249
24864,42031,35-39,955,979,1934
24865,42031,40-44,969,926,1895
24866,42031,45-49,996,990,1986
24867,42031,50-54,1186,1160,2346
24868,42031,55-59,1278,1346,2624
24869,42031,60-64,1356,1356,2712
24870,42031,65+,4065,3553,7618
24871,42033,15-19,2030,2138,4168
24872,42033,20-24,1787,2737,4524
24873,42033,25-29,2019,2920,4939
24874,42033,30-34,2031,2857,4888
24875,42033,35-39,1972,2845,4817
24876,42033,40-44,2178,2719,4897
24877,42033,45-49,2227,2890,5117
24878,42033,50-54,2669,3163,5832
24879,42033,55-59,2881,3221,6102
24880,42033,60-64,2906,3139,6045
24881,42033,65+,9143,7851,16994
24882,42035,15-19,1448,1335,2783
24883,42035,20-24,2011,1705,3716
24884,42035,25-29,1044,1233,2277
24885,42035,30-34,911,1179,2090
24886,42035,35-39,953,1000,1953
24887,42035,40-44,1003,981,1984
24888,42035,45-49,1033,1024,2057
24889,42035,50-54,1109,1112,2221
24890,42035,55-59,1157,1228,2385
24891,42035,60-64,1332,1294,2626
24892,42035,65+,3887,3326,7213
24893,42037,15-19,2861,2388,5249
24894,42037,20-24,3577,2976,6553
24895,42037,25-29,1733,1903,3636
24896,42037,30-34,1721,1884,3605
24897,42037,35-39,1753,1684,3437
24898,42037,40-44,1677,1763,3440
24899,42037,45-49,1776,1837,3613
24900,42037,50-54,1984,2071,4055
24901,42037,55-59,2216,2178,4394
24902,42037,60-64,2323,2222,4545
24903,42037,65+,7179,5840,13019
24904,42039,15-19,2679,2770,5449
24905,42039,20-24,2395,2481,4876
24906,42039,25-29,2346,2240,4586
24907,42039,30-34,2360,2307,4667
24908,42039,35-39,2351,2243,4594
24909,42039,40-44,2399,2218,4617
24910,42039,45-49,2400,2243,4643
24911,42039,50-54,2788,2700,5488
24912,42039,55-59,3026,2942,5968
24913,42039,60-64,3243,3167,6410
24914,42039,65+,9472,8537,18009
24915,42041,15-19,8648,8564,17212
24916,42041,20-24,7952,8359,16311
24917,42041,25-29,7648,8312,15960
24918,42041,30-34,8533,9363,17896
24919,42041,35-39,8609,9426,18035
24920,42041,40-44,8020,8604,16624
24921,42041,45-49,7416,8103,15519
24922,42041,50-54,8114,8671,16785
24923,42041,55-59,8647,8511,17158
24924,42041,60-64,8839,8397,17236
24925,42041,65+,27382,22151,49533
24926,42043,15-19,8406,8672,17078
24927,42043,20-24,8246,8215,16461
24928,42043,25-29,10033,9801,19834
24929,42043,30-34,10077,9896,19973
24930,42043,35-39,9449,9382,18831
24931,42043,40-44,8882,8480,17362
24932,42043,45-49,8240,8210,16450
24933,42043,50-54,9089,8980,18069
24934,42043,55-59,9834,9190,19024
24935,42043,60-64,10165,9432,19597
24936,42043,65+,28331,22488,50819
24937,42045,15-19,19332,20680,40012
24938,42045,20-24,18388,18292,36680
24939,42045,25-29,17772,17308,35080
24940,42045,30-34,19991,18687,38678
24941,42045,35-39,19801,18960,38761
24942,42045,40-44,18318,17405,35723
24943,42045,45-49,16431,15809,32240
24944,42045,50-54,18370,17609,35979
24945,42045,55-59,20244,18713,38957
24946,42045,60-64,20532,18837,39369
24947,42045,65+,55831,42599,98430
24948,42047,15-19,793,869,1662
24949,42047,20-24,760,799,1559
24950,42047,25-29,757,864,1621
24951,42047,30-34,689,774,1463
24952,42047,35-39,778,867,1645
24953,42047,40-44,778,806,1584
24954,42047,45-49,878,867,1745
24955,42047,50-54,1126,1198,2324
24956,42047,55-59,1253,1304,2557
24957,42047,60-64,1236,1430,2666
24958,42047,65+,3753,3331,7084
24959,42049,15-19,9187,9493,18680
24960,42049,20-24,8500,9071,17571
24961,42049,25-29,7871,8549,16420
24962,42049,30-34,8848,9159,18007
24963,42049,35-39,8193,8380,16573
24964,42049,40-44,7643,7837,15480
24965,42049,45-49,7310,7397,14707
24966,42049,50-54,8430,8511,16941
24967,42049,55-59,8927,8803,17730
24968,42049,60-64,9730,9569,19299
24969,42049,65+,27980,23414,51394
24970,42051,15-19,3267,3465,6732
24971,42051,20-24,3157,3400,6557
24972,42051,25-29,3502,4178,7680
24973,42051,30-34,3489,4077,7566
24974,42051,35-39,3419,3811,7230
24975,42051,40-44,3606,3735,7341
24976,42051,45-49,3756,3923,7679
24977,42051,50-54,4391,4464,8855
24978,42051,55-59,4612,4575,9187
24979,42051,60-64,5083,4902,9985
24980,42051,65+,15388,12768,28156
24981,42053,15-19,19,261,280
24982,42053,20-24,53,498,551
24983,42053,25-29,78,603,681
24984,42053,30-34,78,496,574
24985,42053,35-39,102,379,481
24986,42053,40-44,102,331,433
24987,42053,45-49,124,315,439
24988,42053,50-54,181,293,474
24989,42053,55-59,245,347,592
24990,42053,60-64,271,336,607
24991,42053,65+,840,935,1775
24992,42055,15-19,4669,5164,9833
24993,42055,20-24,4178,4130,8308
24994,42055,25-29,4470,4584,9054
24995,42055,30-34,4870,4733,9603
24996,42055,35-39,4731,4704,9435
24997,42055,40-44,4635,4501,9136
24998,42055,45-49,4681,4712,9393
24999,42055,50-54,5133,5315,10448
25000,42055,55-59,5400,5554,10954
25001,42055,60-64,5484,5131,10615
25002,42055,65+,17210,14200,31410
25003,42057,15-19,426,393,819
25004,42057,20-24,343,415,758
25005,42057,25-29,391,437,828
25006,42057,30-34,381,392,773
25007,42057,35-39,388,403,791
25008,42057,40-44,404,424,828
25009,42057,45-49,442,480,922
25010,42057,50-54,503,579,1082
25011,42057,55-59,512,604,1116
25012,42057,60-64,530,572,1102
25013,42057,65+,1663,1515,3178
25014,42059,15-19,1083,1131,2214
25015,42059,20-24,986,1196,2182
25016,42059,25-29,868,1278,2146
25017,42059,30-34,939,1297,2236
25018,42059,35-39,877,1143,2020
25019,42059,40-44,963,1217,2180
25020,42059,45-49,1030,1252,2282
25021,42059,50-54,1108,1305,2413
25022,42059,55-59,1128,1303,2431
25023,42059,60-64,1308,1269,2577
25024,42059,65+,3808,3347,7155
25025,42061,15-19,1394,1325,2719
25026,42061,20-24,1298,1550,2848
25027,42061,25-29,1028,1661,2689
25028,42061,30-34,1055,1736,2791
25029,42061,35-39,1061,1518,2579
25030,42061,40-44,1083,1512,2595
25031,42061,45-49,1103,1595,2698
25032,42061,50-54,1300,1645,2945
25033,42061,55-59,1472,1681,3153
25034,42061,60-64,1506,1599,3105
25035,42061,65+,4945,4493,9438
25036,42063,15-19,3601,3315,6916
25037,42063,20-24,4450,4555,9005
25038,42063,25-29,2041,2347,4388
25039,42063,30-34,1855,2283,4138
25040,42063,35-39,2085,2279,4364
25041,42063,40-44,2060,2239,4299
25042,42063,45-49,2059,2097,4156
25043,42063,50-54,2420,2578,4998
25044,42063,55-59,2712,2717,5429
25045,42063,60-64,2976,3042,6018
25046,42063,65+,9015,7939,16954
25047,42065,15-19,1312,1329,2641
25048,42065,20-24,1026,1125,2151
25049,42065,25-29,1192,1225,2417
25050,42065,30-34,1237,1302,2539
25051,42065,35-39,1211,1322,2533
25052,42065,40-44,1215,1270,2485
25053,42065,45-49,1215,1252,2467
25054,42065,50-54,1423,1481,2904
25055,42065,55-59,1502,1568,3070
25056,42065,60-64,1779,1816,3595
25057,42065,65+,5106,4451,9557
25058,42067,15-19,728,765,1493
25059,42067,20-24,610,618,1228
25060,42067,25-29,595,665,1260
25061,42067,30-34,651,665,1316
25062,42067,35-39,643,674,1317
25063,42067,40-44,648,713,1361
25064,42067,45-49,651,645,1296
25065,42067,50-54,744,825,1569
25066,42067,55-59,821,892,1713
25067,42067,60-64,859,863,1722
25068,42067,65+,2578,2339,4917
25069,42069,15-19,6805,7192,13997
25070,42069,20-24,6589,6389,12978
25071,42069,25-29,6161,6200,12361
25072,42069,30-34,6871,7018,13889
25073,42069,35-39,6551,6746,13297
25074,42069,40-44,6254,6289,12543
25075,42069,45-49,6143,6065,12208
25076,42069,50-54,7060,7008,14068
25077,42069,55-59,7584,7178,14762
25078,42069,60-64,7866,7510,15376
25079,42069,65+,24526,19207,43733
25080,42071,15-19,17922,18718,36640
25081,42071,20-24,16754,16846,33600
25082,42071,25-29,17692,17655,35347
25083,42071,30-34,18564,18390,36954
25084,42071,35-39,17026,17273,34299
25085,42071,40-44,15923,15699,31622
25086,42071,45-49,14884,14854,29738
25087,42071,50-54,16150,16182,32332
25088,42071,55-59,18125,17550,35675
25089,42071,60-64,18544,17606,36150
25090,42071,65+,57028,47209,104237
25091,42073,15-19,2559,2606,5165
25092,42073,20-24,2327,2398,4725
25093,42073,25-29,2305,2452,4757
25094,42073,30-34,2257,2480,4737
25095,42073,35-39,2339,2296,4635
25096,42073,40-44,2481,2388,4869
25097,42073,45-49,2355,2369,4724
25098,42073,50-54,2848,2837,5685
25099,42073,55-59,3028,2928,5956
25100,42073,60-64,3488,3331,6819
25101,42073,65+,10842,8633,19475
25102,42075,15-19,4427,4761,9188
25103,42075,20-24,4250,4361,8611
25104,42075,25-29,4020,4101,8121
25105,42075,30-34,4292,4370,8662
25106,42075,35-39,4337,4361,8698
25107,42075,40-44,4283,4325,8608
25108,42075,45-49,4060,4212,8272
25109,42075,50-54,4258,4465,8723
25110,42075,55-59,4911,4797,9708
25111,42075,60-64,4900,4748,9648
25112,42075,65+,15534,12972,28506
25113,42077,15-19,12233,12799,25032
25114,42077,20-24,11980,11750,23730
25115,42077,25-29,11896,11885,23781
25116,42077,30-34,12549,12654,25203
25117,42077,35-39,12290,12590,24880
25118,42077,40-44,11910,12110,24020
25119,42077,45-49,11136,11005,22141
25120,42077,50-54,11838,11599,23437
25121,42077,55-59,12362,12082,24444
25122,42077,60-64,12373,11952,24325
25123,42077,65+,35781,28484,64265
25124,42079,15-19,9710,10438,20148
25125,42079,20-24,9468,10094,19562
25126,42079,25-29,9389,10555,19944
25127,42079,30-34,10065,11345,21410
25128,42079,35-39,9406,10586,19992
25129,42079,40-44,9343,9838,19181
25130,42079,45-49,9535,9667,19202
25131,42079,50-54,10769,11114,21883
25132,42079,55-59,11334,11760,23094
25133,42079,60-64,11497,11186,22683
25134,42079,65+,36212,28691,64903
25135,42081,15-19,3528,3848,7376
25136,42081,20-24,3377,3468,6845
25137,42081,25-29,3404,3312,6716
25138,42081,30-34,3713,3935,7648
25139,42081,35-39,3570,3502,7072
25140,42081,40-44,3256,3182,6438
25141,42081,45-49,3226,2954,6180
25142,42081,50-54,3596,3495,7091
25143,42081,55-59,3878,3882,7760
25144,42081,60-64,4224,4117,8341
25145,42081,65+,12443,10391,22834
25146,42083,15-19,1269,1420,2689
25147,42083,20-24,1135,1256,2391
25148,42083,25-29,1014,1331,2345
25149,42083,30-34,1034,1407,2441
25150,42083,35-39,1041,1356,2397
25151,42083,40-44,1061,1191,2252
25152,42083,45-49,1154,1273,2427
25153,42083,50-54,1271,1420,2691
25154,42083,55-59,1363,1442,2805
25155,42083,60-64,1571,1545,3116
25156,42083,65+,4309,3730,8039
25157,42085,15-19,3361,3871,7232
25158,42085,20-24,3476,3735,7211
25159,42085,25-29,2868,3161,6029
25160,42085,30-34,2814,3027,5841
25161,42085,35-39,3000,3095,6095
25162,42085,40-44,2869,3052,5921
25163,42085,45-49,3056,3200,6256
25164,42085,50-54,3603,3640,7243
25165,42085,55-59,3928,4068,7996
25166,42085,60-64,4374,4141,8515
25167,42085,65+,13763,11071,24834
25168,42087,15-19,1298,1383,2681
25169,42087,20-24,1173,1214,2387
25170,42087,25-29,1265,1357,2622
25171,42087,30-34,1273,1352,2625
25172,42087,35-39,1202,1274,2476
25173,42087,40-44,1278,1218,2496
25174,42087,45-49,1254,1231,2485
25175,42087,50-54,1544,1508,3052
25176,42087,55-59,1630,1705,3335
25177,42087,60-64,1610,1627,3237
25178,42087,65+,5551,4505,10056
25179,42089,15-19,5898,5912,11810
25180,42089,20-24,5614,5800,11414
25181,42089,25-29,4600,5219,9819
25182,42089,30-34,4629,5130,9759
25183,42089,35-39,4684,4815,9499
25184,42089,40-44,5015,4633,9648
25185,42089,45-49,5174,4814,9988
25186,42089,50-54,6156,6076,12232
25187,42089,55-59,6956,7081,14037
25188,42089,60-64,6700,6770,13470
25189,42089,65+,16251,14983,31234
25190,42091,15-19,26611,26932,53543
25191,42091,20-24,23913,23691,47604
25192,42091,25-29,24830,26059,50889
25193,42091,30-34,27654,28137,55791
25194,42091,35-39,29447,29742,59189
25195,42091,40-44,27799,27950,55749
25196,42091,45-49,25771,25866,51637
25197,42091,50-54,28994,28530,57524
25198,42091,55-59,30823,29435,60258
25199,42091,60-64,30953,29289,60242
25200,42091,65+,88454,69440,157894
25201,42093,15-19,414,600,1014
25202,42093,20-24,391,386,777
25203,42093,25-29,539,510,1049
25204,42093,30-34,621,696,1317
25205,42093,35-39,562,622,1184
25206,42093,40-44,486,521,1007
25207,42093,45-49,476,476,952
25208,42093,50-54,555,529,1084
25209,42093,55-59,651,606,1257
25210,42093,60-64,726,690,1416
25211,42093,65+,2306,1671,3977
25212,42095,15-19,10454,11325,21779
25213,42095,20-24,9720,10724,20444
25214,42095,25-29,8887,9463,18350
25215,42095,30-34,9603,10009,19612
25216,42095,35-39,9370,9861,19231
25217,42095,40-44,9414,9208,18622
25218,42095,45-49,9267,9155,18422
25219,42095,50-54,10372,10543,20915
25220,42095,55-59,11135,11147,22282
25221,42095,60-64,11435,10864,22299
25222,42095,65+,34268,27779,62047
25223,42097,15-19,2308,2678,4986
25224,42097,20-24,2160,2607,4767
25225,42097,25-29,2490,2914,5404
25226,42097,30-34,2611,3013,5624
25227,42097,35-39,2663,2930,5593
25228,42097,40-44,2514,2834,5348
25229,42097,45-49,2494,2772,5266
25230,42097,50-54,2863,3159,6022
25231,42097,55-59,3315,3428,6743
25232,42097,60-64,3458,3363,6821
25233,42097,65+,10908,9107,20015
25234,42099,15-19,1165,1463,2628
25235,42099,20-24,1061,1177,2238
25236,42099,25-29,1273,1350,2623
25237,42099,30-34,1351,1472,2823
25238,42099,35-39,1359,1382,2741
25239,42099,40-44,1326,1446,2772
25240,42099,45-49,1351,1375,2726
25241,42099,50-54,1606,1677,3283
25242,42099,55-59,1716,1862,3578
25243,42099,60-64,1751,1761,3512
25244,42099,65+,4739,4344,9083
25245,42101,15-19,47843,47833,95676
25246,42101,20-24,52846,50447,103293
25247,42101,25-29,74567,68456,143023
25248,42101,30-34,78607,74211,152818
25249,42101,35-39,59991,56871,116862
25250,42101,40-44,50383,45340,95723
25251,42101,45-49,43215,39425,82640
25252,42101,50-54,46619,42576,89195
25253,42101,55-59,48640,42999,91639
25254,42101,60-64,49290,41627,90917
25255,42101,65+,134193,93174,227367
25256,42103,15-19,1591,1775,3366
25257,42103,20-24,1392,1599,2991
25258,42103,25-29,1412,1563,2975
25259,42103,30-34,1466,1690,3156
25260,42103,35-39,1473,1632,3105
25261,42103,40-44,1643,1765,3408
25262,42103,45-49,1776,1670,3446
25263,42103,50-54,2160,2206,4366
25264,42103,55-59,2650,2720,5370
25265,42103,60-64,2619,2798,5417
25266,42103,65+,7189,6888,14077
25267,42105,15-19,429,503,932
25268,42105,20-24,365,407,772
25269,42105,25-29,394,433,827
25270,42105,30-34,396,409,805
25271,42105,35-39,397,422,819
25272,42105,40-44,420,445,865
25273,42105,45-49,425,412,837
25274,42105,50-54,513,532,1045
25275,42105,55-59,620,631,1251
25276,42105,60-64,671,675,1346
25277,42105,65+,2150,1930,4080
25278,42107,15-19,3831,4330,8161
25279,42107,20-24,3423,4093,7516
25280,42107,25-29,3630,4837,8467
25281,42107,30-34,3780,4913,8693
25282,42107,35-39,3998,4768,8766
25283,42107,40-44,3955,4717,8672
25284,42107,45-49,4049,4870,8919
25285,42107,50-54,4791,5337,10128
25286,42107,55-59,5042,5449,10491
25287,42107,60-64,5219,5355,10574
25288,42107,65+,16181,13517,29698
25289,42109,15-19,1633,1707,3340
25290,42109,20-24,1424,1448,2872
25291,42109,25-29,998,1039,2037
25292,42109,30-34,1137,1190,2327
25293,42109,35-39,1074,1106,2180
25294,42109,40-44,1032,1058,2090
25295,42109,45-49,1117,1123,2240
25296,42109,50-54,1277,1301,2578
25297,42109,55-59,1388,1416,2804
25298,42109,60-64,1315,1361,2676
25299,42109,65+,4260,3598,7858
25300,42111,15-19,1764,1949,3713
25301,42111,20-24,1612,2199,3811
25302,42111,25-29,1692,2516,4208
25303,42111,30-34,1755,2467,4222
25304,42111,35-39,1835,2476,4311
25305,42111,40-44,1898,2526,4424
25306,42111,45-49,2063,2582,4645
25307,42111,50-54,2266,2746,5012
25308,42111,55-59,2623,2835,5458
25309,42111,60-64,2912,3031,5943
25310,42111,65+,9012,8015,17027
25311,42113,15-19,85,181,266
25312,42113,20-24,100,160,260
25313,42113,25-29,117,149,266
25314,42113,30-34,146,156,302
25315,42113,35-39,144,160,304
25316,42113,40-44,158,166,324
25317,42113,45-49,155,172,327
25318,42113,50-54,178,223,401
25319,42113,55-59,266,272,538
25320,42113,60-64,337,338,675
25321,42113,65+,898,838,1736
25322,42115,15-19,955,1067,2022
25323,42115,20-24,887,949,1836
25324,42115,25-29,845,1062,1907
25325,42115,30-34,979,984,1963
25326,42115,35-39,994,1089,2083
25327,42115,40-44,1044,1014,2058
25328,42115,45-49,991,1048,2039
25329,42115,50-54,1241,1314,2555
25330,42115,55-59,1512,1596,3108
25331,42115,60-64,1701,1808,3509
25332,42115,65+,4897,4548,9445
25333,42117,15-19,1294,1265,2559
25334,42117,20-24,1121,1106,2227
25335,42117,25-29,1061,1089,2150
25336,42117,30-34,1099,1164,2263
25337,42117,35-39,1181,1134,2315
25338,42117,40-44,1102,1154,2256
25339,42117,45-49,1080,1087,2167
25340,42117,50-54,1285,1329,2614
25341,42117,55-59,1515,1460,2975
25342,42117,60-64,1667,1642,3309
25343,42117,65+,4830,4587,9417
25344,42119,15-19,1821,1766,3587
25345,42119,20-24,1611,2031,3642
25346,42119,25-29,887,1517,2404
25347,42119,30-34,1000,1929,2929
25348,42119,35-39,1083,1917,3000
25349,42119,40-44,1015,1677,2692
25350,42119,45-49,1010,1464,2474
25351,42119,50-54,1119,1459,2578
25352,42119,55-59,1218,1427,2645
25353,42119,60-64,1259,1316,2575
25354,42119,65+,4403,3563,7966
25355,42121,15-19,1252,1517,2769
25356,42121,20-24,1176,1239,2415
25357,42121,25-29,1156,1313,2469
25358,42121,30-34,1278,1299,2577
25359,42121,35-39,1377,1350,2727
25360,42121,40-44,1413,1397,2810
25361,42121,45-49,1369,1473,2842
25362,42121,50-54,1652,1669,3321
25363,42121,55-59,1922,1928,3850
25364,42121,60-64,2275,2238,4513
25365,42121,65+,6482,5569,12051
25366,42123,15-19,943,1063,2006
25367,42123,20-24,852,976,1828
25368,42123,25-29,919,1031,1950
25369,42123,30-34,940,1009,1949
25370,42123,35-39,1031,1065,2096
25371,42123,40-44,986,1030,2016
25372,42123,45-49,1043,1005,2048
25373,42123,50-54,1268,1372,2640
25374,42123,55-59,1459,1528,2987
25375,42123,60-64,1600,1613,3213
25376,42123,65+,4828,4373,9201
25377,42125,15-19,6152,6284,12436
25378,42125,20-24,5694,6004,11698
25379,42125,25-29,5486,5738,11224
25380,42125,30-34,6085,6418,12503
25381,42125,35-39,6187,6381,12568
25382,42125,40-44,6161,6369,12530
25383,42125,45-49,5993,6202,12195
25384,42125,50-54,7011,7034,14045
25385,42125,55-59,7653,7630,15283
25386,42125,60-64,8377,7945,16322
25387,42125,65+,24402,20319,44721
25388,42127,15-19,1145,1313,2458
25389,42127,20-24,1123,1410,2533
25390,42127,25-29,1161,1628,2789
25391,42127,30-34,1221,1838,3059
25392,42127,35-39,1286,1759,3045
25393,42127,40-44,1229,1706,2935
25394,42127,45-49,1286,1704,2990
25395,42127,50-54,1604,1963,3567
25396,42127,55-59,1965,2092,4057
25397,42127,60-64,2112,2348,4460
25398,42127,65+,6535,6234,12769
25399,42129,15-19,9410,10229,19639
25400,42129,20-24,8841,9407,18248
25401,42129,25-29,9129,9763,18892
25402,42129,30-34,9457,9831,19288
25403,42129,35-39,9827,10228,20055
25404,42129,40-44,9817,10228,20045
25405,42129,45-49,10075,10143,20218
25406,42129,50-54,12328,12327,24655
25407,42129,55-59,13572,13225,26797
25408,42129,60-64,14949,14648,29597
25409,42129,65+,45747,37758,83505
25410,42131,15-19,758,888,1646
25411,42131,20-24,748,781,1529
25412,42131,25-29,661,719,1380
25413,42131,30-34,674,739,1413
25414,42131,35-39,730,760,1490
25415,42131,40-44,751,712,1463
25416,42131,45-49,777,790,1567
25417,42131,50-54,850,874,1724
25418,42131,55-59,946,992,1938
25419,42131,60-64,1034,976,2010
25420,42131,65+,3011,2832,5843
25421,42133,15-19,14129,15069,29198
25422,42133,20-24,12320,13240,25560
25423,42133,25-29,13544,14073,27617
25424,42133,30-34,14548,14987,29535
25425,42133,35-39,14708,14659,29367
25426,42133,40-44,14030,14137,28167
25427,42133,45-49,13687,13571,27258
25428,42133,50-54,15513,15930,31443
25429,42133,55-59,16327,16230,32557
25430,42133,60-64,16236,15850,32086
25431,42133,65+,45392,38335,83727
25432,44001,15-19,1956,1943,3899
25433,44001,20-24,1765,1743,3508
25434,44001,25-29,1153,1266,2419
25435,44001,30-34,1373,1382,2755
25436,44001,35-39,1545,1440,2985
25437,44001,40-44,1505,1439,2944
25438,44001,45-49,1574,1471,3045
25439,44001,50-54,1836,1733,3569
25440,44001,55-59,2038,1868,3906
25441,44001,60-64,2093,1923,4016
25442,44001,65+,5739,4749,10488
25443,44003,15-19,4267,4647,8914
25444,44003,20-24,4256,4432,8688
25445,44003,25-29,5407,5568,10975
25446,44003,30-34,5981,6024,12005
25447,44003,35-39,5624,5791,11415
25448,44003,40-44,5322,5306,10628
25449,44003,45-49,5077,4961,10038
25450,44003,50-54,6176,5966,12142
25451,44003,55-59,6926,6351,13277
25452,44003,60-64,6976,6308,13284
25453,44003,65+,18983,14800,33783
25454,44005,15-19,2489,2560,5049
25455,44005,20-24,2504,2807,5311
25456,44005,25-29,2434,2992,5426
25457,44005,30-34,2555,2694,5249
25458,44005,35-39,2372,2605,4977
25459,44005,40-44,2258,2297,4555
25460,44005,45-49,2212,2268,4480
25461,44005,50-54,2818,2695,5513
25462,44005,55-59,3402,3199,6601
25463,44005,60-64,3451,3253,6704
25464,44005,65+,10896,9255,20151
25465,44007,15-19,22238,22319,44557
25466,44007,20-24,23169,23120,46289
25467,44007,25-29,24035,24356,48391
25468,44007,30-34,25673,26675,52348
25469,44007,35-39,22150,22941,45091
25470,44007,40-44,19967,20355,40322
25471,44007,45-49,19026,18511,37537
25472,44007,50-54,21442,20610,42052
25473,44007,55-59,22451,21545,43996
25474,44007,60-64,21806,20284,42090
25475,44007,65+,59272,45939,105211
25476,44009,15-19,5667,5058,10725
25477,44009,20-24,5912,5973,11885
25478,44009,25-29,3174,3536,6710
25479,44009,30-34,3221,3253,6474
25480,44009,35-39,3207,3264,6471
25481,44009,40-44,3332,3255,6587
25482,44009,45-49,3296,3209,6505
25483,44009,50-54,4488,4103,8591
25484,44009,55-59,5415,5017,10432
25485,44009,60-64,5681,5252,10933
25486,44009,65+,15750,13408,29158
25487,45001,15-19,804,780,1584
25488,45001,20-24,759,779,1538
25489,45001,25-29,640,674,1314
25490,45001,30-34,693,634,1327
25491,45001,35-39,648,604,1252
25492,45001,40-44,684,629,1313
25493,45001,45-49,682,700,1382
25494,45001,50-54,852,775,1627
25495,45001,55-59,857,845,1702
25496,45001,60-64,946,862,1808
25497,45001,65+,3057,2513,5570
25498,45003,15-19,5150,5189,10339
25499,45003,20-24,4868,4668,9536
25500,45003,25-29,5205,5171,10376
25501,45003,30-34,5774,5299,11073
25502,45003,35-39,5353,5054,10407
25503,45003,40-44,5090,4849,9939
25504,45003,45-49,4954,4580,9534
25505,45003,50-54,5549,5141,10690
25506,45003,55-59,6141,5797,11938
25507,45003,60-64,6257,5895,12152
25508,45003,65+,19222,15672,34894
25509,45005,15-19,213,215,428
25510,45005,20-24,200,307,507
25511,45005,25-29,227,356,583
25512,45005,30-34,173,316,489
25513,45005,35-39,197,287,484
25514,45005,40-44,196,253,449
25515,45005,45-49,193,244,437
25516,45005,50-54,257,281,538
25517,45005,55-59,263,268,531
25518,45005,60-64,279,233,512
25519,45005,65+,979,736,1715
25520,45007,15-19,6509,6633,13142
25521,45007,20-24,6053,6024,12077
25522,45007,25-29,6496,6207,12703
25523,45007,30-34,6861,6286,13147
25524,45007,35-39,6428,5859,12287
25525,45007,40-44,6522,6059,12581
25526,45007,45-49,6419,6136,12555
25527,45007,50-54,7018,6858,13876
25528,45007,55-59,7315,6863,14178
25529,45007,60-64,7195,6737,13932
25530,45007,65+,21166,16893,38059
25531,45009,15-19,493,497,990
25532,45009,20-24,509,550,1059
25533,45009,25-29,322,384,706
25534,45009,30-34,370,337,707
25535,45009,35-39,319,297,616
25536,45009,40-44,327,312,639
25537,45009,45-49,376,324,700
25538,45009,50-54,414,371,785
25539,45009,55-59,531,454,985
25540,45009,60-64,487,449,936
25541,45009,65+,1767,1327,3094
25542,45011,15-19,673,667,1340
25543,45011,20-24,565,595,1160
25544,45011,25-29,635,638,1273
25545,45011,30-34,613,596,1209
25546,45011,35-39,534,465,999
25547,45011,40-44,628,549,1177
25548,45011,45-49,622,580,1202
25549,45011,50-54,651,578,1229
25550,45011,55-59,770,693,1463
25551,45011,60-64,769,654,1423
25552,45011,65+,2248,1749,3997
25553,45013,15-19,5070,6004,11074
25554,45013,20-24,4900,6404,11304
25555,45013,25-29,5002,5210,10212
25556,45013,30-34,5042,4845,9887
25557,45013,35-39,4917,4808,9725
25558,45013,40-44,4844,4570,9414
25559,45013,45-49,4816,4456,9272
25560,45013,50-54,5426,4929,10355
25561,45013,55-59,6866,5824,12690
25562,45013,60-64,8172,6789,14961
25563,45013,65+,29072,25491,54563
25564,45015,15-19,7156,8619,15775
25565,45015,20-24,6577,8562,15139
25566,45015,25-29,7809,8089,15898
25567,45015,30-34,8988,8508,17496
25568,45015,35-39,8787,8406,17193
25569,45015,40-44,7939,7638,15577
25570,45015,45-49,7277,6978,14255
25571,45015,50-54,7460,7057,14517
25572,45015,55-59,7683,7323,15006
25573,45015,60-64,7451,6796,14247
25574,45015,65+,19040,15922,34962
25575,45017,15-19,373,391,764
25576,45017,20-24,358,341,699
25577,45017,25-29,370,410,780
25578,45017,30-34,407,351,758
25579,45017,35-39,391,371,762
25580,45017,40-44,380,397,777
25581,45017,45-49,435,361,796
25582,45017,50-54,513,471,984
25583,45017,55-59,572,516,1088
25584,45017,60-64,592,573,1165
25585,45017,65+,1885,1533,3418
25586,45019,15-19,11583,11682,23265
25587,45019,20-24,12321,12931,25252
25588,45019,25-29,15885,14968,30853
25589,45019,30-34,17639,16636,34275
25590,45019,35-39,15867,15589,31456
25591,45019,40-44,13703,13475,27178
25592,45019,45-49,11594,11512,23106
25593,45019,50-54,12633,12082,24715
25594,45019,55-59,14172,12516,26688
25595,45019,60-64,14650,12614,27264
25596,45019,65+,39832,31981,71813
25597,45021,15-19,1812,1975,3787
25598,45021,20-24,1688,1759,3447
25599,45021,25-29,1837,1740,3577
25600,45021,30-34,1903,1811,3714
25601,45021,35-39,1596,1504,3100
25602,45021,40-44,1719,1527,3246
25603,45021,45-49,1837,1708,3545
25604,45021,50-54,1937,1959,3896
25605,45021,55-59,1903,1947,3850
25606,45021,60-64,1850,1789,3639
25607,45021,65+,5379,4351,9730
25608,45023,15-19,944,1015,1959
25609,45023,20-24,879,900,1779
25610,45023,25-29,983,946,1929
25611,45023,30-34,1079,968,2047
25612,45023,35-39,915,820,1735
25613,45023,40-44,972,827,1799
25614,45023,45-49,941,882,1823
25615,45023,50-54,1148,1089,2237
25616,45023,55-59,1216,1199,2415
25617,45023,60-64,1173,1083,2256
25618,45023,65+,3444,2790,6234
25619,45025,15-19,1256,1317,2573
25620,45025,20-24,1209,1277,2486
25621,45025,25-29,1344,1352,2696
25622,45025,30-34,1308,1264,2572
25623,45025,35-39,1145,1115,2260
25624,45025,40-44,1281,1200,2481
25625,45025,45-49,1340,1342,2682
25626,45025,50-54,1575,1570,3145
25627,45025,55-59,1656,1560,3216
25628,45025,60-64,1535,1442,2977
25629,45025,65+,4609,3746,8355
25630,45027,15-19,821,1009,1830
25631,45027,20-24,748,1160,1908
25632,45027,25-29,808,922,1730
25633,45027,30-34,868,808,1676
25634,45027,35-39,870,751,1621
25635,45027,40-44,835,822,1657
25636,45027,45-49,807,798,1605
25637,45027,50-54,1011,907,1918
25638,45027,55-59,1192,1075,2267
25639,45027,60-64,1330,1127,2457
25640,45027,65+,4302,3475,7777
25641,45029,15-19,1139,1121,2260
25642,45029,20-24,1032,1050,2082
25643,45029,25-29,1168,1146,2314
25644,45029,30-34,1151,1056,2207
25645,45029,35-39,1130,974,2104
25646,45029,40-44,1085,999,2084
25647,45029,45-49,1109,1037,2146
25648,45029,50-54,1299,1122,2421
25649,45029,55-59,1497,1383,2880
25650,45029,60-64,1451,1383,2834
25651,45029,65+,4290,3609,7899
25652,45031,15-19,2065,2022,4087
25653,45031,20-24,1958,1808,3766
25654,45031,25-29,2082,1884,3966
25655,45031,30-34,1926,1821,3747
25656,45031,35-39,1779,1551,3330
25657,45031,40-44,1878,1655,3533
25658,45031,45-49,2075,1783,3858
25659,45031,50-54,2037,1882,3919
25660,45031,55-59,2301,2070,4371
25661,45031,60-64,2284,1951,4235
25662,45031,65+,7066,5454,12520
25663,45033,15-19,952,973,1925
25664,45033,20-24,842,805,1647
25665,45033,25-29,902,810,1712
25666,45033,30-34,946,815,1761
25667,45033,35-39,826,749,1575
25668,45033,40-44,922,807,1729
25669,45033,45-49,847,737,1584
25670,45033,50-54,890,803,1693
25671,45033,55-59,995,831,1826
25672,45033,60-64,985,861,1846
25673,45033,65+,2798,2121,4919
25674,45035,15-19,5098,5447,10545
25675,45035,20-24,4541,4608,9149
25676,45035,25-29,5244,5290,10534
25677,45035,30-34,6005,5824,11829
25678,45035,35-39,6142,5829,11971
25679,45035,40-44,5777,5428,11205
25680,45035,45-49,5155,4875,10030
25681,45035,50-54,5350,5214,10564
25682,45035,55-59,5544,5256,10800
25683,45035,60-64,5236,4906,10142
25684,45035,65+,13477,10889,24366
25685,45037,15-19,674,811,1485
25686,45037,20-24,622,911,1533
25687,45037,25-29,703,988,1691
25688,45037,30-34,723,1153,1876
25689,45037,35-39,649,1082,1731
25690,45037,40-44,711,967,1678
25691,45037,45-49,708,885,1593
25692,45037,50-54,860,979,1839
25693,45037,55-59,927,992,1919
25694,45037,60-64,976,1007,1983
25695,45037,65+,2803,2432,5235
25696,45039,15-19,519,594,1113
25697,45039,20-24,564,558,1122
25698,45039,25-29,601,556,1157
25699,45039,30-34,626,495,1121
25700,45039,35-39,517,485,1002
25701,45039,40-44,561,511,1072
25702,45039,45-49,610,558,1168
25703,45039,50-54,750,703,1453
25704,45039,55-59,900,819,1719
25705,45039,60-64,989,836,1825
25706,45039,65+,2640,2256,4896
25707,45041,15-19,4420,4554,8974
25708,45041,20-24,4586,4092,8678
25709,45041,25-29,4407,3892,8299
25710,45041,30-34,4688,4025,8713
25711,45041,35-39,4333,3850,8183
25712,45041,40-44,4539,4042,8581
25713,45041,45-49,4476,3658,8134
25714,45041,50-54,4626,4145,8771
25715,45041,55-59,4824,4125,8949
25716,45041,60-64,4639,3998,8637
25717,45041,65+,13829,10339,24168
25718,45043,15-19,1604,1686,3290
25719,45043,20-24,1463,1612,3075
25720,45043,25-29,1437,1495,2932
25721,45043,30-34,1540,1451,2991
25722,45043,35-39,1483,1385,2868
25723,45043,40-44,1722,1410,3132
25724,45043,45-49,1762,1510,3272
25725,45043,50-54,2137,1898,4035
25726,45043,55-59,2615,2145,4760
25727,45043,60-64,3077,2556,5633
25728,45043,65+,10371,8729,19100
25729,45045,15-19,16690,16926,33616
25730,45045,20-24,16825,16041,32866
25731,45045,25-29,18522,17723,36245
25732,45045,30-34,19357,18441,37798
25733,45045,35-39,18174,17694,35868
25734,45045,40-44,17336,16801,34137
25735,45045,45-49,16593,15916,32509
25736,45045,50-54,17374,16911,34285
25737,45045,55-59,17637,16777,34414
25738,45045,60-64,17333,15751,33084
25739,45045,65+,48928,39164,88092
25740,45047,15-19,2429,2238,4667
25741,45047,20-24,2298,2078,4376
25742,45047,25-29,2252,1983,4235
25743,45047,30-34,2431,1951,4382
25744,45047,35-39,2098,1897,3995
25745,45047,40-44,2063,1824,3887
25746,45047,45-49,2049,1847,3896
25747,45047,50-54,2300,2147,4447
25748,45047,55-59,2415,2163,4578
25749,45047,60-64,2372,2074,4446
25750,45047,65+,7449,5849,13298
25751,45049,15-19,549,588,1137
25752,45049,20-24,512,491,1003
25753,45049,25-29,511,527,1038
25754,45049,30-34,555,605,1160
25755,45049,35-39,507,546,1053
25756,45049,40-44,541,550,1091
25757,45049,45-49,580,495,1075
25758,45049,50-54,609,583,1192
25759,45049,55-59,642,601,1243
25760,45049,60-64,637,588,1225
25761,45049,65+,2072,1682,3754
25762,45051,15-19,9489,9842,19331
25763,45051,20-24,8720,8401,17121
25764,45051,25-29,9648,9258,18906
25765,45051,30-34,10685,9819,20504
25766,45051,35-39,10129,9510,19639
25767,45051,40-44,10245,9834,20079
25768,45051,45-49,10417,9880,20297
25769,45051,50-54,12121,11164,23285
25770,45051,55-59,14759,12739,27498
25771,45051,60-64,17231,14592,31823
25772,45051,65+,50166,45247,95413
25773,45053,15-19,705,837,1542
25774,45053,20-24,842,1083,1925
25775,45053,25-29,930,1111,2041
25776,45053,30-34,777,989,1766
25777,45053,35-39,763,839,1602
25778,45053,40-44,765,797,1562
25779,45053,45-49,784,851,1635
25780,45053,50-54,912,886,1798
25781,45053,55-59,1244,1070,2314
25782,45053,60-64,1383,1269,2652
25783,45053,65+,3673,3204,6877
25784,45055,15-19,1987,2150,4137
25785,45055,20-24,1670,1752,3422
25786,45055,25-29,1821,1788,3609
25787,45055,30-34,2178,1946,4124
25788,45055,35-39,2083,2015,4098
25789,45055,40-44,2150,1942,4092
25790,45055,45-49,2045,1928,3973
25791,45055,50-54,2174,2148,4322
25792,45055,55-59,2422,2176,4598
25793,45055,60-64,2441,2204,4645
25794,45055,65+,6914,5700,12614
25795,45057,15-19,2532,2625,5157
25796,45057,20-24,2286,2351,4637
25797,45057,25-29,2577,2718,5295
25798,45057,30-34,3373,3196,6569
25799,45057,35-39,3436,3311,6747
25800,45057,40-44,3273,3397,6670
25801,45057,45-49,3206,3274,6480
25802,45057,50-54,3202,3245,6447
25803,45057,55-59,3384,3083,6467
25804,45057,60-64,3353,2989,6342
25805,45057,65+,11912,9671,21583
25806,45059,15-19,2088,2139,4227
25807,45059,20-24,2106,2115,4221
25808,45059,25-29,2042,2037,4079
25809,45059,30-34,2199,2043,4242
25810,45059,35-39,2007,1858,3865
25811,45059,40-44,1948,1827,3775
25812,45059,45-49,2005,1994,3999
25813,45059,50-54,2389,2204,4593
25814,45059,55-59,2544,2312,4856
25815,45059,60-64,2527,2330,4857
25816,45059,65+,7022,5688,12710
25817,45061,15-19,451,509,960
25818,45061,20-24,478,676,1154
25819,45061,25-29,414,724,1138
25820,45061,30-34,435,636,1071
25821,45061,35-39,412,527,939
25822,45061,40-44,465,525,990
25823,45061,45-49,432,518,950
25824,45061,50-54,502,471,973
25825,45061,55-59,594,567,1161
25826,45061,60-64,669,530,1199
25827,45061,65+,1855,1376,3231
25828,45063,15-19,9199,9658,18857
25829,45063,20-24,8064,8221,16285
25830,45063,25-29,9502,9298,18800
25831,45063,30-34,10685,10154,20839
25832,45063,35-39,10450,9893,20343
25833,45063,40-44,9923,9560,19483
25834,45063,45-49,9697,9234,18931
25835,45063,50-54,10068,10087,20155
25836,45063,55-59,10496,9939,20435
25837,45063,60-64,10188,9574,19762
25838,45063,65+,27645,22484,50129
25839,45065,15-19,151,155,306
25840,45065,20-24,139,224,363
25841,45065,25-29,158,336,494
25842,45065,30-34,143,349,492
25843,45065,35-39,156,314,470
25844,45065,40-44,186,283,469
25845,45065,45-49,204,291,495
25846,45065,50-54,253,329,582
25847,45065,55-59,364,387,751
25848,45065,60-64,514,476,990
25849,45065,65+,1787,1702,3489
25850,45067,15-19,882,918,1800
25851,45067,20-24,779,780,1559
25852,45067,25-29,899,830,1729
25853,45067,30-34,854,790,1644
25854,45067,35-39,872,662,1534
25855,45067,40-44,927,806,1733
25856,45067,45-49,914,762,1676
25857,45067,50-54,950,819,1769
25858,45067,55-59,1056,884,1940
25859,45067,60-64,1120,928,2048
25860,45067,65+,3585,2509,6094
25861,45069,15-19,683,699,1382
25862,45069,20-24,687,875,1562
25863,45069,25-29,712,1157,1869
25864,45069,30-34,694,1183,1877
25865,45069,35-39,657,1021,1678
25866,45069,40-44,739,907,1646
25867,45069,45-49,761,841,1602
25868,45069,50-54,803,865,1668
25869,45069,55-59,952,911,1863
25870,45069,60-64,919,917,1836
25871,45069,65+,2847,2143,4990
25872,45071,15-19,1238,1313,2551
25873,45071,20-24,1159,1304,2463
25874,45071,25-29,1048,1057,2105
25875,45071,30-34,1027,1064,2091
25876,45071,35-39,978,1010,1988
25877,45071,40-44,1065,1003,2068
25878,45071,45-49,1129,1126,2255
25879,45071,50-54,1238,1169,2407
25880,45071,55-59,1390,1301,2691
25881,45071,60-64,1438,1367,2805
25882,45071,65+,4260,3555,7815
25883,45073,15-19,2198,2210,4408
25884,45073,20-24,1955,2165,4120
25885,45073,25-29,2159,2223,4382
25886,45073,30-34,2258,2281,4539
25887,45073,35-39,2010,1996,4006
25888,45073,40-44,2074,2095,4169
25889,45073,45-49,2232,2197,4429
25890,45073,50-54,2622,2524,5146
25891,45073,55-59,2959,2885,5844
25892,45073,60-64,3404,3210,6614
25893,45073,65+,10059,9011,19070
25894,45075,15-19,2915,2970,5885
25895,45075,20-24,2907,2694,5601
25896,45075,25-29,2424,2219,4643
25897,45075,30-34,2558,2194,4752
25898,45075,35-39,2429,2013,4442
25899,45075,40-44,2306,2026,4332
25900,45075,45-49,2320,1927,4247
25901,45075,50-54,2652,2318,4970
25902,45075,55-59,3211,2779,5990
25903,45075,60-64,3075,2734,5809
25904,45075,65+,9817,7528,17345
25905,45077,15-19,5955,6242,12197
25906,45077,20-24,7140,8349,15489
25907,45077,25-29,4060,4251,8311
25908,45077,30-34,3854,3940,7794
25909,45077,35-39,3320,3429,6749
25910,45077,40-44,3575,3448,7023
25911,45077,45-49,3562,3532,7094
25912,45077,50-54,3984,3801,7785
25913,45077,55-59,4321,4204,8525
25914,45077,60-64,4266,4003,8269
25915,45077,65+,12290,10298,22588
25916,45079,15-19,16277,17516,33793
25917,45079,20-24,21314,23182,44496
25918,45079,25-29,16253,15559,31812
25919,45079,30-34,15318,14158,29476
25920,45079,35-39,14206,12983,27189
25921,45079,40-44,13435,11979,25414
25922,45079,45-49,12451,10984,23435
25923,45079,50-54,12567,11235,23802
25924,45079,55-59,12988,11311,24299
25925,45079,60-64,12628,10909,23537
25926,45079,65+,32546,24634,57180
25927,45081,15-19,474,576,1050
25928,45081,20-24,457,518,975
25929,45081,25-29,479,543,1022
25930,45081,30-34,492,518,1010
25931,45081,35-39,505,613,1118
25932,45081,40-44,533,549,1082
25933,45081,45-49,535,577,1112
25934,45081,50-54,633,641,1274
25935,45081,55-59,730,692,1422
25936,45081,60-64,679,688,1367
25937,45081,65+,2147,1860,4007
25938,45083,15-19,11020,11375,22395
25939,45083,20-24,10438,10347,20785
25940,45083,25-29,11506,11324,22830
25941,45083,30-34,12425,11625,24050
25942,45083,35-39,10713,10369,21082
25943,45083,40-44,10227,9909,20136
25944,45083,45-49,10268,9931,20199
25945,45083,50-54,11112,10919,22031
25946,45083,55-59,11246,11043,22289
25947,45083,60-64,10622,9910,20532
25948,45083,65+,30546,24352,54898
25949,45085,15-19,3280,3374,6654
25950,45085,20-24,3586,4217,7803
25951,45085,25-29,3595,3796,7391
25952,45085,30-34,3724,3502,7226
25953,45085,35-39,3247,3064,6311
25954,45085,40-44,3082,2747,5829
25955,45085,45-49,2790,2464,5254
25956,45085,50-54,3268,2771,6039
25957,45085,55-59,3458,3127,6585
25958,45085,60-64,3571,3173,6744
25959,45085,65+,10364,7629,17993
25960,45087,15-19,735,839,1574
25961,45087,20-24,711,716,1427
25962,45087,25-29,814,751,1565
25963,45087,30-34,926,735,1661
25964,45087,35-39,724,643,1367
25965,45087,40-44,811,740,1551
25966,45087,45-49,826,735,1561
25967,45087,50-54,954,927,1881
25968,45087,55-59,1081,944,2025
25969,45087,60-64,1065,984,2049
25970,45087,65+,3228,2425,5653
25971,45089,15-19,880,930,1810
25972,45089,20-24,845,828,1673
25973,45089,25-29,915,965,1880
25974,45089,30-34,780,979,1759
25975,45089,35-39,799,878,1677
25976,45089,40-44,905,841,1746
25977,45089,45-49,922,864,1786
25978,45089,50-54,1074,882,1956
25979,45089,55-59,1086,944,2030
25980,45089,60-64,1288,996,2284
25981,45089,65+,4004,2975,6979
25982,45091,15-19,9602,9705,19307
25983,45091,20-24,8166,7768,15934
25984,45091,25-29,8284,7816,16100
25985,45091,30-34,10039,8945,18984
25986,45091,35-39,10869,9823,20692
25987,45091,40-44,10731,10292,21023
25988,45091,45-49,10118,9762,19880
25989,45091,50-54,10186,10032,20218
25990,45091,55-59,9719,9281,19000
25991,45091,60-64,9134,8482,17616
25992,45091,65+,24002,19311,43313
25993,46003,15-19,88,98,186
25994,46003,20-24,68,66,134
25995,46003,25-29,71,74,145
25996,46003,30-34,60,85,145
25997,46003,35-39,79,107,186
25998,46003,40-44,81,82,163
25999,46003,45-49,61,64,125
26000,46003,50-54,75,78,153
26001,46003,55-59,81,99,180
26002,46003,60-64,106,98,204
26003,46003,65+,287,291,578
26004,46005,15-19,570,672,1242
26005,46005,20-24,472,511,983
26006,46005,25-29,582,529,1111
26007,46005,30-34,578,549,1127
26008,46005,35-39,542,587,1129
26009,46005,40-44,504,556,1060
26010,46005,45-49,480,494,974
26011,46005,50-54,527,533,1060
26012,46005,55-59,597,626,1223
26013,46005,60-64,661,657,1318
26014,46005,65+,1766,1583,3349
26015,46007,15-19,142,163,305
26016,46007,20-24,96,104,200
26017,46007,25-29,104,112,216
26018,46007,30-34,105,96,201
26019,46007,35-39,118,103,221
26020,46007,40-44,87,80,167
26021,46007,45-49,74,69,143
26022,46007,50-54,80,81,161
26023,46007,55-59,102,106,208
26024,46007,60-64,89,103,192
26025,46007,65+,237,216,453
26026,46009,15-19,179,207,386
26027,46009,20-24,136,347,483
26028,46009,25-29,121,375,496
26029,46009,30-34,122,308,430
26030,46009,35-39,173,333,506
26031,46009,40-44,124,307,431
26032,46009,45-49,138,293,431
26033,46009,50-54,147,246,393
26034,46009,55-59,197,250,447
26035,46009,60-64,200,284,484
26036,46009,65+,748,667,1415
26037,46011,15-19,1993,2023,4016
26038,46011,20-24,2891,3152,6043
26039,46011,25-29,970,1224,2194
26040,46011,30-34,900,1125,2025
26041,46011,35-39,934,1050,1984
26042,46011,40-44,829,937,1766
26043,46011,45-49,656,742,1398
26044,46011,50-54,694,721,1415
26045,46011,55-59,749,823,1572
26046,46011,60-64,789,825,1614
26047,46011,65+,2382,2132,4514
26048,46013,15-19,1346,1232,2578
26049,46013,20-24,1434,1181,2615
26050,46013,25-29,1118,1228,2346
26051,46013,30-34,1204,1242,2446
26052,46013,35-39,1136,1386,2522
26053,46013,40-44,1144,1143,2287
26054,46013,45-49,942,949,1891
26055,46013,50-54,1010,1100,2110
26056,46013,55-59,1155,1256,2411
26057,46013,60-64,1317,1219,2536
26058,46013,65+,3772,3056,6828
26059,46015,15-19,167,192,359
26060,46015,20-24,143,150,293
26061,46015,25-29,124,147,271
26062,46015,30-34,131,126,257
26063,46015,35-39,142,139,281
26064,46015,40-44,146,142,288
26065,46015,45-49,137,130,267
26066,46015,50-54,152,160,312
26067,46015,55-59,177,174,351
26068,46015,60-64,200,210,410
26069,46015,65+,514,487,1001
26070,46017,15-19,108,94,202
26071,46017,20-24,74,81,155
26072,46017,25-29,42,61,103
26073,46017,30-34,61,58,119
26074,46017,35-39,66,62,128
26075,46017,40-44,48,48,96
26076,46017,45-49,49,50,99
26077,46017,50-54,35,53,88
26078,46017,55-59,29,33,62
26079,46017,60-64,57,50,107
26080,46017,65+,90,88,178
26081,46019,15-19,307,367,674
26082,46019,20-24,246,251,497
26083,46019,25-29,304,307,611
26084,46019,30-34,305,313,618
26085,46019,35-39,293,298,591
26086,46019,40-44,289,328,617
26087,46019,45-49,235,263,498
26088,46019,50-54,290,294,584
26089,46019,55-59,338,333,671
26090,46019,60-64,411,395,806
26091,46019,65+,1071,1052,2123
26092,46021,15-19,37,27,64
26093,46021,20-24,23,28,51
26094,46021,25-29,28,35,63
26095,46021,30-34,25,30,55
26096,46021,35-39,29,32,61
26097,46021,40-44,41,35,76
26098,46021,45-49,18,26,44
26099,46021,50-54,35,29,64
26100,46021,55-59,60,77,137
26101,46021,60-64,69,79,148
26102,46021,65+,208,218,426
26103,46023,15-19,324,328,652
26104,46023,20-24,214,264,478
26105,46023,25-29,268,239,507
26106,46023,30-34,217,220,437
26107,46023,35-39,259,258,517
26108,46023,40-44,237,211,448
26109,46023,45-49,199,236,435
26110,46023,50-54,230,233,463
26111,46023,55-59,287,261,548
26112,46023,60-64,305,334,639
26113,46023,65+,872,806,1678
26114,46025,15-19,89,97,186
26115,46025,20-24,69,81,150
26116,46025,25-29,101,131,232
26117,46025,30-34,111,117,228
26118,46025,35-39,96,111,207
26119,46025,40-44,81,104,185
26120,46025,45-49,55,97,152
26121,46025,50-54,94,88,182
26122,46025,55-59,119,110,229
26123,46025,60-64,119,144,263
26124,46025,65+,451,407,858
26125,46027,15-19,983,780,1763
26126,46027,20-24,1707,1608,3315
26127,46027,25-29,515,583,1098
26128,46027,30-34,410,456,866
26129,46027,35-39,341,371,712
26130,46027,40-44,344,351,695
26131,46027,45-49,264,312,576
26132,46027,50-54,308,317,625
26133,46027,55-59,347,320,667
26134,46027,60-64,358,318,676
26135,46027,65+,949,927,1876
26136,46029,15-19,888,957,1845
26137,46029,20-24,761,908,1669
26138,46029,25-29,816,859,1675
26139,46029,30-34,849,879,1728
26140,46029,35-39,901,939,1840
26141,46029,40-44,842,896,1738
26142,46029,45-49,720,816,1536
26143,46029,50-54,820,895,1715
26144,46029,55-59,946,968,1914
26145,46029,60-64,1003,976,1979
26146,46029,65+,2812,2490,5302
26147,46031,15-19,186,197,383
26148,46031,20-24,120,105,225
26149,46031,25-29,104,96,200
26150,46031,30-34,99,124,223
26151,46031,35-39,97,100,197
26152,46031,40-44,113,95,208
26153,46031,45-49,81,97,178
26154,46031,50-54,73,93,166
26155,46031,55-59,109,107,216
26156,46031,60-64,127,101,228
26157,46031,65+,252,225,477
26158,46033,15-19,175,250,425
26159,46033,20-24,116,140,256
26160,46033,25-29,152,138,290
26161,46033,30-34,176,183,359
26162,46033,35-39,212,227,439
26163,46033,40-44,222,227,449
26164,46033,45-49,220,226,446
26165,46033,50-54,276,257,533
26166,46033,55-59,368,360,728
26167,46033,60-64,540,428,968
26168,46033,65+,1370,1410,2780
26169,46035,15-19,656,711,1367
26170,46035,20-24,620,686,1306
26171,46035,25-29,595,657,1252
26172,46035,30-34,545,655,1200
26173,46035,35-39,575,588,1163
26174,46035,40-44,573,604,1177
26175,46035,45-49,480,549,1029
26176,46035,50-54,482,516,998
26177,46035,55-59,602,629,1231
26178,46035,60-64,677,642,1319
26179,46035,65+,2210,1751,3961
26180,46037,15-19,155,172,327
26181,46037,20-24,113,126,239
26182,46037,25-29,110,129,239
26183,46037,30-34,131,123,254
26184,46037,35-39,110,141,251
26185,46037,40-44,152,150,302
26186,46037,45-49,105,137,242
26187,46037,50-54,129,148,277
26188,46037,55-59,188,185,373
26189,46037,60-64,225,236,461
26190,46037,65+,726,713,1439
26191,46039,15-19,112,151,263
26192,46039,20-24,85,103,188
26193,46039,25-29,117,104,221
26194,46039,30-34,115,120,235
26195,46039,35-39,101,136,237
26196,46039,40-44,109,131,240
26197,46039,45-49,102,123,225
26198,46039,50-54,112,121,233
26199,46039,55-59,146,159,305
26200,46039,60-64,151,182,333
26201,46039,65+,486,452,938
26202,46041,15-19,226,217,443
26203,46041,20-24,159,146,305
26204,46041,25-29,175,147,322
26205,46041,30-34,158,157,315
26206,46041,35-39,156,151,307
26207,46041,40-44,139,149,288
26208,46041,45-49,116,104,220
26209,46041,50-54,128,112,240
26210,46041,55-59,142,147,289
26211,46041,60-64,139,133,272
26212,46041,65+,284,250,534
26213,46043,15-19,90,103,193
26214,46043,20-24,51,67,118
26215,46043,25-29,69,80,149
26216,46043,30-34,64,58,122
26217,46043,35-39,59,89,148
26218,46043,40-44,66,71,137
26219,46043,45-49,56,50,106
26220,46043,50-54,82,69,151
26221,46043,55-59,86,99,185
26222,46043,60-64,108,114,222
26223,46043,65+,353,315,668
26224,46045,15-19,111,128,239
26225,46045,20-24,93,92,185
26226,46045,25-29,108,122,230
26227,46045,30-34,86,92,178
26228,46045,35-39,125,106,231
26229,46045,40-44,95,113,208
26230,46045,45-49,90,123,213
26231,46045,50-54,107,116,223
26232,46045,55-59,161,155,316
26233,46045,60-64,147,183,330
26234,46045,65+,478,434,912
26235,46047,15-19,187,197,384
26236,46047,20-24,131,144,275
26237,46047,25-29,145,152,297
26238,46047,30-34,177,155,332
26239,46047,35-39,162,154,316
26240,46047,40-44,178,196,374
26241,46047,45-49,193,211,404
26242,46047,50-54,201,238,439
26243,46047,55-59,288,262,550
26244,46047,60-64,346,340,686
26245,46047,65+,1079,1096,2175
26246,46049,15-19,73,57,130
26247,46049,20-24,51,53,104
26248,46049,25-29,49,61,110
26249,46049,30-34,58,48,106
26250,46049,35-39,48,50,98
26251,46049,40-44,54,64,118
26252,46049,45-49,51,42,93
26253,46049,50-54,50,56,106
26254,46049,55-59,59,69,128
26255,46049,60-64,73,82,155
26256,46049,65+,256,260,516
26257,46051,15-19,197,235,432
26258,46051,20-24,173,205,378
26259,46051,25-29,178,183,361
26260,46051,30-34,170,203,373
26261,46051,35-39,185,219,404
26262,46051,40-44,213,209,422
26263,46051,45-49,183,242,425
26264,46051,50-54,186,298,484
26265,46051,55-59,258,294,552
26266,46051,60-64,294,355,649
26267,46051,65+,855,790,1645
26268,46053,15-19,106,141,247
26269,46053,20-24,87,89,176
26270,46053,25-29,90,89,179
26271,46053,30-34,80,100,180
26272,46053,35-39,99,95,194
26273,46053,40-44,89,114,203
26274,46053,45-49,95,124,219
26275,46053,50-54,100,96,196
26276,46053,55-59,121,121,242
26277,46053,60-64,149,166,315
26278,46053,65+,543,482,1025
26279,46055,15-19,56,56,112
26280,46055,20-24,49,31,80
26281,46055,25-29,59,47,106
26282,46055,30-34,41,29,70
26283,46055,35-39,46,50,96
26284,46055,40-44,50,61,111
26285,46055,45-49,35,37,72
26286,46055,50-54,41,52,93
26287,46055,55-59,40,52,92
26288,46055,60-64,87,93,180
26289,46055,65+,249,232,481
26290,46057,15-19,252,270,522
26291,46057,20-24,175,170,345
26292,46057,25-29,172,204,376
26293,46057,30-34,152,197,349
26294,46057,35-39,137,174,311
26295,46057,40-44,164,186,350
26296,46057,45-49,150,177,327
26297,46057,50-54,135,175,310
26298,46057,55-59,180,174,354
26299,46057,60-64,164,197,361
26300,46057,65+,480,452,932
26301,46059,15-19,87,72,159
26302,46059,20-24,77,82,159
26303,46059,25-29,65,98,163
26304,46059,30-34,65,69,134
26305,46059,35-39,71,87,158
26306,46059,40-44,83,97,180
26307,46059,45-49,52,64,116
26308,46059,50-54,92,80,172
26309,46059,55-59,101,124,225
26310,46059,60-64,119,131,250
26311,46059,65+,441,382,823
26312,46061,15-19,148,141,289
26313,46061,20-24,80,89,169
26314,46061,25-29,78,79,157
26315,46061,30-34,77,74,151
26316,46061,35-39,116,88,204
26317,46061,40-44,109,139,248
26318,46061,45-49,97,95,192
26319,46061,50-54,98,114,212
26320,46061,55-59,117,117,234
26321,46061,60-64,129,140,269
26322,46061,65+,260,293,553
26323,46063,15-19,25,47,72
26324,46063,20-24,35,34,69
26325,46063,25-29,38,34,72
26326,46063,30-34,31,56,87
26327,46063,35-39,36,50,86
26328,46063,40-44,34,30,64
26329,46063,45-49,35,35,70
26330,46063,50-54,33,41,74
26331,46063,55-59,44,45,89
26332,46063,60-64,46,58,104
26333,46063,65+,137,144,281
26334,46065,15-19,500,513,1013
26335,46065,20-24,524,460,984
26336,46065,25-29,555,489,1044
26337,46065,30-34,599,550,1149
26338,46065,35-39,601,630,1231
26339,46065,40-44,555,505,1060
26340,46065,45-49,500,482,982
26341,46065,50-54,531,472,1003
26342,46065,55-59,603,564,1167
26343,46065,60-64,623,611,1234
26344,46065,65+,1611,1542,3153
26345,46067,15-19,220,213,433
26346,46067,20-24,172,169,341
26347,46067,25-29,181,190,371
26348,46067,30-34,185,174,359
26349,46067,35-39,198,218,416
26350,46067,40-44,187,193,380
26351,46067,45-49,197,191,388
26352,46067,50-54,187,241,428
26353,46067,55-59,203,233,436
26354,46067,60-64,266,292,558
26355,46067,65+,902,774,1676
26356,46069,15-19,29,46,75
26357,46069,20-24,25,32,57
26358,46069,25-29,35,33,68
26359,46069,30-34,37,43,80
26360,46069,35-39,21,26,47
26361,46069,40-44,35,34,69
26362,46069,45-49,25,32,57
26363,46069,50-54,38,19,57
26364,46069,55-59,46,41,87
26365,46069,60-64,40,58,98
26366,46069,65+,164,149,313
26367,46071,15-19,110,129,239
26368,46071,20-24,95,93,188
26369,46071,25-29,80,79,159
26370,46071,30-34,83,69,152
26371,46071,35-39,76,64,140
26372,46071,40-44,61,65,126
26373,46071,45-49,62,62,124
26374,46071,50-54,74,68,142
26375,46071,55-59,70,87,157
26376,46071,60-64,82,91,173
26377,46071,65+,191,193,384
26378,46073,15-19,38,49,87
26379,46073,20-24,28,26,54
26380,46073,25-29,41,44,85
26381,46073,30-34,36,41,77
26382,46073,35-39,47,48,95
26383,46073,40-44,46,50,96
26384,46073,45-49,27,52,79
26385,46073,50-54,40,38,78
26386,46073,55-59,50,48,98
26387,46073,60-64,54,63,117
26388,46073,65+,253,192,445
26389,46075,15-19,20,22,42
26390,46075,20-24,16,13,29
26391,46075,25-29,19,15,34
26392,46075,30-34,25,27,52
26393,46075,35-39,20,30,50
26394,46075,40-44,18,18,36
26395,46075,45-49,20,22,42
26396,46075,50-54,29,26,55
26397,46075,55-59,30,25,55
26398,46075,60-64,46,42,88
26399,46075,65+,98,127,225
26400,46077,15-19,132,165,297
26401,46077,20-24,110,126,236
26402,46077,25-29,139,148,287
26403,46077,30-34,114,147,261
26404,46077,35-39,132,137,269
26405,46077,40-44,153,155,308
26406,46077,45-49,114,145,259
26407,46077,50-54,127,115,242
26408,46077,55-59,171,183,354
26409,46077,60-64,184,234,418
26410,46077,65+,610,594,1204
26411,46079,15-19,388,444,832
26412,46079,20-24,318,428,746
26413,46079,25-29,206,280,486
26414,46079,30-34,219,263,482
26415,46079,35-39,278,307,585
26416,46079,40-44,255,308,563
26417,46079,45-49,230,249,479
26418,46079,50-54,247,295,542
26419,46079,55-59,362,374,736
26420,46079,60-64,501,467,968
26421,46079,65+,1298,1369,2667
26422,46081,15-19,921,913,1834
26423,46081,20-24,1023,963,1986
26424,46081,25-29,682,696,1378
26425,46081,30-34,703,802,1505
26426,46081,35-39,759,850,1609
26427,46081,40-44,682,789,1471
26428,46081,45-49,626,631,1257
26429,46081,50-54,707,737,1444
26430,46081,55-59,864,845,1709
26431,46081,60-64,1154,1035,2189
26432,46081,65+,3110,3070,6180
26433,46083,15-19,2162,2289,4451
26434,46083,20-24,1935,1860,3795
26435,46083,25-29,2383,2318,4701
26436,46083,30-34,2433,2379,4812
26437,46083,35-39,2591,2699,5290
26438,46083,40-44,2399,2486,4885
26439,46083,45-49,2056,2052,4108
26440,46083,50-54,1829,1884,3713
26441,46083,55-59,1862,1788,3650
26442,46083,60-64,1825,1747,3572
26443,46083,65+,5242,4430,9672
26444,46085,15-19,132,156,288
26445,46085,20-24,103,125,228
26446,46085,25-29,93,123,216
26447,46085,30-34,105,106,211
26448,46085,35-39,99,101,200
26449,46085,40-44,105,104,209
26450,46085,45-49,70,112,182
26451,46085,50-54,85,95,180
26452,46085,55-59,102,108,210
26453,46085,60-64,134,153,287
26454,46085,65+,325,328,653
26455,46087,15-19,191,188,379
26456,46087,20-24,139,162,301
26457,46087,25-29,134,154,288
26458,46087,30-34,151,146,297
26459,46087,35-39,154,187,341
26460,46087,40-44,148,178,326
26461,46087,45-49,152,150,302
26462,46087,50-54,142,182,324
26463,46087,55-59,155,175,330
26464,46087,60-64,176,226,402
26465,46087,65+,591,460,1051
26466,46089,15-19,66,63,129
26467,46089,20-24,46,48,94
26468,46089,25-29,45,59,104
26469,46089,30-34,57,44,101
26470,46089,35-39,64,66,130
26471,46089,40-44,41,69,110
26472,46089,45-49,57,52,109
26473,46089,50-54,60,63,123
26474,46089,55-59,72,78,150
26475,46089,60-64,87,103,190
26476,46089,65+,356,318,674
26477,46091,15-19,108,134,242
26478,46091,20-24,78,103,181
26479,46091,25-29,98,120,218
26480,46091,30-34,101,125,226
26481,46091,35-39,119,159,278
26482,46091,40-44,102,136,238
26483,46091,45-49,73,114,187
26484,46091,50-54,108,130,238
26485,46091,55-59,150,171,321
26486,46091,60-64,153,155,308
26487,46091,65+,472,503,975
26488,46093,15-19,871,1022,1893
26489,46093,20-24,917,1590,2507
26490,46093,25-29,914,1198,2112
26491,46093,30-34,1122,1095,2217
26492,46093,35-39,1071,1141,2212
26493,46093,40-44,945,943,1888
26494,46093,45-49,710,811,1521
26495,46093,50-54,790,783,1573
26496,46093,55-59,948,918,1866
26497,46093,60-64,1010,1035,2045
26498,46093,65+,2494,2421,4915
26499,46095,15-19,66,99,165
26500,46095,20-24,57,64,121
26501,46095,25-29,66,56,122
26502,46095,30-34,53,57,110
26503,46095,35-39,39,42,81
26504,46095,40-44,56,36,92
26505,46095,45-49,38,51,89
26506,46095,50-54,49,50,99
26507,46095,55-59,63,56,119
26508,46095,60-64,63,57,120
26509,46095,65+,132,159,291
26510,46097,15-19,78,87,165
26511,46097,20-24,56,65,121
26512,46097,25-29,59,79,138
26513,46097,30-34,49,45,94
26514,46097,35-39,50,63,113
26515,46097,40-44,59,52,111
26516,46097,45-49,47,59,106
26517,46097,50-54,56,48,104
26518,46097,55-59,88,110,198
26519,46097,60-64,104,101,205
26520,46097,65+,261,257,518
26521,46099,15-19,6205,6566,12771
26522,46099,20-24,6174,6339,12513
26523,46099,25-29,7023,7487,14510
26524,46099,30-34,7313,8015,15328
26525,46099,35-39,7133,7978,15111
26526,46099,40-44,6230,6982,13212
26527,46099,45-49,5180,5697,10877
26528,46099,50-54,5319,5792,11111
26529,46099,55-59,6008,6148,12156
26530,46099,60-64,6161,6097,12258
26531,46099,65+,14671,12595,27266
26532,46101,15-19,195,233,428
26533,46101,20-24,149,173,322
26534,46101,25-29,142,183,325
26535,46101,30-34,149,157,306
26536,46101,35-39,192,190,382
26537,46101,40-44,173,188,361
26538,46101,45-49,144,157,301
26539,46101,50-54,173,200,373
26540,46101,55-59,209,219,428
26541,46101,60-64,235,238,473
26542,46101,65+,649,585,1234
26543,46102,15-19,610,628,1238
26544,46102,20-24,522,507,1029
26545,46102,25-29,496,513,1009
26546,46102,30-34,526,500,1026
26547,46102,35-39,408,450,858
26548,46102,40-44,369,335,704
26549,46102,45-49,318,297,615
26550,46102,50-54,344,318,662
26551,46102,55-59,319,314,633
26552,46102,60-64,304,266,570
26553,46102,65+,612,388,1000
26554,46103,15-19,3136,3602,6738
26555,46103,20-24,2966,3411,6377
26556,46103,25-29,3406,3767,7173
26557,46103,30-34,3516,3727,7243
26558,46103,35-39,3369,3549,6918
26559,46103,40-44,3235,3359,6594
26560,46103,45-49,2875,2907,5782
26561,46103,50-54,2989,3064,6053
26562,46103,55-59,3727,3698,7425
26563,46103,60-64,4352,4376,8728
26564,46103,65+,11216,10367,21583
26565,46105,15-19,66,79,145
26566,46105,20-24,55,69,124
26567,46105,25-29,64,73,137
26568,46105,30-34,51,52,103
26569,46105,35-39,73,77,150
26570,46105,40-44,74,84,158
26571,46105,45-49,69,63,132
26572,46105,50-54,81,73,154
26573,46105,55-59,105,98,203
26574,46105,60-64,120,128,248
26575,46105,65+,373,383,756
26576,46107,15-19,70,73,143
26577,46107,20-24,54,50,104
26578,46107,25-29,60,46,106
26579,46107,30-34,61,55,116
26580,46107,35-39,51,51,102
26581,46107,40-44,62,76,138
26582,46107,45-49,41,45,86
26583,46107,50-54,78,68,146
26584,46107,55-59,86,81,167
26585,46107,60-64,90,126,216
26586,46107,65+,383,305,688
26587,46109,15-19,331,373,704
26588,46109,20-24,240,306,546
26589,46109,25-29,276,290,566
26590,46109,30-34,231,218,449
26591,46109,35-39,236,263,499
26592,46109,40-44,252,239,491
26593,46109,45-49,233,247,480
26594,46109,50-54,252,269,521
26595,46109,55-59,315,327,642
26596,46109,60-64,310,359,669
26597,46109,65+,1019,995,2014
26598,46111,15-19,60,70,130
26599,46111,20-24,46,64,110
26600,46111,25-29,62,58,120
26601,46111,30-34,53,72,125
26602,46111,35-39,65,90,155
26603,46111,40-44,74,76,150
26604,46111,45-49,46,70,116
26605,46111,50-54,57,48,105
26606,46111,55-59,79,84,163
26607,46111,60-64,93,101,194
26608,46111,65+,256,247,503
26609,46115,15-19,185,236,421
26610,46115,20-24,134,155,289
26611,46115,25-29,159,148,307
26612,46115,30-34,151,181,332
26613,46115,35-39,182,231,413
26614,46115,40-44,163,180,343
26615,46115,45-49,149,141,290
26616,46115,50-54,174,178,352
26617,46115,55-59,216,234,450
26618,46115,60-64,264,266,530
26619,46115,65+,735,662,1397
26620,46117,15-19,98,112,210
26621,46117,20-24,67,71,138
26622,46117,25-29,76,89,165
26623,46117,30-34,78,85,163
26624,46117,35-39,83,90,173
26625,46117,40-44,85,97,182
26626,46117,45-49,72,92,164
26627,46117,50-54,89,86,175
26628,46117,55-59,99,101,200
26629,46117,60-64,100,98,198
26630,46117,65+,348,332,680
26631,46119,15-19,40,45,85
26632,46119,20-24,30,33,63
26633,46119,25-29,32,35,67
26634,46119,30-34,31,33,64
26635,46119,35-39,30,41,71
26636,46119,40-44,38,44,82
26637,46119,45-49,34,34,68
26638,46119,50-54,42,40,82
26639,46119,55-59,52,61,113
26640,46119,60-64,61,72,133
26641,46119,65+,176,211,387
26642,46121,15-19,469,448,917
26643,46121,20-24,306,313,619
26644,46121,25-29,333,293,626
26645,46121,30-34,286,263,549
26646,46121,35-39,286,275,561
26647,46121,40-44,235,217,452
26648,46121,45-49,212,181,393
26649,46121,50-54,201,181,382
26650,46121,55-59,218,189,407
26651,46121,60-64,191,172,363
26652,46121,65+,381,295,676
26653,46123,15-19,162,177,339
26654,46123,20-24,130,164,294
26655,46123,25-29,150,147,297
26656,46123,30-34,132,154,286
26657,46123,35-39,130,149,279
26658,46123,40-44,135,125,260
26659,46123,45-49,136,159,295
26660,46123,50-54,147,142,289
26661,46123,55-59,201,211,412
26662,46123,60-64,211,230,441
26663,46123,65+,664,582,1246
26664,46125,15-19,273,313,586
26665,46125,20-24,170,190,360
26666,46125,25-29,198,218,416
26667,46125,30-34,232,220,452
26668,46125,35-39,262,282,544
26669,46125,40-44,286,298,584
26670,46125,45-49,235,251,486
26671,46125,50-54,234,255,489
26672,46125,55-59,280,303,583
26673,46125,60-64,299,330,629
26674,46125,65+,968,859,1827
26675,46127,15-19,517,577,1094
26676,46127,20-24,391,479,870
26677,46127,25-29,409,537,946
26678,46127,30-34,515,514,1029
26679,46127,35-39,506,529,1035
26680,46127,40-44,553,553,1106
26681,46127,45-49,486,513,999
26682,46127,50-54,496,543,1039
26683,46127,55-59,542,577,1119
26684,46127,60-64,544,591,1135
26685,46127,65+,1638,1537,3175
26686,46129,15-19,147,158,305
26687,46129,20-24,141,144,285
26688,46129,25-29,124,133,257
26689,46129,30-34,134,165,299
26690,46129,35-39,128,158,286
26691,46129,40-44,124,119,243
26692,46129,45-49,136,137,273
26693,46129,50-54,116,138,254
26694,46129,55-59,181,160,341
26695,46129,60-64,170,198,368
26696,46129,65+,701,625,1326
26697,46135,15-19,701,732,1433
26698,46135,20-24,688,752,1440
26699,46135,25-29,571,847,1418
26700,46135,30-34,559,852,1411
26701,46135,35-39,603,863,1466
26702,46135,40-44,567,822,1389
26703,46135,45-49,566,721,1287
26704,46135,50-54,639,763,1402
26705,46135,55-59,709,848,1557
26706,46135,60-64,849,849,1698
26707,46135,65+,2539,2153,4692
26708,46137,15-19,145,91,236
26709,46137,20-24,103,106,209
26710,46137,25-29,83,118,201
26711,46137,30-34,57,49,106
26712,46137,35-39,68,74,142
26713,46137,40-44,82,95,177
26714,46137,45-49,72,80,152
26715,46137,50-54,64,49,113
26716,46137,55-59,71,82,153
26717,46137,60-64,82,90,172
26718,46137,65+,131,122,253
26719,47001,15-19,2184,2465,4649
26720,47001,20-24,2022,2082,4104
26721,47001,25-29,2385,2450,4835
26722,47001,30-34,2422,2441,4863
26723,47001,35-39,2259,2267,4526
26724,47001,40-44,2302,2340,4642
26725,47001,45-49,2357,2270,4627
26726,47001,50-54,2640,2505,5145
26727,47001,55-59,2832,2676,5508
26728,47001,60-64,2849,2705,5554
26729,47001,65+,8709,7055,15764
26730,47003,15-19,1650,1805,3455
26731,47003,20-24,1486,1542,3028
26732,47003,25-29,1638,1778,3416
26733,47003,30-34,1710,1735,3445
26734,47003,35-39,1618,1572,3190
26735,47003,40-44,1572,1623,3195
26736,47003,45-49,1622,1540,3162
26737,47003,50-54,1667,1698,3365
26738,47003,55-59,1760,1665,3425
26739,47003,60-64,1575,1525,3100
26740,47003,65+,4311,3421,7732
26741,47005,15-19,405,407,812
26742,47005,20-24,362,399,761
26743,47005,25-29,409,387,796
26744,47005,30-34,401,442,843
26745,47005,35-39,411,404,815
26746,47005,40-44,410,430,840
26747,47005,45-49,472,503,975
26748,47005,50-54,574,538,1112
26749,47005,55-59,614,593,1207
26750,47005,60-64,656,593,1249
26751,47005,65+,2009,1795,3804
26752,47007,15-19,260,426,686
26753,47007,20-24,267,481,748
26754,47007,25-29,340,640,980
26755,47007,30-34,345,793,1138
26756,47007,35-39,309,807,1116
26757,47007,40-44,399,794,1193
26758,47007,45-49,417,714,1131
26759,47007,50-54,450,711,1161
26760,47007,55-59,550,700,1250
26761,47007,60-64,546,664,1210
26762,47007,65+,1421,1467,2888
26763,47009,15-19,3835,4132,7967
26764,47009,20-24,3685,3748,7433
26765,47009,25-29,4022,4168,8190
26766,47009,30-34,4211,4174,8385
26767,47009,35-39,3977,3855,7832
26768,47009,40-44,4153,4078,8231
26769,47009,45-49,4232,4022,8254
26770,47009,50-54,4946,4854,9800
26771,47009,55-59,5325,4955,10280
26772,47009,60-64,5105,4896,10001
26773,47009,65+,15873,13125,28998
26774,47011,15-19,3662,3680,7342
26775,47011,20-24,3631,3561,7192
26776,47011,25-29,3560,3517,7077
26777,47011,30-34,3654,3507,7161
26778,47011,35-39,3190,3240,6430
26779,47011,40-44,3493,3320,6813
26780,47011,45-49,3509,3610,7119
26781,47011,50-54,3758,3721,7479
26782,47011,55-59,3871,3664,7535
26783,47011,60-64,3782,3350,7132
26784,47011,65+,10724,8556,19280
26785,47013,15-19,1074,1136,2210
26786,47013,20-24,1056,1113,2169
26787,47013,25-29,1189,1292,2481
26788,47013,30-34,1175,1177,2352
26789,47013,35-39,1086,1010,2096
26790,47013,40-44,1120,1185,2305
26791,47013,45-49,1311,1279,2590
26792,47013,50-54,1412,1499,2911
26793,47013,55-59,1499,1376,2875
26794,47013,60-64,1394,1371,2765
26795,47013,65+,4430,3715,8145
26796,47015,15-19,371,404,775
26797,47015,20-24,366,380,746
26798,47015,25-29,448,502,950
26799,47015,30-34,472,505,977
26800,47015,35-39,446,422,868
26801,47015,40-44,411,446,857
26802,47015,45-49,437,438,875
26803,47015,50-54,518,545,1063
26804,47015,55-59,539,591,1130
26805,47015,60-64,558,504,1062
26806,47015,65+,1458,1188,2646
26807,47017,15-19,928,1071,1999
26808,47017,20-24,829,923,1752
26809,47017,25-29,769,785,1554
26810,47017,30-34,835,793,1628
26811,47017,35-39,759,724,1483
26812,47017,40-44,767,761,1528
26813,47017,45-49,834,778,1612
26814,47017,50-54,949,966,1915
26815,47017,55-59,1034,990,2024
26816,47017,60-64,957,982,1939
26817,47017,65+,3199,2565,5764
26818,47019,15-19,1448,1534,2982
26819,47019,20-24,1444,1500,2944
26820,47019,25-29,1639,1625,3264
26821,47019,30-34,1741,1819,3560
26822,47019,35-39,1524,1617,3141
26823,47019,40-44,1594,1636,3230
26824,47019,45-49,1815,1718,3533
26825,47019,50-54,2046,2024,4070
26826,47019,55-59,2210,2148,4358
26827,47019,60-64,2131,2060,4191
26828,47019,65+,6889,5912,12801
26829,47021,15-19,1253,1262,2515
26830,47021,20-24,1039,1137,2176
26831,47021,25-29,1287,1332,2619
26832,47021,30-34,1383,1432,2815
26833,47021,35-39,1328,1420,2748
26834,47021,40-44,1298,1315,2613
26835,47021,45-49,1372,1375,2747
26836,47021,50-54,1487,1519,3006
26837,47021,55-59,1682,1687,3369
26838,47021,60-64,1595,1505,3100
26839,47021,65+,3499,3108,6607
26840,47023,15-19,724,699,1423
26841,47023,20-24,792,752,1544
26842,47023,25-29,505,567,1072
26843,47023,30-34,552,478,1030
26844,47023,35-39,463,480,943
26845,47023,40-44,533,475,1008
26846,47023,45-49,560,527,1087
26847,47023,50-54,548,493,1041
26848,47023,55-59,560,561,1121
26849,47023,60-64,531,538,1069
26850,47023,65+,1711,1354,3065
26851,47025,15-19,1003,1005,2008
26852,47025,20-24,960,1055,2015
26853,47025,25-29,1043,1092,2135
26854,47025,30-34,979,994,1973
26855,47025,35-39,850,858,1708
26856,47025,40-44,909,986,1895
26857,47025,45-49,1023,1013,2036
26858,47025,50-54,1114,1130,2244
26859,47025,55-59,1159,1110,2269
26860,47025,60-64,1198,1134,2332
26861,47025,65+,3629,2977,6606
26862,47027,15-19,193,221,414
26863,47027,20-24,172,166,338
26864,47027,25-29,203,179,382
26865,47027,30-34,186,169,355
26866,47027,35-39,188,193,381
26867,47027,40-44,203,224,427
26868,47027,45-49,223,234,457
26869,47027,50-54,254,266,520
26870,47027,55-59,295,308,603
26871,47027,60-64,278,271,549
26872,47027,65+,1015,887,1902
26873,47029,15-19,958,1022,1980
26874,47029,20-24,928,926,1854
26875,47029,25-29,1008,1054,2062
26876,47029,30-34,1066,976,2042
26877,47029,35-39,1003,957,1960
26878,47029,40-44,1049,930,1979
26879,47029,45-49,1145,1112,2257
26880,47029,50-54,1294,1263,2557
26881,47029,55-59,1478,1372,2850
26882,47029,60-64,1513,1348,2861
26883,47029,65+,4239,3745,7984
26884,47031,15-19,1806,1958,3764
26885,47031,20-24,1593,1684,3277
26886,47031,25-29,1885,1897,3782
26887,47031,30-34,1889,1870,3759
26888,47031,35-39,1865,1748,3613
26889,47031,40-44,1803,1793,3596
26890,47031,45-49,1755,1770,3525
26891,47031,50-54,1881,1837,3718
26892,47031,55-59,2066,2048,4114
26893,47031,60-64,1987,1896,3883
26894,47031,65+,5653,4551,10204
26895,47033,15-19,465,431,896
26896,47033,20-24,390,378,768
26897,47033,25-29,427,416,843
26898,47033,30-34,420,400,820
26899,47033,35-39,437,417,854
26900,47033,40-44,404,372,776
26901,47033,45-49,422,394,816
26902,47033,50-54,426,417,843
26903,47033,55-59,531,506,1037
26904,47033,60-64,510,445,955
26905,47033,65+,1441,1161,2602
26906,47035,15-19,1355,1500,2855
26907,47035,20-24,1250,1379,2629
26908,47035,25-29,1419,1577,2996
26909,47035,30-34,1512,1484,2996
26910,47035,35-39,1432,1359,2791
26911,47035,40-44,1452,1333,2785
26912,47035,45-49,1574,1462,3036
26913,47035,50-54,1789,1815,3604
26914,47035,55-59,2350,2119,4469
26915,47035,60-64,2991,2525,5516
26916,47035,65+,10392,9628,20020
26917,47037,15-19,20013,20080,40093
26918,47037,20-24,26500,22967,49467
26919,47037,25-29,37622,33544,71166
26920,47037,30-34,35973,34764,70737
26921,47037,35-39,27981,28105,56086
26922,47037,40-44,22648,22504,45152
26923,47037,45-49,19654,19839,39493
26924,47037,50-54,19974,19503,39477
26925,47037,55-59,20680,19543,40223
26926,47037,60-64,20954,18049,39003
26927,47037,65+,52698,39699,92397
26928,47039,15-19,324,364,688
26929,47039,20-24,240,277,517
26930,47039,25-29,288,295,583
26931,47039,30-34,280,284,564
26932,47039,35-39,322,301,623
26933,47039,40-44,350,343,693
26934,47039,45-49,320,348,668
26935,47039,50-54,358,400,758
26936,47039,55-59,406,429,835
26937,47039,60-64,498,443,941
26938,47039,65+,1446,1215,2661
26939,47041,15-19,541,618,1159
26940,47041,20-24,534,539,1073
26941,47041,25-29,569,699,1268
26942,47041,30-34,636,634,1270
26943,47041,35-39,592,685,1277
26944,47041,40-44,600,605,1205
26945,47041,45-49,678,627,1305
26946,47041,50-54,658,703,1361
26947,47041,55-59,813,796,1609
26948,47041,60-64,737,705,1442
26949,47041,65+,2062,1802,3864
26950,47043,15-19,1574,1811,3385
26951,47043,20-24,1440,1562,3002
26952,47043,25-29,1688,1762,3450
26953,47043,30-34,1940,1896,3836
26954,47043,35-39,1836,1772,3608
26955,47043,40-44,1771,1730,3501
26956,47043,45-49,1758,1731,3489
26957,47043,50-54,1905,1891,3796
26958,47043,55-59,2002,1990,3992
26959,47043,60-64,1994,1780,3774
26960,47043,65+,5123,4168,9291
26961,47045,15-19,1116,1258,2374
26962,47045,20-24,1057,1050,2107
26963,47045,25-29,1216,1099,2315
26964,47045,30-34,1210,1131,2341
26965,47045,35-39,1116,1012,2128
26966,47045,40-44,1147,1034,2181
26967,47045,45-49,1131,1091,2222
26968,47045,50-54,1233,1169,2402
26969,47045,55-59,1304,1266,2570
26970,47045,60-64,1146,1157,2303
26971,47045,65+,3661,2852,6513
26972,47047,15-19,1010,1189,2199
26973,47047,20-24,1037,1114,2151
26974,47047,25-29,1222,1187,2409
26975,47047,30-34,1190,1188,2378
26976,47047,35-39,1164,1185,2349
26977,47047,40-44,1239,1171,2410
26978,47047,45-49,1261,1302,2563
26979,47047,50-54,1621,1554,3175
26980,47047,55-59,1846,1766,3612
26981,47047,60-64,1852,1880,3732
26982,47047,65+,5178,4560,9738
26983,47049,15-19,494,529,1023
26984,47049,20-24,431,526,957
26985,47049,25-29,490,504,994
26986,47049,30-34,476,520,996
26987,47049,35-39,493,492,985
26988,47049,40-44,502,541,1043
26989,47049,45-49,553,563,1116
26990,47049,50-54,687,639,1326
26991,47049,55-59,790,700,1490
26992,47049,60-64,773,737,1510
26993,47049,65+,2263,1993,4256
26994,47051,15-19,1510,1573,3083
26995,47051,20-24,1708,1694,3402
26996,47051,25-29,1210,1194,2404
26997,47051,30-34,1176,1192,2368
26998,47051,35-39,1124,1156,2280
26999,47051,40-44,1192,1266,2458
27000,47051,45-49,1334,1255,2589
27001,47051,50-54,1317,1329,2646
27002,47051,55-59,1551,1494,3045
27003,47051,60-64,1589,1567,3156
27004,47051,65+,4818,4092,8910
27005,47053,15-19,1608,1669,3277
27006,47053,20-24,1332,1341,2673
27007,47053,25-29,1552,1509,3061
27008,47053,30-34,1615,1423,3038
27009,47053,35-39,1705,1550,3255
27010,47053,40-44,1637,1592,3229
27011,47053,45-49,1565,1503,3068
27012,47053,50-54,1568,1548,3116
27013,47053,55-59,1736,1631,3367
27014,47053,60-64,1721,1600,3321
27015,47053,65+,5150,3940,9090
27016,47055,15-19,934,878,1812
27017,47055,20-24,870,866,1736
27018,47055,25-29,854,919,1773
27019,47055,30-34,971,875,1846
27020,47055,35-39,875,834,1709
27021,47055,40-44,818,857,1675
27022,47055,45-49,876,855,1731
27023,47055,50-54,1041,999,2040
27024,47055,55-59,1188,1178,2366
27025,47055,60-64,1144,1151,2295
27026,47055,65+,3425,2828,6253
27027,47057,15-19,628,766,1394
27028,47057,20-24,561,637,1198
27029,47057,25-29,673,742,1415
27030,47057,30-34,606,674,1280
27031,47057,35-39,627,590,1217
27032,47057,40-44,659,711,1370
27033,47057,45-49,758,762,1520
27034,47057,50-54,892,940,1832
27035,47057,55-59,959,929,1888
27036,47057,60-64,884,901,1785
27037,47057,65+,2668,2449,5117
27038,47059,15-19,2004,2225,4229
27039,47059,20-24,1864,2008,3872
27040,47059,25-29,1919,2088,4007
27041,47059,30-34,1953,1956,3909
27042,47059,35-39,1889,1814,3703
27043,47059,40-44,2074,2109,4183
27044,47059,45-49,2206,2237,4443
27045,47059,50-54,2509,2499,5008
27046,47059,55-59,2795,2559,5354
27047,47059,60-64,2704,2634,5338
27048,47059,65+,8500,7227,15727
27049,47061,15-19,364,451,815
27050,47061,20-24,349,381,730
27051,47061,25-29,387,423,810
27052,47061,30-34,385,393,778
27053,47061,35-39,389,363,752
27054,47061,40-44,444,437,881
27055,47061,45-49,417,426,843
27056,47061,50-54,444,460,904
27057,47061,55-59,464,496,960
27058,47061,60-64,483,483,966
27059,47061,65+,1575,1237,2812
27060,47063,15-19,2034,2072,4106
27061,47063,20-24,1833,1894,3727
27062,47063,25-29,1883,2054,3937
27063,47063,30-34,1890,1914,3804
27064,47063,35-39,1833,1894,3727
27065,47063,40-44,1955,1983,3938
27066,47063,45-49,2099,2042,4141
27067,47063,50-54,2225,2151,4376
27068,47063,55-59,2145,2278,4423
27069,47063,60-64,2204,2068,4272
27070,47063,65+,6666,5167,11833
27071,47065,15-19,11170,10844,22014
27072,47065,20-24,11249,11073,22322
27073,47065,25-29,13117,12703,25820
27074,47065,30-34,14091,13361,27452
27075,47065,35-39,12154,12141,24295
27076,47065,40-44,11612,11352,22964
27077,47065,45-49,11081,10720,21801
27078,47065,50-54,12001,11461,23462
27079,47065,55-59,12375,11680,24055
27080,47065,60-64,12737,11560,24297
27081,47065,65+,37426,29472,66898
27082,47067,15-19,171,210,381
27083,47067,20-24,151,183,334
27084,47067,25-29,192,203,395
27085,47067,30-34,189,173,362
27086,47067,35-39,191,197,388
27087,47067,40-44,194,188,382
27088,47067,45-49,195,184,379
27089,47067,50-54,210,220,430
27090,47067,55-59,270,220,490
27091,47067,60-64,284,255,539
27092,47067,65+,785,729,1514
27093,47069,15-19,660,707,1367
27094,47069,20-24,599,1045,1644
27095,47069,25-29,620,1256,1876
27096,47069,30-34,648,1285,1933
27097,47069,35-39,595,1047,1642
27098,47069,40-44,667,1050,1717
27099,47069,45-49,598,961,1559
27100,47069,50-54,678,891,1569
27101,47069,55-59,833,884,1717
27102,47069,60-64,841,845,1686
27103,47069,65+,2572,2145,4717
27104,47071,15-19,761,816,1577
27105,47071,20-24,595,682,1277
27106,47071,25-29,717,727,1444
27107,47071,30-34,761,704,1465
27108,47071,35-39,711,678,1389
27109,47071,40-44,790,740,1530
27110,47071,45-49,801,781,1582
27111,47071,50-54,907,876,1783
27112,47071,55-59,1012,997,2009
27113,47071,60-64,1077,1031,2108
27114,47071,65+,3425,2879,6304
27115,47073,15-19,1607,1698,3305
27116,47073,20-24,1494,1482,2976
27117,47073,25-29,1655,1702,3357
27118,47073,30-34,1551,1698,3249
27119,47073,35-39,1582,1547,3129
27120,47073,40-44,1577,1570,3147
27121,47073,45-49,1895,1820,3715
27122,47073,50-54,2177,2161,4338
27123,47073,55-59,2241,2203,4444
27124,47073,60-64,2171,2119,4290
27125,47073,65+,6631,5805,12436
27126,47075,15-19,541,547,1088
27127,47075,20-24,495,502,997
27128,47075,25-29,513,518,1031
27129,47075,30-34,561,432,993
27130,47075,35-39,525,470,995
27131,47075,40-44,614,474,1088
27132,47075,45-49,511,458,969
27133,47075,50-54,608,523,1131
27134,47075,55-59,681,612,1293
27135,47075,60-64,718,620,1338
27136,47075,65+,2017,1544,3561
27137,47077,15-19,826,931,1757
27138,47077,20-24,735,761,1496
27139,47077,25-29,806,820,1626
27140,47077,30-34,857,850,1707
27141,47077,35-39,890,839,1729
27142,47077,40-44,892,932,1824
27143,47077,45-49,864,812,1676
27144,47077,50-54,913,879,1792
27145,47077,55-59,1029,1020,2049
27146,47077,60-64,950,890,1840
27147,47077,65+,2890,2325,5215
27148,47079,15-19,897,957,1854
27149,47079,20-24,699,830,1529
27150,47079,25-29,818,887,1705
27151,47079,30-34,879,854,1733
27152,47079,35-39,904,804,1708
27153,47079,40-44,911,943,1854
27154,47079,45-49,922,910,1832
27155,47079,50-54,1048,1071,2119
27156,47079,55-59,1303,1157,2460
27157,47079,60-64,1288,1230,2518
27158,47079,65+,4184,3425,7609
27159,47081,15-19,688,763,1451
27160,47081,20-24,630,868,1498
27161,47081,25-29,679,986,1665
27162,47081,30-34,742,955,1697
27163,47081,35-39,689,893,1582
27164,47081,40-44,751,884,1635
27165,47081,45-49,750,867,1617
27166,47081,50-54,826,935,1761
27167,47081,55-59,873,960,1833
27168,47081,60-64,836,938,1774
27169,47081,65+,2447,2048,4495
27170,47083,15-19,246,239,485
27171,47083,20-24,219,222,441
27172,47083,25-29,223,235,458
27173,47083,30-34,231,240,471
27174,47083,35-39,276,243,519
27175,47083,40-44,248,244,492
27176,47083,45-49,259,251,510
27177,47083,50-54,277,271,548
27178,47083,55-59,296,297,593
27179,47083,60-64,300,327,627
27180,47083,65+,938,784,1722
27181,47085,15-19,544,620,1164
27182,47085,20-24,498,501,999
27183,47085,25-29,559,568,1127
27184,47085,30-34,559,627,1186
27185,47085,35-39,558,508,1066
27186,47085,40-44,566,556,1122
27187,47085,45-49,555,568,1123
27188,47085,50-54,635,675,1310
27189,47085,55-59,732,698,1430
27190,47085,60-64,695,699,1394
27191,47085,65+,2084,1830,3914
27192,47087,15-19,278,317,595
27193,47087,20-24,275,293,568
27194,47087,25-29,346,340,686
27195,47087,30-34,309,354,663
27196,47087,35-39,286,278,564
27197,47087,40-44,306,338,644
27198,47087,45-49,364,395,759
27199,47087,50-54,431,422,853
27200,47087,55-59,451,465,916
27201,47087,60-64,536,547,1083
27202,47087,65+,1382,1306,2688
27203,47089,15-19,1630,1799,3429
27204,47089,20-24,1645,1641,3286
27205,47089,25-29,1567,1676,3243
27206,47089,30-34,1648,1609,3257
27207,47089,35-39,1419,1496,2915
27208,47089,40-44,1639,1572,3211
27209,47089,45-49,1751,1778,3529
27210,47089,50-54,2005,1985,3990
27211,47089,55-59,2222,2232,4454
27212,47089,60-64,2166,2125,4291
27213,47089,65+,6089,5252,11341
27214,47091,15-19,424,486,910
27215,47091,20-24,347,562,909
27216,47091,25-29,388,584,972
27217,47091,30-34,436,782,1218
27218,47091,35-39,407,503,910
27219,47091,40-44,445,756,1201
27220,47091,45-49,494,778,1272
27221,47091,50-54,572,731,1303
27222,47091,55-59,658,681,1339
27223,47091,60-64,697,676,1373
27224,47091,65+,2331,1993,4324
27225,47093,15-19,15979,16484,32463
27226,47093,20-24,20907,21116,42023
27227,47093,25-29,17425,17201,34626
27228,47093,30-34,16669,16291,32960
27229,47093,35-39,16233,15684,31917
27230,47093,40-44,15462,15114,30576
27231,47093,45-49,14485,14287,28772
27232,47093,50-54,15267,14889,30156
27233,47093,55-59,15957,14768,30725
27234,47093,60-64,15268,14129,29397
27235,47093,65+,44528,34991,79519
27236,47095,15-19,107,222,329
27237,47095,20-24,128,468,596
27238,47095,25-29,140,533,673
27239,47095,30-34,149,473,622
27240,47095,35-39,148,380,528
27241,47095,40-44,141,378,519
27242,47095,45-49,158,330,488
27243,47095,50-54,199,301,500
27244,47095,55-59,198,284,482
27245,47095,60-64,185,238,423
27246,47095,65+,625,529,1154
27247,47097,15-19,747,825,1572
27248,47097,20-24,662,996,1658
27249,47097,25-29,726,1034,1760
27250,47097,30-34,691,1000,1691
27251,47097,35-39,732,924,1656
27252,47097,40-44,769,905,1674
27253,47097,45-49,717,763,1480
27254,47097,50-54,777,862,1639
27255,47097,55-59,891,891,1782
27256,47097,60-64,857,732,1589
27257,47097,65+,2285,1809,4094
27258,47099,15-19,1439,1494,2933
27259,47099,20-24,1165,1293,2458
27260,47099,25-29,1332,1314,2646
27261,47099,30-34,1465,1418,2883
27262,47099,35-39,1275,1259,2534
27263,47099,40-44,1296,1304,2600
27264,47099,45-49,1321,1255,2576
27265,47099,50-54,1500,1509,3009
27266,47099,55-59,1522,1570,3092
27267,47099,60-64,1495,1434,2929
27268,47099,65+,4377,3566,7943
27269,47101,15-19,356,427,783
27270,47101,20-24,320,340,660
27271,47101,25-29,354,390,744
27272,47101,30-34,392,354,746
27273,47101,35-39,370,334,704
27274,47101,40-44,383,382,765
27275,47101,45-49,402,405,807
27276,47101,50-54,415,392,807
27277,47101,55-59,428,425,853
27278,47101,60-64,487,458,945
27279,47101,65+,1474,1224,2698
27280,47103,15-19,1075,1181,2256
27281,47103,20-24,896,988,1884
27282,47103,25-29,938,1022,1960
27283,47103,30-34,1017,1002,2019
27284,47103,35-39,1011,1033,2044
27285,47103,40-44,1037,1046,2083
27286,47103,45-49,1014,1014,2028
27287,47103,50-54,1231,1204,2435
27288,47103,55-59,1273,1306,2579
27289,47103,60-64,1348,1343,2691
27290,47103,65+,3960,3139,7099
27291,47105,15-19,1399,1562,2961
27292,47105,20-24,1243,1346,2589
27293,47105,25-29,1357,1387,2744
27294,47105,30-34,1408,1489,2897
27295,47105,35-39,1400,1401,2801
27296,47105,40-44,1412,1334,2746
27297,47105,45-49,1595,1422,3017
27298,47105,50-54,1902,1765,3667
27299,47105,55-59,2073,2020,4093
27300,47105,60-64,2471,2322,4793
27301,47105,65+,8189,7324,15513
27302,47107,15-19,1663,1706,3369
27303,47107,20-24,1510,1532,3042
27304,47107,25-29,1661,1655,3316
27305,47107,30-34,1583,1567,3150
27306,47107,35-39,1583,1485,3068
27307,47107,40-44,1628,1509,3137
27308,47107,45-49,1675,1569,3244
27309,47107,50-54,1819,1946,3765
27310,47107,55-59,1936,1845,3781
27311,47107,60-64,1993,1922,3915
27312,47107,65+,5909,4981,10890
27313,47109,15-19,805,851,1656
27314,47109,20-24,672,740,1412
27315,47109,25-29,746,716,1462
27316,47109,30-34,707,734,1441
27317,47109,35-39,669,722,1391
27318,47109,40-44,819,782,1601
27319,47109,45-49,786,798,1584
27320,47109,50-54,871,873,1744
27321,47109,55-59,967,903,1870
27322,47109,60-64,920,885,1805
27323,47109,65+,2974,2411,5385
27324,47111,15-19,751,802,1553
27325,47111,20-24,719,776,1495
27326,47111,25-29,910,833,1743
27327,47111,30-34,888,827,1715
27328,47111,35-39,803,760,1563
27329,47111,40-44,738,715,1453
27330,47111,45-49,815,780,1595
27331,47111,50-54,866,874,1740
27332,47111,55-59,888,913,1801
27333,47111,60-64,811,763,1574
27334,47111,65+,2297,1834,4131
27335,47113,15-19,3807,3416,7223
27336,47113,20-24,3564,3311,6875
27337,47113,25-29,3358,3007,6365
27338,47113,30-34,3271,2851,6122
27339,47113,35-39,2912,2617,5529
27340,47113,40-44,2998,2726,5724
27341,47113,45-49,2874,2611,5485
27342,47113,50-54,3163,2942,6105
27343,47113,55-59,3512,3129,6641
27344,47113,60-64,3574,3099,6673
27345,47113,65+,9921,7793,17714
27346,47115,15-19,821,842,1663
27347,47115,20-24,772,797,1569
27348,47115,25-29,799,862,1661
27349,47115,30-34,839,838,1677
27350,47115,35-39,810,793,1603
27351,47115,40-44,797,871,1668
27352,47115,45-49,942,888,1830
27353,47115,50-54,973,969,1942
27354,47115,55-59,1095,1068,2163
27355,47115,60-64,1122,1022,2144
27356,47115,65+,3256,2812,6068
27357,47117,15-19,1073,1073,2146
27358,47117,20-24,942,989,1931
27359,47117,25-29,1104,1089,2193
27360,47117,30-34,1254,1168,2422
27361,47117,35-39,1147,1114,2261
27362,47117,40-44,1074,1103,2177
27363,47117,45-49,1118,1075,2193
27364,47117,50-54,1183,1216,2399
27365,47117,55-59,1251,1213,2464
27366,47117,60-64,1198,1121,2319
27367,47117,65+,3120,2622,5742
27368,47119,15-19,2945,3069,6014
27369,47119,20-24,2887,2808,5695
27370,47119,25-29,3647,3519,7166
27371,47119,30-34,3914,3661,7575
27372,47119,35-39,3548,3586,7134
27373,47119,40-44,3591,3274,6865
27374,47119,45-49,3140,3004,6144
27375,47119,50-54,3249,3198,6447
27376,47119,55-59,3564,3241,6805
27377,47119,60-64,3847,3383,7230
27378,47119,65+,9728,7922,17650
27379,47121,15-19,334,370,704
27380,47121,20-24,356,361,717
27381,47121,25-29,357,350,707
27382,47121,30-34,335,346,681
27383,47121,35-39,340,353,693
27384,47121,40-44,405,389,794
27385,47121,45-49,415,439,854
27386,47121,50-54,480,475,955
27387,47121,55-59,542,486,1028
27388,47121,60-64,446,477,923
27389,47121,65+,1410,1338,2748
27390,47123,15-19,1287,1398,2685
27391,47123,20-24,1118,1217,2335
27392,47123,25-29,1274,1385,2659
27393,47123,30-34,1331,1410,2741
27394,47123,35-39,1217,1232,2449
27395,47123,40-44,1288,1314,2602
27396,47123,45-49,1351,1375,2726
27397,47123,50-54,1667,1584,3251
27398,47123,55-59,1765,1737,3502
27399,47123,60-64,1824,1755,3579
27400,47123,65+,5483,4755,10238
27401,47125,15-19,7150,7340,14490
27402,47125,20-24,8849,9590,18439
27403,47125,25-29,10345,11307,21652
27404,47125,30-34,9959,10197,20156
27405,47125,35-39,8734,8872,17606
27406,47125,40-44,7337,7248,14585
27407,47125,45-49,6277,5997,12274
27408,47125,50-54,6048,5703,11751
27409,47125,55-59,6017,5623,11640
27410,47125,60-64,5601,4914,10515
27411,47125,65+,12348,9993,22341
27412,47127,15-19,188,200,388
27413,47127,20-24,173,164,337
27414,47127,25-29,179,174,353
27415,47127,30-34,177,189,366
27416,47127,35-39,194,192,386
27417,47127,40-44,189,212,401
27418,47127,45-49,216,211,427
27419,47127,50-54,209,240,449
27420,47127,55-59,252,249,501
27421,47127,60-64,255,257,512
27422,47127,65+,782,684,1466
27423,47129,15-19,547,629,1176
27424,47129,20-24,509,809,1318
27425,47129,25-29,543,945,1488
27426,47129,30-34,529,915,1444
27427,47129,35-39,529,822,1351
27428,47129,40-44,512,804,1316
27429,47129,45-49,607,818,1425
27430,47129,50-54,674,885,1559
27431,47129,55-59,712,812,1524
27432,47129,60-64,677,736,1413
27433,47129,65+,2099,1862,3961
27434,47131,15-19,894,903,1797
27435,47131,20-24,847,841,1688
27436,47131,25-29,918,891,1809
27437,47131,30-34,867,858,1725
27438,47131,35-39,893,858,1751
27439,47131,40-44,910,901,1811
27440,47131,45-49,912,943,1855
27441,47131,50-54,1045,1029,2074
27442,47131,55-59,1013,927,1940
27443,47131,60-64,1115,1042,2157
27444,47131,65+,3540,2883,6423
27445,47133,15-19,637,755,1392
27446,47133,20-24,590,627,1217
27447,47133,25-29,694,756,1450
27448,47133,30-34,624,687,1311
27449,47133,35-39,620,606,1226
27450,47133,40-44,674,704,1378
27451,47133,45-49,701,710,1411
27452,47133,50-54,780,749,1529
27453,47133,55-59,832,811,1643
27454,47133,60-64,852,812,1664
27455,47133,65+,2500,2162,4662
27456,47135,15-19,210,248,458
27457,47135,20-24,194,249,443
27458,47135,25-29,245,254,499
27459,47135,30-34,249,247,496
27460,47135,35-39,208,265,473
27461,47135,40-44,269,228,497
27462,47135,45-49,258,245,503
27463,47135,50-54,265,279,544
27464,47135,55-59,259,286,545
27465,47135,60-64,315,302,617
27466,47135,65+,944,866,1810
27467,47137,15-19,134,139,273
27468,47137,20-24,126,138,264
27469,47137,25-29,98,109,207
27470,47137,30-34,106,110,216
27471,47137,35-39,107,103,210
27472,47137,40-44,146,141,287
27473,47137,45-49,151,136,287
27474,47137,50-54,168,171,339
27475,47137,55-59,211,212,423
27476,47137,60-64,212,221,433
27477,47137,65+,735,709,1444
27478,47139,15-19,448,566,1014
27479,47139,20-24,445,451,896
27480,47139,25-29,462,488,950
27481,47139,30-34,479,495,974
27482,47139,35-39,460,468,928
27483,47139,40-44,563,528,1091
27484,47139,45-49,607,615,1222
27485,47139,50-54,678,688,1366
27486,47139,55-59,740,742,1482
27487,47139,60-64,658,658,1316
27488,47139,65+,1982,1779,3761
27489,47141,15-19,2779,3091,5870
27490,47141,20-24,3731,4521,8252
27491,47141,25-29,2732,3020,5752
27492,47141,30-34,2543,2576,5119
27493,47141,35-39,2365,2453,4818
27494,47141,40-44,2250,2328,4578
27495,47141,45-49,2309,2268,4577
27496,47141,50-54,2497,2395,4892
27497,47141,55-59,2567,2369,4936
27498,47141,60-64,2583,2279,4862
27499,47141,65+,7538,6061,13599
27500,47143,15-19,1107,1150,2257
27501,47143,20-24,1008,1086,2094
27502,47143,25-29,935,1016,1951
27503,47143,30-34,962,944,1906
27504,47143,35-39,915,931,1846
27505,47143,40-44,951,951,1902
27506,47143,45-49,998,970,1968
27507,47143,50-54,1150,1099,2249
27508,47143,55-59,1158,1161,2319
27509,47143,60-64,1157,1172,2329
27510,47143,65+,3434,2935,6369
27511,47145,15-19,1376,1593,2969
27512,47145,20-24,1349,1445,2794
27513,47145,25-29,1443,1486,2929
27514,47145,30-34,1509,1459,2968
27515,47145,35-39,1462,1450,2912
27516,47145,40-44,1530,1431,2961
27517,47145,45-49,1694,1637,3331
27518,47145,50-54,1885,1971,3856
27519,47145,55-59,2151,2029,4180
27520,47145,60-64,2198,2132,4330
27521,47145,65+,6761,5939,12700
27522,47147,15-19,2309,2396,4705
27523,47147,20-24,1931,2051,3982
27524,47147,25-29,2321,2280,4601
27525,47147,30-34,2409,2466,4875
27526,47147,35-39,2484,2441,4925
27527,47147,40-44,2465,2472,4937
27528,47147,45-49,2356,2428,4784
27529,47147,50-54,2498,2486,4984
27530,47147,55-59,2704,2692,5396
27531,47147,60-64,2626,2525,5151
27532,47147,65+,6205,5170,11375
27533,47149,15-19,12707,13045,25752
27534,47149,20-24,15414,15394,30808
27535,47149,25-29,13225,12955,26180
27536,47149,30-34,12969,12687,25656
27537,47149,35-39,12857,12384,25241
27538,47149,40-44,12791,12487,25278
27539,47149,45-49,11545,11152,22697
27540,47149,50-54,10971,10893,21864
27541,47149,55-59,10523,9937,20460
27542,47149,60-64,9146,8836,17982
27543,47149,65+,21719,17394,39113
27544,47151,15-19,753,753,1506
27545,47151,20-24,614,618,1232
27546,47151,25-29,654,673,1327
27547,47151,30-34,672,700,1372
27548,47151,35-39,634,584,1218
27549,47151,40-44,761,751,1512
27550,47151,45-49,675,689,1364
27551,47151,50-54,707,743,1450
27552,47151,55-59,757,764,1521
27553,47151,60-64,690,654,1344
27554,47151,65+,2094,1780,3874
27555,47153,15-19,466,532,998
27556,47153,20-24,389,433,822
27557,47153,25-29,483,448,931
27558,47153,30-34,426,464,890
27559,47153,35-39,446,429,875
27560,47153,40-44,501,471,972
27561,47153,45-49,531,542,1073
27562,47153,50-54,563,582,1145
27563,47153,55-59,608,588,1196
27564,47153,60-64,636,641,1277
27565,47153,65+,1845,1671,3516
27566,47155,15-19,2633,2998,5631
27567,47155,20-24,2598,2780,5378
27568,47155,25-29,3040,3145,6185
27569,47155,30-34,2982,3014,5996
27570,47155,35-39,2772,2782,5554
27571,47155,40-44,2921,2809,5730
27572,47155,45-49,3068,3062,6130
27573,47155,50-54,3451,3417,6868
27574,47155,55-59,3959,3596,7555
27575,47155,60-64,3956,3621,7577
27576,47155,65+,10900,9505,20405
27577,47157,15-19,29991,30109,60100
27578,47157,20-24,30694,29218,59912
27579,47157,25-29,36050,33154,69204
27580,47157,30-34,35583,32378,67961
27581,47157,35-39,31608,28786,60394
27582,47157,40-44,30394,27155,57549
27583,47157,45-49,28338,25250,53588
27584,47157,50-54,29563,26606,56169
27585,47157,55-59,30069,26280,56349
27586,47157,60-64,30023,25417,55440
27587,47157,65+,77485,56504,133989
27588,47159,15-19,602,644,1246
27589,47159,20-24,533,584,1117
27590,47159,25-29,608,608,1216
27591,47159,30-34,645,692,1337
27592,47159,35-39,622,618,1240
27593,47159,40-44,635,608,1243
27594,47159,45-49,638,593,1231
27595,47159,50-54,669,677,1346
27596,47159,55-59,768,788,1556
27597,47159,60-64,713,747,1460
27598,47159,65+,1812,1605,3417
27599,47161,15-19,387,469,856
27600,47161,20-24,329,381,710
27601,47161,25-29,364,378,742
27602,47161,30-34,376,428,804
27603,47161,35-39,402,382,784
27604,47161,40-44,382,448,830
27605,47161,45-49,428,414,842
27606,47161,50-54,483,481,964
27607,47161,55-59,531,561,1092
27608,47161,60-64,510,497,1007
27609,47161,65+,1545,1319,2864
27610,47163,15-19,4208,4588,8796
27611,47163,20-24,4282,4360,8642
27612,47163,25-29,4760,5020,9780
27613,47163,30-34,4873,4768,9641
27614,47163,35-39,4380,4452,8832
27615,47163,40-44,4686,4447,9133
27616,47163,45-49,5043,4941,9984
27617,47163,50-54,5725,5645,11370
27618,47163,55-59,5848,5739,11587
27619,47163,60-64,5981,5548,11529
27620,47163,65+,19480,15929,35409
27621,47165,15-19,6087,6523,12610
27622,47165,20-24,5423,5625,11048
27623,47165,25-29,6160,5959,12119
27624,47165,30-34,6734,6333,13067
27625,47165,35-39,6923,6639,13562
27626,47165,40-44,6879,6629,13508
27627,47165,45-49,6648,6360,13008
27628,47165,50-54,6915,6768,13683
27629,47165,55-59,7119,6823,13942
27630,47165,60-64,6617,6310,12927
27631,47165,65+,18095,14723,32818
27632,47167,15-19,1963,2137,4100
27633,47167,20-24,1722,1885,3607
27634,47167,25-29,1854,1965,3819
27635,47167,30-34,2055,2002,4057
27636,47167,35-39,2052,1951,4003
27637,47167,40-44,2003,1933,3936
27638,47167,45-49,1851,1793,3644
27639,47167,50-54,2059,2049,4108
27640,47167,55-59,2218,2152,4370
27641,47167,60-64,2123,1960,4083
27642,47167,65+,5156,4276,9432
27643,47169,15-19,257,567,824
27644,47169,20-24,242,543,785
27645,47169,25-29,304,945,1249
27646,47169,30-34,528,807,1335
27647,47169,35-39,279,750,1029
27648,47169,40-44,294,319,613
27649,47169,45-49,272,495,767
27650,47169,50-54,329,417,746
27651,47169,55-59,317,308,625
27652,47169,60-64,312,324,636
27653,47169,65+,842,720,1562
27654,47171,15-19,443,518,961
27655,47171,20-24,449,479,928
27656,47171,25-29,473,494,967
27657,47171,30-34,460,487,947
27658,47171,35-39,458,524,982
27659,47171,40-44,486,519,1005
27660,47171,45-49,542,531,1073
27661,47171,50-54,616,647,1263
27662,47171,55-59,665,627,1292
27663,47171,60-64,788,689,1477
27664,47171,65+,2272,1951,4223
27665,47173,15-19,553,631,1184
27666,47173,20-24,493,542,1035
27667,47173,25-29,582,592,1174
27668,47173,30-34,643,608,1251
27669,47173,35-39,568,532,1100
27670,47173,40-44,617,585,1202
27671,47173,45-49,617,635,1252
27672,47173,50-54,744,709,1453
27673,47173,55-59,766,787,1553
27674,47173,60-64,802,796,1598
27675,47173,65+,1995,1796,3791
27676,47175,15-19,172,177,349
27677,47175,20-24,142,147,289
27678,47175,25-29,142,177,319
27679,47175,30-34,140,162,302
27680,47175,35-39,145,162,307
27681,47175,40-44,182,185,367
27682,47175,45-49,198,188,386
27683,47175,50-54,236,243,479
27684,47175,55-59,218,203,421
27685,47175,60-64,236,270,506
27686,47175,65+,804,716,1520
27687,47177,15-19,1284,1366,2650
27688,47177,20-24,1129,1219,2348
27689,47177,25-29,1204,1302,2506
27690,47177,30-34,1312,1310,2622
27691,47177,35-39,1245,1229,2474
27692,47177,40-44,1358,1332,2690
27693,47177,45-49,1267,1376,2643
27694,47177,50-54,1288,1420,2708
27695,47177,55-59,1392,1397,2789
27696,47177,60-64,1410,1381,2791
27697,47177,65+,4087,3335,7422
27698,47179,15-19,4393,4309,8702
27699,47179,20-24,6083,5604,11687
27700,47179,25-29,4449,4520,8969
27701,47179,30-34,4051,4071,8122
27702,47179,35-39,3843,3761,7604
27703,47179,40-44,3849,3786,7635
27704,47179,45-49,4099,4199,8298
27705,47179,50-54,4382,4484,8866
27706,47179,55-59,4397,4465,8862
27707,47179,60-64,4731,4317,9048
27708,47179,65+,13969,11930,25899
27709,47181,15-19,356,453,809
27710,47181,20-24,348,624,972
27711,47181,25-29,357,815,1172
27712,47181,30-34,397,798,1195
27713,47181,35-39,403,681,1084
27714,47181,40-44,414,699,1113
27715,47181,45-49,449,676,1125
27716,47181,50-54,539,664,1203
27717,47181,55-59,573,658,1231
27718,47181,60-64,585,581,1166
27719,47181,65+,1714,1498,3212
27720,47183,15-19,1263,1214,2477
27721,47183,20-24,1959,1888,3847
27722,47183,25-29,934,1065,1999
27723,47183,30-34,877,911,1788
27724,47183,35-39,867,819,1686
27725,47183,40-44,917,895,1812
27726,47183,45-49,883,844,1727
27727,47183,50-54,1031,1006,2037
27728,47183,55-59,1123,1065,2188
27729,47183,60-64,1049,1029,2078
27730,47183,65+,3456,2769,6225
27731,47185,15-19,788,823,1611
27732,47185,20-24,695,769,1464
27733,47185,25-29,772,826,1598
27734,47185,30-34,821,889,1710
27735,47185,35-39,774,777,1551
27736,47185,40-44,865,776,1641
27737,47185,45-49,804,852,1656
27738,47185,50-54,942,925,1867
27739,47185,55-59,1020,1020,2040
27740,47185,60-64,1007,905,1912
27741,47185,65+,3094,2574,5668
27742,47187,15-19,9859,10035,19894
27743,47187,20-24,6773,6971,13744
27744,47187,25-29,5386,5271,10657
27745,47187,30-34,6583,5902,12485
27746,47187,35-39,9158,8513,17671
27747,47187,40-44,10141,9871,20012
27748,47187,45-49,9630,9551,19181
27749,47187,50-54,9634,9749,19383
27750,47187,55-59,8840,8467,17307
27751,47187,60-64,8053,7674,15727
27752,47187,65+,19377,16776,36153
27753,47189,15-19,4490,5064,9554
27754,47189,20-24,3864,4179,8043
27755,47189,25-29,4299,4158,8457
27756,47189,30-34,5096,4795,9891
27757,47189,35-39,5460,5251,10711
27758,47189,40-44,5411,5349,10760
27759,47189,45-49,5063,5200,10263
27760,47189,50-54,5270,5366,10636
27761,47189,55-59,5342,5184,10526
27762,47189,60-64,4982,4753,9735
27763,47189,65+,13173,11078,24251
27764,48001,15-19,1395,1644,3039
27765,48001,20-24,1220,2245,3465
27766,48001,25-29,1297,3136,4433
27767,48001,30-34,1263,3616,4879
27768,48001,35-39,1300,3561,4861
27769,48001,40-44,1288,3565,4853
27770,48001,45-49,1303,3143,4446
27771,48001,50-54,1317,2631,3948
27772,48001,55-59,1383,2096,3479
27773,48001,60-64,1490,1724,3214
27774,48001,65+,4595,4127,8722
27775,48003,15-19,701,747,1448
27776,48003,20-24,554,579,1133
27777,48003,25-29,584,653,1237
27778,48003,30-34,672,746,1418
27779,48003,35-39,660,735,1395
27780,48003,40-44,532,625,1157
27781,48003,45-49,513,547,1060
27782,48003,50-54,536,490,1026
27783,48003,55-59,454,516,970
27784,48003,60-64,424,500,924
27785,48003,65+,984,835,1819
27786,48005,15-19,3026,3067,6093
27787,48005,20-24,2670,2723,5393
27788,48005,25-29,2768,2654,5422
27789,48005,30-34,2842,2679,5521
27790,48005,35-39,2702,2521,5223
27791,48005,40-44,2632,2530,5162
27792,48005,45-49,2501,2444,4945
27793,48005,50-54,2663,2665,5328
27794,48005,55-59,2631,2834,5465
27795,48005,60-64,2632,2573,5205
27796,48005,65+,8126,6485,14611
27797,48007,15-19,609,632,1241
27798,48007,20-24,539,625,1164
27799,48007,25-29,595,611,1206
27800,48007,30-34,587,601,1188
27801,48007,35-39,604,666,1270
27802,48007,40-44,622,640,1262
27803,48007,45-49,626,626,1252
27804,48007,50-54,770,725,1495
27805,48007,55-59,979,842,1821
27806,48007,60-64,1132,1047,2179
27807,48007,65+,3475,3241,6716
27808,48009,15-19,243,275,518
27809,48009,20-24,212,213,425
27810,48009,25-29,199,249,448
27811,48009,30-34,242,235,477
27812,48009,35-39,276,289,565
27813,48009,40-44,238,252,490
27814,48009,45-49,243,204,447
27815,48009,50-54,285,269,554
27816,48009,55-59,322,353,675
27817,48009,60-64,372,336,708
27818,48009,65+,946,837,1783
27819,48011,15-19,52,55,107
27820,48011,20-24,45,40,85
27821,48011,25-29,50,56,106
27822,48011,30-34,38,36,74
27823,48011,35-39,57,48,105
27824,48011,40-44,71,68,139
27825,48011,45-49,51,52,103
27826,48011,50-54,49,53,102
27827,48011,55-59,55,44,99
27828,48011,60-64,72,91,163
27829,48011,65+,229,191,420
27830,48013,15-19,1769,1933,3702
27831,48013,20-24,1572,1556,3128
27832,48013,25-29,1517,1500,3017
27833,48013,30-34,1567,1682,3249
27834,48013,35-39,1615,1652,3267
27835,48013,40-44,1619,1637,3256
27836,48013,45-49,1518,1484,3002
27837,48013,50-54,1427,1567,2994
27838,48013,55-59,1471,1433,2904
27839,48013,60-64,1413,1412,2825
27840,48013,65+,3990,3419,7409
27841,48015,15-19,910,1018,1928
27842,48015,20-24,857,799,1656
27843,48015,25-29,823,891,1714
27844,48015,30-34,861,851,1712
27845,48015,35-39,846,855,1701
27846,48015,40-44,894,862,1756
27847,48015,45-49,800,853,1653
27848,48015,50-54,912,902,1814
27849,48015,55-59,1021,1026,2047
27850,48015,60-64,1082,1146,2228
27851,48015,65+,3318,2986,6304
27852,48017,15-19,281,292,573
27853,48017,20-24,237,212,449
27854,48017,25-29,193,199,392
27855,48017,30-34,208,185,393
27856,48017,35-39,225,212,437
27857,48017,40-44,195,183,378
27858,48017,45-49,175,202,377
27859,48017,50-54,175,170,345
27860,48017,55-59,175,189,364
27861,48017,60-64,175,204,379
27862,48017,65+,537,519,1056
27863,48019,15-19,467,519,986
27864,48019,20-24,428,457,885
27865,48019,25-29,432,446,878
27866,48019,30-34,464,489,953
27867,48019,35-39,520,554,1074
27868,48019,40-44,532,551,1083
27869,48019,45-49,576,587,1163
27870,48019,50-54,690,632,1322
27871,48019,55-59,965,887,1852
27872,48019,60-64,1105,992,2097
27873,48019,65+,3120,3101,6221
27874,48021,15-19,3583,3723,7306
27875,48021,20-24,2863,3235,6098
27876,48021,25-29,2849,3240,6089
27877,48021,30-34,3052,3434,6486
27878,48021,35-39,3096,3510,6606
27879,48021,40-44,2912,3315,6227
27880,48021,45-49,2867,3069,5936
27881,48021,50-54,3075,3176,6251
27882,48021,55-59,3315,3502,6817
27883,48021,60-64,3379,3471,6850
27884,48021,65+,8287,7657,15944
27885,48023,15-19,85,109,194
27886,48023,20-24,69,82,151
27887,48023,25-29,79,80,159
27888,48023,30-34,122,90,212
27889,48023,35-39,91,95,186
27890,48023,40-44,96,116,212
27891,48023,45-49,86,89,175
27892,48023,50-54,108,101,209
27893,48023,55-59,118,122,240
27894,48023,60-64,114,122,236
27895,48023,65+,471,368,839
27896,48025,15-19,916,1119,2035
27897,48025,20-24,742,1784,2526
27898,48025,25-29,732,1860,2592
27899,48025,30-34,767,1943,2710
27900,48025,35-39,765,1876,2641
27901,48025,40-44,674,1634,2308
27902,48025,45-49,636,1434,2070
27903,48025,50-54,635,1119,1754
27904,48025,55-59,712,862,1574
27905,48025,60-64,695,805,1500
27906,48025,65+,2122,1879,4001
27907,48027,15-19,12841,14061,26902
27908,48027,20-24,14149,17211,31360
27909,48027,25-29,15016,16494,31510
27910,48027,30-34,14674,14593,29267
27911,48027,35-39,13903,13595,27498
27912,48027,40-44,12317,12008,24325
27913,48027,45-49,10462,9951,20413
27914,48027,50-54,9756,9407,19163
27915,48027,55-59,10021,9162,19183
27916,48027,60-64,9549,8547,18096
27917,48027,65+,23843,19613,43456
27918,48029,15-19,71552,75061,146613
27919,48029,20-24,71249,74661,145910
27920,48029,25-29,76550,79993,156543
27921,48029,30-34,77892,81136,159028
27922,48029,35-39,74666,77818,152484
27923,48029,40-44,68030,68955,136985
27924,48029,45-49,62619,60903,123522
27925,48029,50-54,59108,57450,116558
27926,48029,55-59,57344,55108,112452
27927,48029,60-64,53620,48943,102563
27928,48029,65+,143025,111306,254331
27929,48031,15-19,315,363,678
27930,48031,20-24,255,336,591
27931,48031,25-29,234,270,504
27932,48031,30-34,266,254,520
27933,48031,35-39,306,325,631
27934,48031,40-44,302,336,638
27935,48031,45-49,356,335,691
27936,48031,50-54,396,381,777
27937,48031,55-59,491,488,979
27938,48031,60-64,618,551,1169
27939,48031,65+,1586,1490,3076
27940,48033,15-19,20,21,41
27941,48033,20-24,12,10,22
27942,48033,25-29,12,9,21
27943,48033,30-34,14,15,29
27944,48033,35-39,17,16,33
27945,48033,40-44,13,22,35
27946,48033,45-49,17,27,44
27947,48033,50-54,32,28,60
27948,48033,55-59,20,22,42
27949,48033,60-64,16,20,36
27950,48033,65+,71,75,146
27951,48035,15-19,533,552,1085
27952,48035,20-24,419,482,901
27953,48035,25-29,444,389,833
27954,48035,30-34,492,473,965
27955,48035,35-39,525,496,1021
27956,48035,40-44,505,485,990
27957,48035,45-49,494,479,973
27958,48035,50-54,600,583,1183
27959,48035,55-59,625,634,1259
27960,48035,60-64,772,758,1530
27961,48035,65+,2428,2210,4638
27962,48037,15-19,2826,3105,5931
27963,48037,20-24,2541,3113,5654
27964,48037,25-29,2930,3443,6373
27965,48037,30-34,2897,3438,6335
27966,48037,35-39,2855,3163,6018
27967,48037,40-44,2896,3091,5987
27968,48037,45-49,2624,2832,5456
27969,48037,50-54,2694,2926,5620
27970,48037,55-59,2883,2790,5673
27971,48037,60-64,2839,2769,5608
27972,48037,65+,8875,6967,15842
27973,48039,15-19,12840,13759,26599
27974,48039,20-24,10698,11518,22216
27975,48039,25-29,11458,12285,23743
27976,48039,30-34,13486,13875,27361
27977,48039,35-39,14598,15231,29829
27978,48039,40-44,13699,14714,28413
27979,48039,45-49,12530,13218,25748
27980,48039,50-54,11630,12535,24165
27981,48039,55-59,11043,11350,22393
27982,48039,60-64,10505,10413,20918
27983,48039,65+,25207,21934,47141
27984,48041,15-19,11470,11278,22748
27985,48041,20-24,20326,22850,43176
27986,48041,25-29,9162,9896,19058
27987,48041,30-34,8254,8360,16614
27988,48041,35-39,7497,7827,15324
27989,48041,40-44,6509,6712,13221
27990,48041,45-49,5463,5359,10822
27991,48041,50-54,5440,5263,10703
27992,48041,55-59,5310,5015,10325
27993,48041,60-64,5170,4834,10004
27994,48041,65+,12933,10928,23861
27995,48043,15-19,229,264,493
27996,48043,20-24,246,261,507
27997,48043,25-29,233,272,505
27998,48043,30-34,281,328,609
27999,48043,35-39,294,362,656
28000,48043,40-44,301,308,609
28001,48043,45-49,250,271,521
28002,48043,50-54,280,305,585
28003,48043,55-59,298,289,587
28004,48043,60-64,346,334,680
28005,48043,65+,1166,1161,2327
28006,48045,15-19,29,39,68
28007,48045,20-24,24,26,50
28008,48045,25-29,31,40,71
28009,48045,30-34,38,42,80
28010,48045,35-39,37,43,80
28011,48045,40-44,44,35,79
28012,48045,45-49,40,44,84
28013,48045,50-54,45,38,83
28014,48045,55-59,59,54,113
28015,48045,60-64,47,51,98
28016,48045,65+,162,173,335
28017,48047,15-19,224,244,468
28018,48047,20-24,195,249,444
28019,48047,25-29,173,266,439
28020,48047,30-34,198,255,453
28021,48047,35-39,201,217,418
28022,48047,40-44,172,220,392
28023,48047,45-49,153,176,329
28024,48047,50-54,169,145,314
28025,48047,55-59,206,200,406
28026,48047,60-64,196,180,376
28027,48047,65+,728,551,1279
28028,48049,15-19,1315,1343,2658
28029,48049,20-24,1134,1212,2346
28030,48049,25-29,998,1095,2093
28031,48049,30-34,1161,1188,2349
28032,48049,35-39,1190,1168,2358
28033,48049,40-44,1131,1179,2310
28034,48049,45-49,1122,1108,2230
28035,48049,50-54,1153,1164,2317
28036,48049,55-59,1327,1299,2626
28037,48049,60-64,1373,1330,2703
28038,48049,65+,4217,3686,7903
28039,48051,15-19,491,550,1041
28040,48051,20-24,441,469,910
28041,48051,25-29,497,461,958
28042,48051,30-34,550,529,1079
28043,48051,35-39,513,516,1029
28044,48051,40-44,482,485,967
28045,48051,45-49,505,464,969
28046,48051,50-54,580,577,1157
28047,48051,55-59,679,676,1355
28048,48051,60-64,737,721,1458
28049,48051,65+,1993,1859,3852
28050,48053,15-19,1490,1523,3013
28051,48053,20-24,1329,1380,2709
28052,48053,25-29,1405,1338,2743
28053,48053,30-34,1400,1421,2821
28054,48053,35-39,1508,1445,2953
28055,48053,40-44,1478,1306,2784
28056,48053,45-49,1412,1407,2819
28057,48053,50-54,1502,1481,2983
28058,48053,55-59,1811,1732,3543
28059,48053,60-64,2240,2083,4323
28060,48053,65+,6150,5563,11713
28061,48055,15-19,1671,2031,3702
28062,48055,20-24,1569,2085,3654
28063,48055,25-29,1574,1606,3180
28064,48055,30-34,1574,1640,3214
28065,48055,35-39,1579,1636,3215
28066,48055,40-44,1453,1477,2930
28067,48055,45-49,1406,1359,2765
28068,48055,50-54,1398,1427,2825
28069,48055,55-59,1448,1497,2945
28070,48055,60-64,1395,1427,2822
28071,48055,65+,3735,3305,7040
28072,48057,15-19,629,693,1322
28073,48057,20-24,530,655,1185
28074,48057,25-29,531,624,1155
28075,48057,30-34,556,654,1210
28076,48057,35-39,561,613,1174
28077,48057,40-44,603,588,1191
28078,48057,45-49,499,538,1037
28079,48057,50-54,559,570,1129
28080,48057,55-59,659,712,1371
28081,48057,60-64,643,680,1323
28082,48057,65+,1878,1878,3756
28083,48059,15-19,385,446,831
28084,48059,20-24,341,332,673
28085,48059,25-29,354,326,680
28086,48059,30-34,436,448,884
28087,48059,35-39,460,451,911
28088,48059,40-44,435,431,866
28089,48059,45-49,429,403,832
28090,48059,50-54,451,433,884
28091,48059,55-59,465,504,969
28092,48059,60-64,551,516,1067
28093,48059,65+,1569,1426,2995
28094,48061,15-19,17740,18541,36281
28095,48061,20-24,15557,16445,32002
28096,48061,25-29,13796,14657,28453
28097,48061,30-34,12568,12721,25289
28098,48061,35-39,12198,12199,24397
28099,48061,40-44,12752,12527,25279
28100,48061,45-49,13246,12395,25641
28101,48061,50-54,12486,10976,23462
28102,48061,55-59,11346,9915,21261
28103,48061,60-64,10739,9367,20106
28104,48061,65+,32850,26386,59236
28105,48063,15-19,427,444,871
28106,48063,20-24,395,355,750
28107,48063,25-29,385,396,781
28108,48063,30-34,379,367,746
28109,48063,35-39,347,315,662
28110,48063,40-44,384,331,715
28111,48063,45-49,305,274,579
28112,48063,50-54,404,357,761
28113,48063,55-59,404,400,804
28114,48063,60-64,416,387,803
28115,48063,65+,1231,1177,2408
28116,48065,15-19,187,209,396
28117,48065,20-24,132,132,264
28118,48065,25-29,150,146,296
28119,48065,30-34,168,173,341
28120,48065,35-39,175,192,367
28121,48065,40-44,190,173,363
28122,48065,45-49,152,167,319
28123,48065,50-54,167,178,345
28124,48065,55-59,188,187,375
28125,48065,60-64,192,196,388
28126,48065,65+,637,580,1217
28127,48067,15-19,844,925,1769
28128,48067,20-24,718,737,1455
28129,48067,25-29,743,746,1489
28130,48067,30-34,756,691,1447
28131,48067,35-39,835,715,1550
28132,48067,40-44,868,776,1644
28133,48067,45-49,847,755,1602
28134,48067,50-54,899,904,1803
28135,48067,55-59,1056,955,2011
28136,48067,60-64,1048,1055,2103
28137,48067,65+,3477,2930,6407
28138,48069,15-19,291,300,591
28139,48069,20-24,259,250,509
28140,48069,25-29,231,225,456
28141,48069,30-34,198,212,410
28142,48069,35-39,199,202,401
28143,48069,40-44,203,224,427
28144,48069,45-49,185,195,380
28145,48069,50-54,163,193,356
28146,48069,55-59,182,206,388
28147,48069,60-64,209,225,434
28148,48069,65+,631,627,1258
28149,48071,15-19,1699,1891,3590
28150,48071,20-24,1398,1461,2859
28151,48071,25-29,1639,1619,3258
28152,48071,30-34,1797,1752,3549
28153,48071,35-39,1816,1884,3700
28154,48071,40-44,1722,1850,3572
28155,48071,45-49,1540,1586,3126
28156,48071,50-54,1526,1516,3042
28157,48071,55-59,1238,1398,2636
28158,48071,60-64,1198,1230,2428
28159,48071,65+,2967,2767,5734
28160,48073,15-19,1709,2089,3798
28161,48073,20-24,1441,1842,3283
28162,48073,25-29,1386,1666,3052
28163,48073,30-34,1505,1578,3083
28164,48073,35-39,1388,1491,2879
28165,48073,40-44,1464,1567,3031
28166,48073,45-49,1431,1687,3118
28167,48073,50-54,1421,1618,3039
28168,48073,55-59,1495,1580,3075
28169,48073,60-64,1501,1454,2955
28170,48073,65+,4853,4256,9109
28171,48075,15-19,166,227,393
28172,48075,20-24,124,617,741
28173,48075,25-29,150,681,831
28174,48075,30-34,132,419,551
28175,48075,35-39,165,290,455
28176,48075,40-44,197,256,453
28177,48075,45-49,137,198,335
28178,48075,50-54,127,165,292
28179,48075,55-59,150,156,306
28180,48075,60-64,182,161,343
28181,48075,65+,556,462,1018
28182,48077,15-19,275,324,599
28183,48077,20-24,240,263,503
28184,48077,25-29,248,263,511
28185,48077,30-34,247,264,511
28186,48077,35-39,287,266,553
28187,48077,40-44,312,313,625
28188,48077,45-49,308,295,603
28189,48077,50-54,308,321,629
28190,48077,55-59,401,396,797
28191,48077,60-64,415,455,870
28192,48077,65+,1261,1183,2444
28193,48079,15-19,106,85,191
28194,48079,20-24,65,77,142
28195,48079,25-29,72,72,144
28196,48079,30-34,77,92,169
28197,48079,35-39,91,86,177
28198,48079,40-44,65,76,141
28199,48079,45-49,75,63,138
28200,48079,50-54,77,80,157
28201,48079,55-59,82,81,163
28202,48079,60-64,69,74,143
28203,48079,65+,211,201,412
28204,48081,15-19,91,74,165
28205,48081,20-24,95,79,174
28206,48081,25-29,81,84,165
28207,48081,30-34,87,100,187
28208,48081,35-39,91,99,190
28209,48081,40-44,84,88,172
28210,48081,45-49,73,69,142
28211,48081,50-54,101,89,190
28212,48081,55-59,127,114,241
28213,48081,60-64,121,150,271
28214,48081,65+,449,389,838
28215,48083,15-19,222,233,455
28216,48083,20-24,181,189,370
28217,48083,25-29,162,179,341
28218,48083,30-34,194,152,346
28219,48083,35-39,181,205,386
28220,48083,40-44,211,195,406
28221,48083,45-49,220,209,429
28222,48083,50-54,210,259,469
28223,48083,55-59,273,286,559
28224,48083,60-64,353,332,685
28225,48083,65+,998,1016,2014
28226,48085,15-19,38742,41100,79842
28227,48085,20-24,32254,32707,64961
28228,48085,25-29,33856,34042,67898
28229,48085,30-34,37988,36686,74674
28230,48085,35-39,44473,42568,87041
28231,48085,40-44,45490,44102,89592
28232,48085,45-49,42616,43152,85768
28233,48085,50-54,39484,40701,80185
28234,48085,55-59,34528,35064,69592
28235,48085,60-64,28628,28842,57470
28236,48085,65+,69602,56413,126015
28237,48087,15-19,89,80,169
28238,48087,20-24,63,68,131
28239,48087,25-29,65,67,132
28240,48087,30-34,72,66,138
28241,48087,35-39,96,93,189
28242,48087,40-44,72,76,148
28243,48087,45-49,63,65,128
28244,48087,50-54,77,79,156
28245,48087,55-59,83,73,156
28246,48087,60-64,94,91,185
28247,48087,65+,275,238,513
28248,48089,15-19,601,638,1239
28249,48089,20-24,551,583,1134
28250,48089,25-29,522,613,1135
28251,48089,30-34,544,537,1081
28252,48089,35-39,524,573,1097
28253,48089,40-44,517,525,1042
28254,48089,45-49,508,522,1030
28255,48089,50-54,597,622,1219
28256,48089,55-59,633,696,1329
28257,48089,60-64,800,784,1584
28258,48089,65+,2432,2187,4619
28259,48091,15-19,5404,5619,11023
28260,48091,20-24,4561,4734,9295
28261,48091,25-29,4956,4974,9930
28262,48091,30-34,5184,5207,10391
28263,48091,35-39,5706,5771,11477
28264,48091,40-44,5501,5724,11225
28265,48091,45-49,5523,5514,11037
28266,48091,50-54,5747,5938,11685
28267,48091,55-59,6398,5978,12376
28268,48091,60-64,6474,6256,12730
28269,48091,65+,16909,15096,32005
28270,48093,15-19,431,435,866
28271,48093,20-24,352,394,746
28272,48093,25-29,331,364,695
28273,48093,30-34,365,353,718
28274,48093,35-39,347,325,672
28275,48093,40-44,353,374,727
28276,48093,45-49,398,330,728
28277,48093,50-54,425,433,858
28278,48093,55-59,481,528,1009
28279,48093,60-64,470,540,1010
28280,48093,65+,1684,1529,3213
28281,48095,15-19,97,94,191
28282,48095,20-24,68,68,136
28283,48095,25-29,82,64,146
28284,48095,30-34,64,106,170
28285,48095,35-39,75,118,193
28286,48095,40-44,74,115,189
28287,48095,45-49,83,122,205
28288,48095,50-54,94,134,228
28289,48095,55-59,104,154,258
28290,48095,60-64,135,139,274
28291,48095,65+,446,450,896
28292,48097,15-19,1220,1569,2789
28293,48097,20-24,1186,1175,2361
28294,48097,25-29,1229,1299,2528
28295,48097,30-34,1327,1277,2604
28296,48097,35-39,1266,1243,2509
28297,48097,40-44,1230,1229,2459
28298,48097,45-49,1143,1109,2252
28299,48097,50-54,1301,1233,2534
28300,48097,55-59,1471,1450,2921
28301,48097,60-64,1582,1485,3067
28302,48097,65+,4291,3810,8101
28303,48099,15-19,2161,2559,4720
28304,48099,20-24,3325,5194,8519
28305,48099,25-29,3978,4351,8329
28306,48099,30-34,3847,3776,7623
28307,48099,35-39,3563,3472,7035
28308,48099,40-44,3215,2863,6078
28309,48099,45-49,2749,2380,5129
28310,48099,50-54,2275,1981,4256
28311,48099,55-59,1993,1757,3750
28312,48099,60-64,1937,1630,3567
28313,48099,65+,5147,3964,9111
28314,48101,15-19,45,57,102
28315,48101,20-24,29,28,57
28316,48101,25-29,27,28,55
28317,48101,30-34,25,26,51
28318,48101,35-39,48,43,91
28319,48101,40-44,45,44,89
28320,48101,45-49,35,24,59
28321,48101,50-54,46,35,81
28322,48101,55-59,59,51,110
28323,48101,60-64,52,60,112
28324,48101,65+,189,164,353
28325,48103,15-19,187,199,386
28326,48103,20-24,156,151,307
28327,48103,25-29,144,154,298
28328,48103,30-34,130,154,284
28329,48103,35-39,158,176,334
28330,48103,40-44,151,147,298
28331,48103,45-49,137,147,284
28332,48103,50-54,124,128,252
28333,48103,55-59,134,157,291
28334,48103,60-64,116,123,239
28335,48103,65+,301,270,571
28336,48105,15-19,106,90,196
28337,48105,20-24,83,75,158
28338,48105,25-29,97,78,175
28339,48105,30-34,70,83,153
28340,48105,35-39,87,107,194
28341,48105,40-44,97,94,191
28342,48105,45-49,84,105,189
28343,48105,50-54,79,95,174
28344,48105,55-59,106,99,205
28345,48105,60-64,95,108,203
28346,48105,65+,303,279,582
28347,48107,15-19,189,213,402
28348,48107,20-24,141,145,286
28349,48107,25-29,152,150,302
28350,48107,30-34,117,156,273
28351,48107,35-39,150,161,311
28352,48107,40-44,160,150,310
28353,48107,45-49,133,133,266
28354,48107,50-54,150,125,275
28355,48107,55-59,172,154,326
28356,48107,60-64,149,173,322
28357,48107,65+,493,465,958
28358,48109,15-19,69,66,135
28359,48109,20-24,52,70,122
28360,48109,25-29,66,86,152
28361,48109,30-34,60,69,129
28362,48109,35-39,61,70,131
28363,48109,40-44,52,63,115
28364,48109,45-49,51,53,104
28365,48109,50-54,71,56,127
28366,48109,55-59,78,76,154
28367,48109,60-64,63,74,137
28368,48109,65+,258,199,457
28369,48111,15-19,262,304,566
28370,48111,20-24,181,223,404
28371,48111,25-29,220,243,463
28372,48111,30-34,214,271,485
28373,48111,35-39,223,259,482
28374,48111,40-44,182,191,373
28375,48111,45-49,196,219,415
28376,48111,50-54,182,240,422
28377,48111,55-59,174,223,397
28378,48111,60-64,160,165,325
28379,48111,65+,427,420,847
28380,48113,15-19,88058,90986,179044
28381,48113,20-24,89409,88814,178223
28382,48113,25-29,107869,108148,216017
28383,48113,30-34,102570,104209,206779
28384,48113,35-39,92301,94413,186714
28385,48113,40-44,84998,85245,170243
28386,48113,45-49,81358,77948,159306
28387,48113,50-54,78218,78169,156387
28388,48113,55-59,75143,75444,150587
28389,48113,60-64,69618,67277,136895
28390,48113,65+,166353,131307,297660
28391,48115,15-19,364,445,809
28392,48115,20-24,310,658,968
28393,48115,25-29,315,719,1034
28394,48115,30-34,333,613,946
28395,48115,35-39,304,536,840
28396,48115,40-44,330,450,780
28397,48115,45-49,303,385,688
28398,48115,50-54,286,297,583
28399,48115,55-59,304,344,648
28400,48115,60-64,313,331,644
28401,48115,65+,1006,761,1767
28402,48117,15-19,726,794,1520
28403,48117,20-24,642,630,1272
28404,48117,25-29,579,638,1217
28405,48117,30-34,584,615,1199
28406,48117,35-39,557,524,1081
28407,48117,40-44,519,551,1070
28408,48117,45-49,510,522,1032
28409,48117,50-54,472,468,940
28410,48117,55-59,444,490,934
28411,48117,60-64,448,458,906
28412,48117,65+,1286,1112,2398
28413,48119,15-19,165,151,316
28414,48119,20-24,127,132,259
28415,48119,25-29,155,150,305
28416,48119,30-34,158,163,321
28417,48119,35-39,146,145,291
28418,48119,40-44,137,163,300
28419,48119,45-49,145,155,300
28420,48119,50-54,178,152,330
28421,48119,55-59,187,178,365
28422,48119,60-64,176,195,371
28423,48119,65+,620,551,1171
28424,48121,15-19,33522,33500,67022
28425,48121,20-24,30827,29942,60769
28426,48121,25-29,32468,32046,64514
28427,48121,30-34,36518,34719,71237
28428,48121,35-39,37380,36438,73818
28429,48121,40-44,36880,35956,72836
28430,48121,45-49,34560,34636,69196
28431,48121,50-54,32789,33538,66327
28432,48121,55-59,29330,29474,58804
28433,48121,60-64,25714,24782,50496
28434,48121,65+,57505,47081,104586
28435,48123,15-19,548,595,1143
28436,48123,20-24,471,537,1008
28437,48123,25-29,462,580,1042
28438,48123,30-34,520,743,1263
28439,48123,35-39,530,765,1295
28440,48123,40-44,518,788,1306
28441,48123,45-49,449,721,1170
28442,48123,50-54,554,687,1241
28443,48123,55-59,612,716,1328
28444,48123,60-64,689,720,1409
28445,48123,65+,2186,1765,3951
28446,48125,15-19,53,72,125
28447,48125,20-24,26,69,95
28448,48125,25-29,33,96,129
28449,48125,30-34,22,83,105
28450,48125,35-39,31,63,94
28451,48125,40-44,36,68,104
28452,48125,45-49,53,64,117
28453,48125,50-54,41,45,86
28454,48125,55-59,50,49,99
28455,48125,60-64,64,64,128
28456,48125,65+,237,193,430
28457,48127,15-19,367,340,707
28458,48127,20-24,305,265,570
28459,48127,25-29,235,241,476
28460,48127,30-34,244,257,501
28461,48127,35-39,240,250,490
28462,48127,40-44,252,250,502
28463,48127,45-49,252,235,487
28464,48127,50-54,242,207,449
28465,48127,55-59,233,220,453
28466,48127,60-64,203,220,423
28467,48127,65+,789,660,1449
28468,48129,15-19,161,154,315
28469,48129,20-24,85,110,195
28470,48129,25-29,85,80,165
28471,48129,30-34,61,64,125
28472,48129,35-39,78,87,165
28473,48129,40-44,99,80,179
28474,48129,45-49,82,84,166
28475,48129,50-54,72,82,154
28476,48129,55-59,111,116,227
28477,48129,60-64,123,107,230
28478,48129,65+,448,367,815
28479,48131,15-19,331,374,705
28480,48131,20-24,277,386,663
28481,48131,25-29,280,375,655
28482,48131,30-34,272,336,608
28483,48131,35-39,259,315,574
28484,48131,40-44,274,299,573
28485,48131,45-49,249,289,538
28486,48131,50-54,244,268,512
28487,48131,55-59,269,272,541
28488,48131,60-64,270,266,536
28489,48131,65+,927,780,1707
28490,48133,15-19,672,742,1414
28491,48133,20-24,466,594,1060
28492,48133,25-29,501,493,994
28493,48133,30-34,445,496,941
28494,48133,35-39,488,471,959
28495,48133,40-44,497,534,1031
28496,48133,45-49,474,435,909
28497,48133,50-54,503,475,978
28498,48133,55-59,585,586,1171
28499,48133,60-64,694,675,1369
28500,48133,65+,2059,1855,3914
28501,48135,15-19,6121,6370,12491
28502,48135,20-24,5382,5675,11057
28503,48135,25-29,5775,6358,12133
28504,48135,30-34,6019,7007,13026
28505,48135,35-39,5619,6520,12139
28506,48135,40-44,4786,5494,10280
28507,48135,45-49,4345,4622,8967
28508,48135,50-54,4044,4216,8260
28509,48135,55-59,3866,3933,7799
28510,48135,60-64,3653,3649,7302
28511,48135,65+,8556,7144,15700
28512,48137,15-19,36,52,88
28513,48137,20-24,28,28,56
28514,48137,25-29,30,30,60
28515,48137,30-34,25,36,61
28516,48137,35-39,27,33,60
28517,48137,40-44,38,38,76
28518,48137,45-49,37,36,73
28519,48137,50-54,43,44,87
28520,48137,55-59,50,57,107
28521,48137,60-64,50,44,94
28522,48137,65+,186,229,415
28523,48139,15-19,7265,7743,15008
28524,48139,20-24,5933,6307,12240
28525,48139,25-29,6315,6127,12442
28526,48139,30-34,7117,6773,13890
28527,48139,35-39,7469,7084,14553
28528,48139,40-44,7019,6783,13802
28529,48139,45-49,6734,6267,13001
28530,48139,50-54,6424,6655,13079
28531,48139,55-59,6375,6221,12596
28532,48139,60-64,5959,5827,11786
28533,48139,65+,14427,12010,26437
28534,48141,15-19,31709,33896,65605
28535,48141,20-24,32105,37516,69621
28536,48141,25-29,32521,36277,68798
28537,48141,30-34,30159,32974,63133
28538,48141,35-39,28533,30644,59177
28539,48141,40-44,25656,26188,51844
28540,48141,45-49,26279,24857,51136
28541,48141,50-54,24753,22837,47590
28542,48141,55-59,24338,21975,46313
28543,48141,60-64,23671,20342,44013
28544,48141,65+,62869,47957,110826
28545,48143,15-19,2461,2153,4614
28546,48143,20-24,2795,2714,5509
28547,48143,25-29,1451,1400,2851
28548,48143,30-34,1318,1282,2600
28549,48143,35-39,1202,1229,2431
28550,48143,40-44,1132,1163,2295
28551,48143,45-49,1033,1019,2052
28552,48143,50-54,1111,1100,2211
28553,48143,55-59,1226,1223,2449
28554,48143,60-64,1190,1190,2380
28555,48143,65+,3442,2942,6384
28556,48145,15-19,423,504,927
28557,48145,20-24,535,573,1108
28558,48145,25-29,668,521,1189
28559,48145,30-34,725,542,1267
28560,48145,35-39,685,482,1167
28561,48145,40-44,602,479,1081
28562,48145,45-49,553,415,968
28563,48145,50-54,540,483,1023
28564,48145,55-59,625,555,1180
28565,48145,60-64,550,532,1082
28566,48145,65+,1675,1548,3223
28567,48147,15-19,1037,1235,2272
28568,48147,20-24,816,1323,2139
28569,48147,25-29,885,1395,2280
28570,48147,30-34,1027,1331,2358
28571,48147,35-39,1059,1368,2427
28572,48147,40-44,1033,1310,2343
28573,48147,45-49,1022,1231,2253
28574,48147,50-54,1140,1291,2431
28575,48147,55-59,1211,1347,2558
28576,48147,60-64,1273,1275,2548
28577,48147,65+,3436,3191,6627
28578,48149,15-19,710,742,1452
28579,48149,20-24,586,568,1154
28580,48149,25-29,583,617,1200
28581,48149,30-34,593,568,1161
28582,48149,35-39,703,650,1353
28583,48149,40-44,635,686,1321
28584,48149,45-49,646,679,1325
28585,48149,50-54,651,668,1319
28586,48149,55-59,922,878,1800
28587,48149,60-64,1018,1004,2022
28588,48149,65+,3436,3128,6564
28589,48151,15-19,107,116,223
28590,48151,20-24,75,96,171
28591,48151,25-29,105,95,200
28592,48151,30-34,94,111,205
28593,48151,35-39,101,100,201
28594,48151,40-44,92,101,193
28595,48151,45-49,106,90,196
28596,48151,50-54,101,112,213
28597,48151,55-59,123,134,257
28598,48151,60-64,129,139,268
28599,48151,65+,467,434,901
28600,48153,15-19,191,217,408
28601,48153,20-24,147,148,295
28602,48153,25-29,148,147,295
28603,48153,30-34,149,149,298
28604,48153,35-39,155,154,309
28605,48153,40-44,153,155,308
28606,48153,45-49,144,157,301
28607,48153,50-54,142,176,318
28608,48153,55-59,161,139,300
28609,48153,60-64,166,172,338
28610,48153,65+,536,510,1046
28611,48155,15-19,33,36,69
28612,48155,20-24,28,13,41
28613,48155,25-29,26,25,51
28614,48155,30-34,28,19,47
28615,48155,35-39,28,31,59
28616,48155,40-44,26,16,42
28617,48155,45-49,27,24,51
28618,48155,50-54,37,40,77
28619,48155,55-59,43,43,86
28620,48155,60-64,41,45,86
28621,48155,65+,159,138,297
28622,48157,15-19,31236,32811,64047
28623,48157,20-24,24647,24699,49346
28624,48157,25-29,23349,22780,46129
28625,48157,30-34,28177,25190,53367
28626,48157,35-39,34291,31480,65771
28627,48157,40-44,34657,33162,67819
28628,48157,45-49,32346,31417,63763
28629,48157,50-54,28612,28853,57465
28630,48157,55-59,25519,24799,50318
28631,48157,60-64,24107,23107,47214
28632,48157,65+,55651,48052,103703
28633,48159,15-19,336,371,707
28634,48159,20-24,273,232,505
28635,48159,25-29,274,263,537
28636,48159,30-34,282,277,559
28637,48159,35-39,320,315,635
28638,48159,40-44,280,270,550
28639,48159,45-49,291,294,585
28640,48159,50-54,302,321,623
28641,48159,55-59,355,363,718
28642,48159,60-64,398,391,789
28643,48159,65+,1170,1126,2296
28644,48161,15-19,627,613,1240
28645,48161,20-24,464,488,952
28646,48161,25-29,462,519,981
28647,48161,30-34,492,690,1182
28648,48161,35-39,543,710,1253
28649,48161,40-44,572,835,1407
28650,48161,45-49,525,755,1280
28651,48161,50-54,530,684,1214
28652,48161,55-59,617,668,1285
28653,48161,60-64,667,647,1314
28654,48161,65+,2141,1852,3993
28655,48163,15-19,582,701,1283
28656,48163,20-24,539,1335,1874
28657,48163,25-29,490,1457,1947
28658,48163,30-34,403,1198,1601
28659,48163,35-39,424,918,1342
28660,48163,40-44,422,663,1085
28661,48163,45-49,424,546,970
28662,48163,50-54,400,527,927
28663,48163,55-59,449,459,908
28664,48163,60-64,368,379,747
28665,48163,65+,1236,1011,2247
28666,48165,15-19,992,1004,1996
28667,48165,20-24,702,699,1401
28668,48165,25-29,690,755,1445
28669,48165,30-34,675,745,1420
28670,48165,35-39,690,771,1461
28671,48165,40-44,648,672,1320
28672,48165,45-49,538,591,1129
28673,48165,50-54,474,501,975
28674,48165,55-59,556,597,1153
28675,48165,60-64,464,540,1004
28676,48165,65+,995,918,1913
28677,48167,15-19,11809,12529,24338
28678,48167,20-24,10300,10640,20940
28679,48167,25-29,11071,10910,21981
28680,48167,30-34,11943,11473,23416
28681,48167,35-39,12572,12010,24582
28682,48167,40-44,12307,11708,24015
28683,48167,45-49,11248,11113,22361
28684,48167,50-54,11492,11165,22657
28685,48167,55-59,12067,11476,23543
28686,48167,60-64,11901,11661,23562
28687,48167,65+,29089,24944,54033
28688,48169,15-19,117,259,376
28689,48169,20-24,107,460,567
28690,48169,25-29,132,551,683
28691,48169,30-34,152,371,523
28692,48169,35-39,112,243,355
28693,48169,40-44,115,269,384
28694,48169,45-49,127,344,471
28695,48169,50-54,152,219,371
28696,48169,55-59,122,289,411
28697,48169,60-64,126,154,280
28698,48169,65+,361,329,690
28699,48171,15-19,709,819,1528
28700,48171,20-24,625,693,1318
28701,48171,25-29,632,630,1262
28702,48171,30-34,589,582,1171
28703,48171,35-39,684,668,1352
28704,48171,40-44,713,653,1366
28705,48171,45-49,678,646,1324
28706,48171,50-54,792,687,1479
28707,48171,55-59,954,891,1845
28708,48171,60-64,1173,1058,2231
28709,48171,65+,4261,3746,8007
28710,48173,15-19,32,47,79
28711,48173,20-24,35,26,61
28712,48173,25-29,33,40,73
28713,48173,30-34,35,68,103
28714,48173,35-39,24,43,67
28715,48173,40-44,39,34,73
28716,48173,45-49,34,38,72
28717,48173,50-54,28,36,64
28718,48173,55-59,37,38,75
28719,48173,60-64,34,40,74
28720,48173,65+,71,86,157
28721,48175,15-19,198,221,419
28722,48175,20-24,176,190,366
28723,48175,25-29,186,181,367
28724,48175,30-34,179,185,364
28725,48175,35-39,214,215,429
28726,48175,40-44,205,204,409
28727,48175,45-49,207,210,417
28728,48175,50-54,221,212,433
28729,48175,55-59,243,230,473
28730,48175,60-64,285,298,583
28731,48175,65+,872,813,1685
28732,48177,15-19,727,774,1501
28733,48177,20-24,558,593,1151
28734,48177,25-29,545,566,1111
28735,48177,30-34,581,585,1166
28736,48177,35-39,573,594,1167
28737,48177,40-44,540,568,1108
28738,48177,45-49,571,530,1101
28739,48177,50-54,588,560,1148
28740,48177,55-59,608,625,1233
28741,48177,60-64,623,640,1263
28742,48177,65+,1782,1654,3436
28743,48179,15-19,703,715,1418
28744,48179,20-24,512,615,1127
28745,48179,25-29,559,826,1385
28746,48179,30-34,593,827,1420
28747,48179,35-39,617,821,1438
28748,48179,40-44,554,857,1411
28749,48179,45-49,471,796,1267
28750,48179,50-54,550,786,1336
28751,48179,55-59,525,681,1206
28752,48179,60-64,604,643,1247
28753,48179,65+,1893,1579,3472
28754,48181,15-19,4589,4759,9348
28755,48181,20-24,4085,4184,8269
28756,48181,25-29,4217,4075,8292
28757,48181,30-34,4404,4167,8571
28758,48181,35-39,4486,4226,8712
28759,48181,40-44,4100,4112,8212
28760,48181,45-49,4009,3955,7964
28761,48181,50-54,4374,4178,8552
28762,48181,55-59,4753,4571,9324
28763,48181,60-64,4939,4599,9538
28764,48181,65+,13737,11456,25193
28765,48183,15-19,4243,4743,8986
28766,48183,20-24,3977,4315,8292
28767,48183,25-29,4188,4028,8216
28768,48183,30-34,4235,4080,8315
28769,48183,35-39,4118,3999,8117
28770,48183,40-44,3822,3762,7584
28771,48183,45-49,3471,3245,6716
28772,48183,50-54,3581,3470,7051
28773,48183,55-59,3774,3422,7196
28774,48183,60-64,3912,3638,7550
28775,48183,65+,11006,8574,19580
28776,48185,15-19,865,984,1849
28777,48185,20-24,717,1061,1778
28778,48185,25-29,753,1197,1950
28779,48185,30-34,807,1093,1900
28780,48185,35-39,811,1152,1963
28781,48185,40-44,770,1081,1851
28782,48185,45-49,784,1094,1878
28783,48185,50-54,776,1089,1865
28784,48185,55-59,942,1123,2065
28785,48185,60-64,960,1136,2096
28786,48185,65+,2790,2799,5589
28787,48187,15-19,6083,6493,12576
28788,48187,20-24,5200,5332,10532
28789,48187,25-29,5371,5436,10807
28790,48187,30-34,5931,6002,11933
28791,48187,35-39,6551,6809,13360
28792,48187,40-44,6408,6447,12855
28793,48187,45-49,5834,5915,11749
28794,48187,50-54,5640,5717,11357
28795,48187,55-59,5583,5459,11042
28796,48187,60-64,5155,4787,9942
28797,48187,65+,13932,11811,25743
28798,48189,15-19,1234,1359,2593
28799,48189,20-24,1057,1525,2582
28800,48189,25-29,900,1345,2245
28801,48189,30-34,950,1287,2237
28802,48189,35-39,958,1197,2155
28803,48189,40-44,906,1057,1963
28804,48189,45-49,828,978,1806
28805,48189,50-54,813,945,1758
28806,48189,55-59,884,906,1790
28807,48189,60-64,858,854,1712
28808,48189,65+,2356,2052,4408
28809,48191,15-19,96,113,209
28810,48191,20-24,71,84,155
28811,48191,25-29,60,90,150
28812,48191,30-34,65,75,140
28813,48191,35-39,70,68,138
28814,48191,40-44,78,64,142
28815,48191,45-49,78,67,145
28816,48191,50-54,88,86,174
28817,48191,55-59,94,116,210
28818,48191,60-64,108,101,209
28819,48191,65+,362,332,694
28820,48193,15-19,215,262,477
28821,48193,20-24,208,191,399
28822,48193,25-29,189,220,409
28823,48193,30-34,232,237,469
28824,48193,35-39,216,234,450
28825,48193,40-44,206,230,436
28826,48193,45-49,233,208,441
28827,48193,50-54,231,212,443
28828,48193,55-59,286,288,574
28829,48193,60-64,319,317,636
28830,48193,65+,1111,931,2042
28831,48195,15-19,224,229,453
28832,48195,20-24,156,180,336
28833,48195,25-29,143,147,290
28834,48195,30-34,149,149,298
28835,48195,35-39,128,154,282
28836,48195,40-44,154,120,274
28837,48195,45-49,151,152,303
28838,48195,50-54,137,152,289
28839,48195,55-59,150,177,327
28840,48195,60-64,143,142,285
28841,48195,65+,428,376,804
28842,48197,15-19,96,128,224
28843,48197,20-24,87,111,198
28844,48197,25-29,106,106,212
28845,48197,30-34,88,80,168
28846,48197,35-39,105,130,235
28847,48197,40-44,114,84,198
28848,48197,45-49,93,111,204
28849,48197,50-54,109,105,214
28850,48197,55-59,113,101,214
28851,48197,60-64,128,121,249
28852,48197,65+,412,382,794
28853,48199,15-19,1811,1881,3692
28854,48199,20-24,1473,1547,3020
28855,48199,25-29,1646,1661,3307
28856,48199,30-34,1879,1870,3749
28857,48199,35-39,1942,1820,3762
28858,48199,40-44,1824,1858,3682
28859,48199,45-49,1721,1623,3344
28860,48199,50-54,1676,1853,3529
28861,48199,55-59,1839,1788,3627
28862,48199,60-64,1953,1843,3796
28863,48199,65+,5407,4423,9830
28864,48201,15-19,162137,170754,332891
28865,48201,20-24,156213,157474,313687
28866,48201,25-29,178599,177786,356385
28867,48201,30-34,184685,186471,371156
28868,48201,35-39,175472,181536,357008
28869,48201,40-44,163591,167404,330995
28870,48201,45-49,151202,151154,302356
28871,48201,50-54,143696,143961,287657
28872,48201,55-59,132872,131272,264144
28873,48201,60-64,124580,119588,244168
28874,48201,65+,294865,242252,537117
28875,48203,15-19,2347,2567,4914
28876,48203,20-24,2043,2104,4147
28877,48203,25-29,1915,1864,3779
28878,48203,30-34,2105,1984,4089
28879,48203,35-39,2297,2086,4383
28880,48203,40-44,2185,1999,4184
28881,48203,45-49,1957,1993,3950
28882,48203,50-54,2078,2090,4168
28883,48203,55-59,2349,2230,4579
28884,48203,60-64,2304,2332,4636
28885,48203,65+,6779,5664,12443
28886,48205,15-19,141,169,310
28887,48205,20-24,126,131,257
28888,48205,25-29,141,264,405
28889,48205,30-34,124,311,435
28890,48205,35-39,91,307,398
28891,48205,40-44,125,295,420
28892,48205,45-49,105,336,441
28893,48205,50-54,120,261,381
28894,48205,55-59,116,192,308
28895,48205,60-64,126,155,281
28896,48205,65+,438,393,831
28897,48207,15-19,134,156,290
28898,48207,20-24,124,225,349
28899,48207,25-29,134,229,363
28900,48207,30-34,143,215,358
28901,48207,35-39,158,212,370
28902,48207,40-44,140,187,327
28903,48207,45-49,133,167,300
28904,48207,50-54,138,161,299
28905,48207,55-59,183,175,358
28906,48207,60-64,186,201,387
28907,48207,65+,639,576,1215
28908,48209,15-19,10226,9919,20145
28909,48209,20-24,14641,13767,28408
28910,48209,25-29,8432,9270,17702
28911,48209,30-34,8708,9311,18019
28912,48209,35-39,9824,9656,19480
28913,48209,40-44,8691,9241,17932
28914,48209,45-49,7610,7872,15482
28915,48209,50-54,6919,7127,14046
28916,48209,55-59,6803,6423,13226
28917,48209,60-64,6723,6299,13022
28918,48209,65+,16153,13735,29888
28919,48211,15-19,176,152,328
28920,48211,20-24,100,81,181
28921,48211,25-29,70,61,131
28922,48211,30-34,73,78,151
28923,48211,35-39,112,109,221
28924,48211,40-44,128,116,244
28925,48211,45-49,111,110,221
28926,48211,50-54,74,89,163
28927,48211,55-59,83,99,182
28928,48211,60-64,97,86,183
28929,48211,65+,287,248,535
28930,48213,15-19,2375,2753,5128
28931,48213,20-24,2199,2350,4549
28932,48213,25-29,2302,2288,4590
28933,48213,30-34,2378,2199,4577
28934,48213,35-39,2355,2305,4660
28935,48213,40-44,2382,2212,4594
28936,48213,45-49,2327,2168,4495
28937,48213,50-54,2723,2565,5288
28938,48213,55-59,2920,2797,5717
28939,48213,60-64,3468,3128,6596
28940,48213,65+,9974,8720,18694
28941,48215,15-19,38334,39132,77466
28942,48215,20-24,33982,34209,68191
28943,48215,25-29,31089,31751,62840
28944,48215,30-34,27971,28878,56849
28945,48215,35-39,26963,27275,54238
28946,48215,40-44,27501,26613,54114
28947,48215,45-49,27247,25803,53050
28948,48215,50-54,24707,22674,47381
28949,48215,55-59,21251,19330,40581
28950,48215,60-64,18820,16593,35413
28951,48215,65+,55471,44446,99917
28952,48217,15-19,1161,1250,2411
28953,48217,20-24,998,1036,2034
28954,48217,25-29,981,1049,2030
28955,48217,30-34,1063,1024,2087
28956,48217,35-39,1098,1080,2178
28957,48217,40-44,983,1066,2049
28958,48217,45-49,978,971,1949
28959,48217,50-54,1110,1115,2225
28960,48217,55-59,1234,1242,2476
28961,48217,60-64,1332,1293,2625
28962,48217,65+,3880,3577,7457
28963,48219,15-19,985,946,1931
28964,48219,20-24,699,784,1483
28965,48219,25-29,620,661,1281
28966,48219,30-34,681,745,1426
28967,48219,35-39,717,720,1437
28968,48219,40-44,654,644,1298
28969,48219,45-49,540,558,1098
28970,48219,50-54,567,527,1094
28971,48219,55-59,655,591,1246
28972,48219,60-64,624,625,1249
28973,48219,65+,1741,1487,3228
28974,48221,15-19,1796,1892,3688
28975,48221,20-24,1478,1506,2984
28976,48221,25-29,1633,1582,3215
28977,48221,30-34,1755,1670,3425
28978,48221,35-39,1834,1817,3651
28979,48221,40-44,1727,1763,3490
28980,48221,45-49,1636,1594,3230
28981,48221,50-54,1960,1839,3799
28982,48221,55-59,2351,2166,4517
28983,48221,60-64,2712,2484,5196
28984,48221,65+,8577,7681,16258
28985,48223,15-19,1246,1263,2509
28986,48223,20-24,1037,1092,2129
28987,48223,25-29,1103,1175,2278
28988,48223,30-34,1183,1093,2276
28989,48223,35-39,1161,1130,2291
28990,48223,40-44,1028,1026,2054
28991,48223,45-49,1129,1041,2170
28992,48223,50-54,1149,1154,2303
28993,48223,55-59,1256,1230,2486
28994,48223,60-64,1223,1188,2411
28995,48223,65+,3751,3135,6886
28996,48225,15-19,569,639,1208
28997,48225,20-24,485,590,1075
28998,48225,25-29,498,709,1207
28999,48225,30-34,551,761,1312
29000,48225,35-39,550,900,1450
29001,48225,40-44,553,938,1491
29002,48225,45-49,534,917,1451
29003,48225,50-54,561,828,1389
29004,48225,55-59,731,746,1477
29005,48225,60-64,782,791,1573
29006,48225,65+,2659,2345,5004
29007,48227,15-19,931,1320,2251
29008,48227,20-24,865,1438,2303
29009,48227,25-29,975,1543,2518
29010,48227,30-34,1121,1695,2816
29011,48227,35-39,1058,1371,2429
29012,48227,40-44,862,1492,2354
29013,48227,45-49,828,1715,2543
29014,48227,50-54,850,1790,2640
29015,48227,55-59,836,1159,1995
29016,48227,60-64,857,975,1832
29017,48227,65+,2287,2144,4431
29018,48229,15-19,91,97,188
29019,48229,20-24,100,111,211
29020,48229,25-29,113,141,254
29021,48229,30-34,136,183,319
29022,48229,35-39,128,175,303
29023,48229,40-44,95,140,235
29024,48229,45-49,81,128,209
29025,48229,50-54,88,92,180
29026,48229,55-59,79,82,161
29027,48229,60-64,82,75,157
29028,48229,65+,233,247,480
29029,48231,15-19,3646,3860,7506
29030,48231,20-24,3448,3476,6924
29031,48231,25-29,3288,3313,6601
29032,48231,30-34,3404,3274,6678
29033,48231,35-39,3216,3172,6388
29034,48231,40-44,3122,3080,6202
29035,48231,45-49,3064,2952,6016
29036,48231,50-54,3258,3253,6511
29037,48231,55-59,3550,3385,6935
29038,48231,60-64,3370,3230,6600
29039,48231,65+,8824,7700,16524
29040,48233,15-19,724,721,1445
29041,48233,20-24,607,606,1213
29042,48233,25-29,560,623,1183
29043,48233,30-34,578,596,1174
29044,48233,35-39,665,713,1378
29045,48233,40-44,639,684,1323
29046,48233,45-49,597,636,1233
29047,48233,50-54,536,579,1115
29048,48233,55-59,584,608,1192
29049,48233,60-64,686,720,1406
29050,48233,65+,1878,1770,3648
29051,48235,15-19,48,55,103
29052,48235,20-24,28,34,62
29053,48235,25-29,43,34,77
29054,48235,30-34,42,51,93
29055,48235,35-39,52,58,110
29056,48235,40-44,29,44,73
29057,48235,45-49,39,51,90
29058,48235,50-54,43,41,84
29059,48235,55-59,47,65,112
29060,48235,60-64,65,60,125
29061,48235,65+,165,151,316
29062,48237,15-19,228,329,557
29063,48237,20-24,187,392,579
29064,48237,25-29,209,397,606
29065,48237,30-34,235,383,618
29066,48237,35-39,233,376,609
29067,48237,40-44,223,305,528
29068,48237,45-49,244,298,542
29069,48237,50-54,243,307,550
29070,48237,55-59,243,337,580
29071,48237,60-64,258,280,538
29072,48237,65+,764,701,1465
29073,48239,15-19,525,512,1037
29074,48239,20-24,400,464,864
29075,48239,25-29,396,477,873
29076,48239,30-34,443,438,881
29077,48239,35-39,473,551,1024
29078,48239,40-44,473,421,894
29079,48239,45-49,410,410,820
29080,48239,50-54,354,399,753
29081,48239,55-59,456,443,899
29082,48239,60-64,463,517,980
29083,48239,65+,1548,1362,2910
29084,48241,15-19,1019,1103,2122
29085,48241,20-24,814,952,1766
29086,48241,25-29,897,946,1843
29087,48241,30-34,917,933,1850
29088,48241,35-39,947,974,1921
29089,48241,40-44,909,892,1801
29090,48241,45-49,904,882,1786
29091,48241,50-54,1059,1049,2108
29092,48241,55-59,1169,1135,2304
29093,48241,60-64,1234,1185,2419
29094,48241,65+,3591,3162,6753
29095,48243,15-19,29,56,85
29096,48243,20-24,26,19,45
29097,48243,25-29,36,36,72
29098,48243,30-34,42,45,87
29099,48243,35-39,51,46,97
29100,48243,40-44,51,46,97
29101,48243,45-49,69,65,134
29102,48243,50-54,75,56,131
29103,48243,55-59,77,82,159
29104,48243,60-64,100,112,212
29105,48243,65+,381,380,761
29106,48245,15-19,8200,8556,16756
29107,48245,20-24,7845,8817,16662
29108,48245,25-29,7947,9832,17779
29109,48245,30-34,8121,9831,17952
29110,48245,35-39,7840,9745,17585
29111,48245,40-44,7550,9012,16562
29112,48245,45-49,6786,7953,14739
29113,48245,50-54,6841,7812,14653
29114,48245,55-59,7676,7844,15520
29115,48245,60-64,7858,7843,15701
29116,48245,65+,21003,17046,38049
29117,48247,15-19,187,243,430
29118,48247,20-24,137,178,315
29119,48247,25-29,120,126,246
29120,48247,30-34,124,146,270
29121,48247,35-39,135,158,293
29122,48247,40-44,144,160,304
29123,48247,45-49,119,128,247
29124,48247,50-54,104,116,220
29125,48247,55-59,131,138,269
29126,48247,60-64,120,138,258
29127,48247,65+,432,363,795
29128,48249,15-19,1325,1530,2855
29129,48249,20-24,1217,1298,2515
29130,48249,25-29,1175,1198,2373
29131,48249,30-34,1246,1255,2501
29132,48249,35-39,1269,1311,2580
29133,48249,40-44,1160,1222,2382
29134,48249,45-49,1079,1073,2152
29135,48249,50-54,1130,960,2090
29136,48249,55-59,1177,1077,2254
29137,48249,60-64,1144,1088,2232
29138,48249,65+,3317,2812,6129
29139,48251,15-19,6484,6910,13394
29140,48251,20-24,5462,5707,11169
29141,48251,25-29,5674,5881,11555
29142,48251,30-34,6438,6529,12967
29143,48251,35-39,6493,6675,13168
29144,48251,40-44,6023,6205,12228
29145,48251,45-49,5670,5924,11594
29146,48251,50-54,5791,6047,11838
29147,48251,55-59,5806,5959,11765
29148,48251,60-64,5551,5666,11217
29149,48251,65+,14612,12049,26661
29150,48253,15-19,469,596,1065
29151,48253,20-24,355,1173,1528
29152,48253,25-29,377,1279,1656
29153,48253,30-34,396,1270,1666
29154,48253,35-39,463,1188,1651
29155,48253,40-44,378,1071,1449
29156,48253,45-49,409,966,1375
29157,48253,50-54,446,785,1231
29158,48253,55-59,487,687,1174
29159,48253,60-64,531,592,1123
29160,48253,65+,1626,1525,3151
29161,48255,15-19,430,521,951
29162,48255,20-24,381,741,1122
29163,48255,25-29,376,860,1236
29164,48255,30-34,425,887,1312
29165,48255,35-39,392,756,1148
29166,48255,40-44,355,674,1029
29167,48255,45-49,343,569,912
29168,48255,50-54,320,402,722
29169,48255,55-59,358,427,785
29170,48255,60-64,375,425,800
29171,48255,65+,1144,957,2101
29172,48257,15-19,5646,6014,11660
29173,48257,20-24,4449,4502,8951
29174,48257,25-29,5339,4946,10285
29175,48257,30-34,6279,5759,12038
29176,48257,35-39,6373,5986,12359
29177,48257,40-44,5718,5663,11381
29178,48257,45-49,4917,4860,9777
29179,48257,50-54,4722,4789,9511
29180,48257,55-59,4496,4393,8889
29181,48257,60-64,4184,3999,8183
29182,48257,65+,9557,8034,17591
29183,48259,15-19,1635,1716,3351
29184,48259,20-24,1147,1330,2477
29185,48259,25-29,1035,1016,2051
29186,48259,30-34,1259,1210,2469
29187,48259,35-39,1512,1438,2950
29188,48259,40-44,1565,1562,3127
29189,48259,45-49,1549,1605,3154
29190,48259,50-54,1567,1574,3141
29191,48259,55-59,1655,1582,3237
29192,48259,60-64,1799,1700,3499
29193,48259,65+,4699,4177,8876
29194,48261,15-19,11,14,25
29195,48261,20-24,13,10,23
29196,48261,25-29,7,9,16
29197,48261,30-34,9,11,20
29198,48261,35-39,12,13,25
29199,48261,40-44,9,11,20
29200,48261,45-49,5,10,15
29201,48261,50-54,14,15,29
29202,48261,55-59,12,12,24
29203,48261,60-64,13,11,24
29204,48261,65+,34,37,71
29205,48263,15-19,18,25,43
29206,48263,20-24,15,21,36
29207,48263,25-29,15,18,33
29208,48263,30-34,16,16,32
29209,48263,35-39,14,23,37
29210,48263,40-44,21,25,46
29211,48263,45-49,19,18,37
29212,48263,50-54,14,19,33
29213,48263,55-59,31,29,60
29214,48263,60-64,25,40,65
29215,48263,65+,104,78,182
29216,48265,15-19,1504,1647,3151
29217,48265,20-24,1441,1489,2930
29218,48265,25-29,1397,1324,2721
29219,48265,30-34,1398,1378,2776
29220,48265,35-39,1407,1346,2753
29221,48265,40-44,1279,1278,2557
29222,48265,45-49,1307,1244,2551
29223,48265,50-54,1561,1361,2922
29224,48265,55-59,1844,1660,3504
29225,48265,60-64,2276,1959,4235
29226,48265,65+,7921,6870,14791
29227,48267,15-19,110,119,229
29228,48267,20-24,100,95,195
29229,48267,25-29,110,103,213
29230,48267,30-34,97,100,197
29231,48267,35-39,94,120,214
29232,48267,40-44,112,116,228
29233,48267,45-49,130,77,207
29234,48267,50-54,113,120,233
29235,48267,55-59,153,168,321
29236,48267,60-64,173,176,349
29237,48267,65+,687,633,1320
29238,48269,15-19,12,13,25
29239,48269,20-24,6,5,11
29240,48269,25-29,5,2,7
29241,48269,30-34,5,4,9
29242,48269,35-39,10,11,21
29243,48269,40-44,8,10,18
29244,48269,45-49,3,12,15
29245,48269,50-54,7,6,13
29246,48269,55-59,13,6,19
29247,48269,60-64,7,13,20
29248,48269,65+,19,26,45
29249,48271,15-19,75,101,176
29250,48271,20-24,63,135,198
29251,48271,25-29,67,127,194
29252,48271,30-34,54,137,191
29253,48271,35-39,75,134,209
29254,48271,40-44,75,113,188
29255,48271,45-49,87,100,187
29256,48271,50-54,84,97,181
29257,48271,55-59,74,87,161
29258,48271,60-64,87,94,181
29259,48271,65+,395,371,766
29260,48273,15-19,1390,1445,2835
29261,48273,20-24,2188,2275,4463
29262,48273,25-29,1100,1260,2360
29263,48273,30-34,822,940,1762
29264,48273,35-39,867,976,1843
29265,48273,40-44,773,797,1570
29266,48273,45-49,709,732,1441
29267,48273,50-54,708,699,1407
29268,48273,55-59,700,691,1391
29269,48273,60-64,625,649,1274
29270,48273,65+,2262,1862,4124
29271,48275,15-19,105,96,201
29272,48275,20-24,73,80,153
29273,48275,25-29,95,82,177
29274,48275,30-34,101,93,194
29275,48275,35-39,89,96,185
29276,48275,40-44,85,101,186
29277,48275,45-49,75,79,154
29278,48275,50-54,94,95,189
29279,48275,55-59,99,113,212
29280,48275,60-64,110,139,249
29281,48275,65+,401,297,698
29282,48277,15-19,1555,1595,3150
29283,48277,20-24,1461,1464,2925
29284,48277,25-29,1544,1508,3052
29285,48277,30-34,1661,1558,3219
29286,48277,35-39,1475,1359,2834
29287,48277,40-44,1417,1376,2793
29288,48277,45-49,1442,1323,2765
29289,48277,50-54,1677,1555,3232
29290,48277,55-59,1675,1614,3289
29291,48277,60-64,1694,1604,3298
29292,48277,65+,5279,4208,9487
29293,48279,15-19,486,510,996
29294,48279,20-24,350,419,769
29295,48279,25-29,327,364,691
29296,48279,30-34,382,388,770
29297,48279,35-39,381,375,756
29298,48279,40-44,416,377,793
29299,48279,45-49,323,335,658
29300,48279,50-54,362,360,722
29301,48279,55-59,416,402,818
29302,48279,60-64,401,390,791
29303,48279,65+,1169,1059,2228
29304,48281,15-19,696,666,1362
29305,48281,20-24,565,596,1161
29306,48281,25-29,526,558,1084
29307,48281,30-34,586,611,1197
29308,48281,35-39,670,667,1337
29309,48281,40-44,668,669,1337
29310,48281,45-49,684,670,1354
29311,48281,50-54,695,749,1444
29312,48281,55-59,861,901,1762
29313,48281,60-64,840,855,1695
29314,48281,65+,2482,2127,4609
29315,48283,15-19,167,232,399
29316,48283,20-24,197,739,936
29317,48283,25-29,170,533,703
29318,48283,30-34,177,285,462
29319,48283,35-39,184,240,424
29320,48283,40-44,185,291,476
29321,48283,45-49,134,198,332
29322,48283,50-54,194,178,372
29323,48283,55-59,148,161,309
29324,48283,60-64,138,133,271
29325,48283,65+,499,413,912
29326,48285,15-19,698,638,1336
29327,48285,20-24,522,564,1086
29328,48285,25-29,500,512,1012
29329,48285,30-34,533,496,1029
29330,48285,35-39,606,545,1151
29331,48285,40-44,560,557,1117
29332,48285,45-49,514,540,1054
29333,48285,50-54,570,575,1145
29334,48285,55-59,664,711,1375
29335,48285,60-64,732,745,1477
29336,48285,65+,2641,2162,4803
29337,48287,15-19,479,729,1208
29338,48287,20-24,416,502,918
29339,48287,25-29,497,512,1009
29340,48287,30-34,507,488,995
29341,48287,35-39,544,536,1080
29342,48287,40-44,544,569,1113
29343,48287,45-49,516,542,1058
29344,48287,50-54,550,525,1075
29345,48287,55-59,638,631,1269
29346,48287,60-64,707,764,1471
29347,48287,65+,1838,1690,3528
29348,48289,15-19,485,496,981
29349,48289,20-24,376,402,778
29350,48289,25-29,366,375,741
29351,48289,30-34,394,395,789
29352,48289,35-39,439,412,851
29353,48289,40-44,432,434,866
29354,48289,45-49,394,422,816
29355,48289,50-54,416,422,838
29356,48289,55-59,565,516,1081
29357,48289,60-64,660,655,1315
29358,48289,65+,2035,1855,3890
29359,48291,15-19,3453,3612,7065
29360,48291,20-24,3051,3199,6250
29361,48291,25-29,3526,3266,6792
29362,48291,30-34,3445,3300,6745
29363,48291,35-39,3328,3075,6403
29364,48291,40-44,3157,2971,6128
29365,48291,45-49,3059,2904,5963
29366,48291,50-54,2884,3010,5894
29367,48291,55-59,2728,2891,5619
29368,48291,60-64,2616,2662,5278
29369,48291,65+,6378,5603,11981
29370,48293,15-19,589,743,1332
29371,48293,20-24,581,781,1362
29372,48293,25-29,606,794,1400
29373,48293,30-34,591,750,1341
29374,48293,35-39,621,736,1357
29375,48293,40-44,599,721,1320
29376,48293,45-49,590,609,1199
29377,48293,50-54,660,641,1301
29378,48293,55-59,685,750,1435
29379,48293,60-64,831,751,1582
29380,48293,65+,2361,2125,4486
29381,48295,15-19,102,106,208
29382,48295,20-24,72,74,146
29383,48295,25-29,66,70,136
29384,48295,30-34,74,100,174
29385,48295,35-39,84,112,196
29386,48295,40-44,86,103,189
29387,48295,45-49,64,70,134
29388,48295,50-54,63,86,149
29389,48295,55-59,110,97,207
29390,48295,60-64,112,114,226
29391,48295,65+,299,272,571
29392,48297,15-19,282,297,579
29393,48297,20-24,252,363,615
29394,48297,25-29,274,483,757
29395,48297,30-34,284,539,823
29396,48297,35-39,274,498,772
29397,48297,40-44,270,433,703
29398,48297,45-49,272,327,599
29399,48297,50-54,290,321,611
29400,48297,55-59,363,355,718
29401,48297,60-64,389,435,824
29402,48297,65+,1234,1220,2454
29403,48299,15-19,437,493,930
29404,48299,20-24,423,450,873
29405,48299,25-29,417,413,830
29406,48299,30-34,449,438,887
29407,48299,35-39,442,446,888
29408,48299,40-44,421,441,862
29409,48299,45-49,501,460,961
29410,48299,50-54,656,596,1252
29411,48299,55-59,856,749,1605
29412,48299,60-64,1115,965,2080
29413,48299,65+,4251,3842,8093
29414,48301,15-19,1,4,5
29415,48301,20-24,0,1,1
29416,48301,25-29,1,3,4
29417,48301,30-34,2,2,4
29418,48301,35-39,0,1,1
29419,48301,40-44,0,4,4
29420,48301,45-49,1,2,3
29421,48301,50-54,0,3,3
29422,48301,55-59,1,4,5
29423,48301,60-64,0,5,5
29424,48301,65+,0,3,3
29425,48303,15-19,13459,13638,27097
29426,48303,20-24,18484,19369,37853
29427,48303,25-29,11715,12058,23773
29428,48303,30-34,10617,10618,21235
29429,48303,35-39,10213,10532,20745
29430,48303,40-44,9424,9341,18765
29431,48303,45-49,7961,7656,15617
29432,48303,50-54,7910,7498,15408
29433,48303,55-59,8256,7610,15866
29434,48303,60-64,8158,7590,15748
29435,48303,65+,22699,17826,40525
29436,48305,15-19,182,223,405
29437,48305,20-24,131,171,302
29438,48305,25-29,150,173,323
29439,48305,30-34,174,179,353
29440,48305,35-39,201,242,443
29441,48305,40-44,163,183,346
29442,48305,45-49,132,149,281
29443,48305,50-54,151,151,302
29444,48305,55-59,180,185,365
29445,48305,60-64,163,192,355
29446,48305,65+,466,441,907
29447,48307,15-19,215,247,462
29448,48307,20-24,193,207,400
29449,48307,25-29,207,227,434
29450,48307,30-34,199,192,391
29451,48307,35-39,195,225,420
29452,48307,40-44,191,212,403
29453,48307,45-49,195,203,398
29454,48307,50-54,236,195,431
29455,48307,55-59,252,262,514
29456,48307,60-64,286,257,543
29457,48307,65+,949,878,1827
29458,48309,15-19,10802,10995,21797
29459,48309,20-24,13101,13287,26388
29460,48309,25-29,9000,8990,17990
29461,48309,30-34,8477,7855,16332
29462,48309,35-39,8267,7981,16248
29463,48309,40-44,7776,7450,15226
29464,48309,45-49,7000,6673,13673
29465,48309,50-54,7113,6703,13816
29466,48309,55-59,7554,7098,14652
29467,48309,60-64,7502,7056,14558
29468,48309,65+,21883,17463,39346
29469,48311,15-19,25,22,47
29470,48311,20-24,10,16,26
29471,48311,25-29,13,15,28
29472,48311,30-34,10,23,33
29473,48311,35-39,21,11,32
29474,48311,40-44,14,16,30
29475,48311,45-49,14,20,34
29476,48311,50-54,17,20,37
29477,48311,55-59,22,29,51
29478,48311,60-64,18,23,41
29479,48311,65+,73,80,153
29480,48313,15-19,388,464,852
29481,48313,20-24,382,896,1278
29482,48313,25-29,398,950,1348
29483,48313,30-34,321,760,1081
29484,48313,35-39,312,626,938
29485,48313,40-44,337,525,862
29486,48313,45-49,327,407,734
29487,48313,50-54,323,394,717
29488,48313,55-59,345,340,685
29489,48313,60-64,342,332,674
29490,48313,65+,1129,974,2103
29491,48315,15-19,226,254,480
29492,48315,20-24,212,211,423
29493,48315,25-29,223,232,455
29494,48315,30-34,215,235,450
29495,48315,35-39,270,226,496
29496,48315,40-44,264,243,507
29497,48315,45-49,260,240,500
29498,48315,50-54,334,287,621
29499,48315,55-59,411,364,775
29500,48315,60-64,497,436,933
29501,48315,65+,1333,1266,2599
29502,48317,15-19,206,192,398
29503,48317,20-24,148,159,307
29504,48317,25-29,146,147,293
29505,48317,30-34,186,176,362
29506,48317,35-39,183,214,397
29507,48317,40-44,144,156,300
29508,48317,45-49,131,143,274
29509,48317,50-54,148,143,291
29510,48317,55-59,156,143,299
29511,48317,60-64,142,129,271
29512,48317,65+,303,284,587
29513,48319,15-19,109,123,232
29514,48319,20-24,88,87,175
29515,48319,25-29,72,94,166
29516,48319,30-34,79,90,169
29517,48319,35-39,91,99,190
29518,48319,40-44,112,104,216
29519,48319,45-49,102,83,185
29520,48319,50-54,114,128,242
29521,48319,55-59,133,122,255
29522,48319,60-64,135,169,304
29523,48319,65+,653,552,1205
29524,48321,15-19,1158,1237,2395
29525,48321,20-24,999,1118,2117
29526,48321,25-29,1133,1123,2256
29527,48321,30-34,1167,1159,2326
29528,48321,35-39,1050,1147,2197
29529,48321,40-44,1026,1080,2106
29530,48321,45-49,932,872,1804
29531,48321,50-54,1067,978,2045
29532,48321,55-59,1195,1156,2351
29533,48321,60-64,1200,1249,2449
29534,48321,65+,3276,3043,6319
29535,48323,15-19,2411,2464,4875
29536,48323,20-24,2166,2581,4747
29537,48323,25-29,1990,2402,4392
29538,48323,30-34,1781,1976,3757
29539,48323,35-39,1704,1788,3492
29540,48323,40-44,1620,1584,3204
29541,48323,45-49,1741,1612,3353
29542,48323,50-54,1643,1522,3165
29543,48323,55-59,1438,1339,2777
29544,48323,60-64,1299,1170,2469
29545,48323,65+,3767,3099,6866
29546,48325,15-19,1720,1951,3671
29547,48325,20-24,1387,2123,3510
29548,48325,25-29,1267,1793,3060
29549,48325,30-34,1509,1659,3168
29550,48325,35-39,1567,1680,3247
29551,48325,40-44,1510,1675,3185
29552,48325,45-49,1532,1746,3278
29553,48325,50-54,1634,1651,3285
29554,48325,55-59,1664,1850,3514
29555,48325,60-64,1702,1735,3437
29556,48325,65+,4652,4293,8945
29557,48327,15-19,39,63,102
29558,48327,20-24,38,37,75
29559,48327,25-29,42,46,88
29560,48327,30-34,24,50,74
29561,48327,35-39,49,47,96
29562,48327,40-44,49,39,88
29563,48327,45-49,55,34,89
29564,48327,50-54,59,62,121
29565,48327,55-59,63,63,126
29566,48327,60-64,99,84,183
29567,48327,65+,308,319,627
29568,48329,15-19,5500,5819,11319
29569,48329,20-24,4989,5192,10181
29570,48329,25-29,6508,6849,13357
29571,48329,30-34,7062,7808,14870
29572,48329,35-39,6619,7538,14157
29573,48329,40-44,5305,5987,11292
29574,48329,45-49,4301,4629,8930
29575,48329,50-54,3994,4176,8170
29576,48329,55-59,4089,4113,8202
29577,48329,60-64,4044,4065,8109
29578,48329,65+,9679,7666,17345
29579,48331,15-19,779,965,1744
29580,48331,20-24,624,737,1361
29581,48331,25-29,674,686,1360
29582,48331,30-34,674,646,1320
29583,48331,35-39,731,756,1487
29584,48331,40-44,735,649,1384
29585,48331,45-49,728,709,1437
29586,48331,50-54,795,735,1530
29587,48331,55-59,849,829,1678
29588,48331,60-64,905,918,1823
29589,48331,65+,2848,2472,5320
29590,48333,15-19,133,158,291
29591,48333,20-24,103,121,224
29592,48333,25-29,92,111,203
29593,48333,30-34,99,93,192
29594,48333,35-39,99,84,183
29595,48333,40-44,118,124,242
29596,48333,45-49,116,104,220
29597,48333,50-54,134,132,266
29598,48333,55-59,160,176,336
29599,48333,60-64,184,164,348
29600,48333,65+,628,607,1235
29601,48335,15-19,225,303,528
29602,48335,20-24,172,576,748
29603,48335,25-29,191,582,773
29604,48335,30-34,203,513,716
29605,48335,35-39,223,408,631
29606,48335,40-44,221,362,583
29607,48335,45-49,181,341,522
29608,48335,50-54,233,302,535
29609,48335,55-59,206,257,463
29610,48335,60-64,262,236,498
29611,48335,65+,746,628,1374
29612,48337,15-19,589,693,1282
29613,48337,20-24,517,508,1025
29614,48337,25-29,536,500,1036
29615,48337,30-34,569,537,1106
29616,48337,35-39,596,631,1227
29617,48337,40-44,566,567,1133
29618,48337,45-49,549,586,1135
29619,48337,50-54,617,619,1236
29620,48337,55-59,679,713,1392
29621,48337,60-64,744,749,1493
29622,48337,65+,2375,2148,4523
29623,48339,15-19,22356,23449,45805
29624,48339,20-24,19036,19173,38209
29625,48339,25-29,19873,19730,39603
29626,48339,30-34,21543,20874,42417
29627,48339,35-39,23206,23086,46292
29628,48339,40-44,22699,22618,45317
29629,48339,45-49,21425,21476,42901
29630,48339,50-54,21288,21747,43035
29631,48339,55-59,20216,20095,40311
29632,48339,60-64,19305,19121,38426
29633,48339,65+,47599,40712,88311
29634,48341,15-19,814,864,1678
29635,48341,20-24,631,737,1368
29636,48341,25-29,677,757,1434
29637,48341,30-34,632,774,1406
29638,48341,35-39,605,752,1357
29639,48341,40-44,619,739,1358
29640,48341,45-49,544,601,1145
29641,48341,50-54,537,640,1177
29642,48341,55-59,521,609,1130
29643,48341,60-64,477,535,1012
29644,48341,65+,1329,1199,2528
29645,48343,15-19,358,388,746
29646,48343,20-24,316,312,628
29647,48343,25-29,319,319,638
29648,48343,30-34,338,329,667
29649,48343,35-39,370,351,721
29650,48343,40-44,349,332,681
29651,48343,45-49,359,311,670
29652,48343,50-54,373,308,681
29653,48343,55-59,398,350,748
29654,48343,60-64,499,413,912
29655,48343,65+,1437,1202,2639
29656,48345,15-19,31,34,65
29657,48345,20-24,24,23,47
29658,48345,25-29,20,32,52
29659,48345,30-34,26,29,55
29660,48345,35-39,28,29,57
29661,48345,40-44,25,19,44
29662,48345,45-49,28,26,54
29663,48345,50-54,25,30,55
29664,48345,55-59,25,42,67
29665,48345,60-64,41,44,85
29666,48345,65+,168,149,317
29667,48347,15-19,3425,2880,6305
29668,48347,20-24,4346,3764,8110
29669,48347,25-29,2029,1997,4026
29670,48347,30-34,1775,1727,3502
29671,48347,35-39,1722,1684,3406
29672,48347,40-44,1723,1624,3347
29673,48347,45-49,1600,1484,3084
29674,48347,50-54,1633,1595,3228
29675,48347,55-59,1806,1747,3553
29676,48347,60-64,1907,1724,3631
29677,48347,65+,5460,4506,9966
29678,48349,15-19,1831,1976,3807
29679,48349,20-24,1528,1750,3278
29680,48349,25-29,1657,1618,3275
29681,48349,30-34,1593,1548,3141
29682,48349,35-39,1564,1490,3054
29683,48349,40-44,1558,1494,3052
29684,48349,45-49,1567,1426,2993
29685,48349,50-54,1601,1638,3239
29686,48349,55-59,1685,1682,3367
29687,48349,60-64,1763,1672,3435
29688,48349,65+,4902,4169,9071
29689,48351,15-19,325,387,712
29690,48351,20-24,298,430,728
29691,48351,25-29,320,465,785
29692,48351,30-34,305,419,724
29693,48351,35-39,308,376,684
29694,48351,40-44,321,352,673
29695,48351,45-49,355,371,726
29696,48351,50-54,369,424,793
29697,48351,55-59,451,459,910
29698,48351,60-64,491,451,942
29699,48351,65+,1380,1275,2655
29700,48353,15-19,504,646,1150
29701,48353,20-24,364,522,886
29702,48353,25-29,386,427,813
29703,48353,30-34,400,413,813
29704,48353,35-39,429,447,876
29705,48353,40-44,459,426,885
29706,48353,45-49,402,396,798
29707,48353,50-54,434,456,890
29708,48353,55-59,429,430,859
29709,48353,60-64,447,395,842
29710,48353,65+,1446,1254,2700
29711,48355,15-19,12155,12809,24964
29712,48355,20-24,12406,12638,25044
29713,48355,25-29,11775,12442,24217
29714,48355,30-34,12096,12557,24653
29715,48355,35-39,12004,12472,24476
29716,48355,40-44,11495,11527,23022
29717,48355,45-49,10439,10334,20773
29718,48355,50-54,10226,9967,20193
29719,48355,55-59,10623,10196,20819
29720,48355,60-64,10559,10040,20599
29721,48355,65+,29550,24380,53930
29722,48357,15-19,451,424,875
29723,48357,20-24,287,304,591
29724,48357,25-29,294,314,608
29725,48357,30-34,315,336,651
29726,48357,35-39,312,316,628
29727,48357,40-44,282,267,549
29728,48357,45-49,265,335,600
29729,48357,50-54,254,250,504
29730,48357,55-59,276,286,562
29731,48357,60-64,269,282,551
29732,48357,65+,628,588,1216
29733,48359,15-19,58,104,162
29734,48359,20-24,31,35,66
29735,48359,25-29,49,55,104
29736,48359,30-34,68,48,116
29737,48359,35-39,55,59,114
29738,48359,40-44,63,73,136
29739,48359,45-49,66,59,125
29740,48359,50-54,61,55,116
29741,48359,55-59,61,68,129
29742,48359,60-64,65,63,128
29743,48359,65+,144,141,285
29744,48361,15-19,2618,2913,5531
29745,48361,20-24,2336,2402,4738
29746,48361,25-29,2785,2741,5526
29747,48361,30-34,2823,2768,5591
29748,48361,35-39,2823,2832,5655
29749,48361,40-44,2652,2646,5298
29750,48361,45-49,2507,2405,4912
29751,48361,50-54,2530,2674,5204
29752,48361,55-59,2759,2703,5462
29753,48361,60-64,2824,2742,5566
29754,48361,65+,7375,6185,13560
29755,48363,15-19,868,853,1721
29756,48363,20-24,831,836,1667
29757,48363,25-29,828,871,1699
29758,48363,30-34,904,853,1757
29759,48363,35-39,805,759,1564
29760,48363,40-44,786,748,1534
29761,48363,45-49,799,732,1531
29762,48363,50-54,883,831,1714
29763,48363,55-59,1067,968,2035
29764,48363,60-64,1110,1030,2140
29765,48363,65+,3041,2745,5786
29766,48365,15-19,743,858,1601
29767,48365,20-24,630,648,1278
29768,48365,25-29,618,656,1274
29769,48365,30-34,612,673,1285
29770,48365,35-39,652,696,1348
29771,48365,40-44,745,691,1436
29772,48365,45-49,658,620,1278
29773,48365,50-54,665,676,1341
29774,48365,55-59,754,677,1431
29775,48365,60-64,811,753,1564
29776,48365,65+,2408,2184,4592
29777,48367,15-19,5076,5319,10395
29778,48367,20-24,3967,4081,8048
29779,48367,25-29,4281,4260,8541
29780,48367,30-34,5127,4715,9842
29781,48367,35-39,5543,5553,11096
29782,48367,40-44,5183,5322,10505
29783,48367,45-49,4926,4933,9859
29784,48367,50-54,5211,5160,10371
29785,48367,55-59,5458,5656,11114
29786,48367,60-64,5221,5166,10387
29787,48367,65+,12916,11674,24590
29788,48369,15-19,372,398,770
29789,48369,20-24,309,315,624
29790,48369,25-29,287,320,607
29791,48369,30-34,252,357,609
29792,48369,35-39,303,316,619
29793,48369,40-44,241,294,535
29794,48369,45-49,249,291,540
29795,48369,50-54,298,293,591
29796,48369,55-59,332,312,644
29797,48369,60-64,255,311,566
29798,48369,65+,767,701,1468
29799,48371,15-19,467,486,953
29800,48371,20-24,377,567,944
29801,48371,25-29,391,653,1044
29802,48371,30-34,428,751,1179
29803,48371,35-39,450,782,1232
29804,48371,40-44,383,728,1111
29805,48371,45-49,362,637,999
29806,48371,50-54,317,557,874
29807,48371,55-59,371,465,836
29808,48371,60-64,346,423,769
29809,48371,65+,989,1032,2021
29810,48373,15-19,1295,1488,2783
29811,48373,20-24,1112,1589,2701
29812,48373,25-29,1179,1723,2902
29813,48373,30-34,1302,1904,3206
29814,48373,35-39,1290,1950,3240
29815,48373,40-44,1349,1808,3157
29816,48373,45-49,1341,1740,3081
29817,48373,50-54,1527,1799,3326
29818,48373,55-59,2047,2050,4097
29819,48373,60-64,2458,2401,4859
29820,48373,65+,4736,5108,9844
29821,48375,15-19,3979,4179,8158
29822,48375,20-24,3791,3917,7708
29823,48375,25-29,3731,4366,8097
29824,48375,30-34,3885,4565,8450
29825,48375,35-39,3706,4496,8202
29826,48375,40-44,3480,4219,7699
29827,48375,45-49,3039,3849,6888
29828,48375,50-54,3067,3661,6728
29829,48375,55-59,3160,3373,6533
29830,48375,60-64,3197,3086,6283
29831,48375,65+,8492,7194,15686
29832,48377,15-19,210,255,465
29833,48377,20-24,162,168,330
29834,48377,25-29,168,173,341
29835,48377,30-34,152,151,303
29836,48377,35-39,165,161,326
29837,48377,40-44,180,164,344
29838,48377,45-49,150,143,293
29839,48377,50-54,146,147,293
29840,48377,55-59,158,148,306
29841,48377,60-64,144,150,294
29842,48377,65+,693,721,1414
29843,48379,15-19,314,349,663
29844,48379,20-24,266,296,562
29845,48379,25-29,273,277,550
29846,48379,30-34,335,292,627
29847,48379,35-39,367,384,751
29848,48379,40-44,334,327,661
29849,48379,45-49,327,343,670
29850,48379,50-54,406,392,798
29851,48379,55-59,461,459,920
29852,48379,60-64,551,554,1105
29853,48379,65+,1640,1517,3157
29854,48381,15-19,5229,5324,10553
29855,48381,20-24,4714,4841,9555
29856,48381,25-29,5012,4855,9867
29857,48381,30-34,5166,5303,10469
29858,48381,35-39,5280,5363,10643
29859,48381,40-44,4696,4938,9634
29860,48381,45-49,4067,4072,8139
29861,48381,50-54,3969,3900,7869
29862,48381,55-59,4149,3912,8061
29863,48381,60-64,4392,4082,8474
29864,48381,65+,12125,10026,22151
29865,48383,15-19,117,137,254
29866,48383,20-24,115,105,220
29867,48383,25-29,90,111,201
29868,48383,30-34,78,119,197
29869,48383,35-39,105,132,237
29870,48383,40-44,95,151,246
29871,48383,45-49,82,113,195
29872,48383,50-54,93,87,180
29873,48383,55-59,78,103,181
29874,48383,60-64,82,87,169
29875,48383,65+,204,186,390
29876,48385,15-19,62,67,129
29877,48385,20-24,47,56,103
29878,48385,25-29,68,63,131
29879,48385,30-34,58,65,123
29880,48385,35-39,74,70,144
29881,48385,40-44,60,70,130
29882,48385,45-49,71,67,138
29883,48385,50-54,95,91,186
29884,48385,55-59,89,100,189
29885,48385,60-64,143,124,267
29886,48385,65+,436,443,879
29887,48387,15-19,267,320,587
29888,48387,20-24,265,300,565
29889,48387,25-29,312,286,598
29890,48387,30-34,305,276,581
29891,48387,35-39,300,308,608
29892,48387,40-44,339,297,636
29893,48387,45-49,309,314,623
29894,48387,50-54,383,367,750
29895,48387,55-59,439,408,847
29896,48387,60-64,474,424,898
29897,48387,65+,1559,1364,2923
29898,48389,15-19,405,515,920
29899,48389,20-24,348,955,1303
29900,48389,25-29,350,787,1137
29901,48389,30-34,376,950,1326
29902,48389,35-39,369,980,1349
29903,48389,40-44,343,661,1004
29904,48389,45-49,305,716,1021
29905,48389,50-54,301,430,731
29906,48389,55-59,288,363,651
29907,48389,60-64,280,305,585
29908,48389,65+,910,766,1676
29909,48391,15-19,205,223,428
29910,48391,20-24,180,193,373
29911,48391,25-29,172,173,345
29912,48391,30-34,168,187,355
29913,48391,35-39,198,201,399
29914,48391,40-44,193,171,364
29915,48391,45-49,170,185,355
29916,48391,50-54,216,188,404
29917,48391,55-59,245,235,480
29918,48391,60-64,227,244,471
29919,48391,65+,806,715,1521
29920,48393,15-19,33,27,60
29921,48393,20-24,16,16,32
29922,48393,25-29,15,15,30
29923,48393,30-34,25,27,52
29924,48393,35-39,25,32,57
29925,48393,40-44,30,37,67
29926,48393,45-49,15,16,31
29927,48393,50-54,27,18,45
29928,48393,55-59,21,31,52
29929,48393,60-64,22,23,45
29930,48393,65+,99,80,179
29931,48395,15-19,477,537,1014
29932,48395,20-24,436,424,860
29933,48395,25-29,454,466,920
29934,48395,30-34,524,502,1026
29935,48395,35-39,534,507,1041
29936,48395,40-44,558,524,1082
29937,48395,45-49,444,394,838
29938,48395,50-54,541,522,1063
29939,48395,55-59,566,554,1120
29940,48395,60-64,601,582,1183
29941,48395,65+,1825,1640,3465
29942,48397,15-19,4361,4515,8876
29943,48397,20-24,3098,3351,6449
29944,48397,25-29,3163,3186,6349
29945,48397,30-34,3739,3448,7187
29946,48397,35-39,4424,4388,8812
29947,48397,40-44,4383,4452,8835
29948,48397,45-49,4163,4097,8260
29949,48397,50-54,3993,4105,8098
29950,48397,55-59,3561,3646,7207
29951,48397,60-64,3372,3333,6705
29952,48397,65+,7921,6574,14495
29953,48399,15-19,313,364,677
29954,48399,20-24,255,295,550
29955,48399,25-29,238,268,506
29956,48399,30-34,268,275,543
29957,48399,35-39,325,340,665
29958,48399,40-44,249,303,552
29959,48399,45-49,275,266,541
29960,48399,50-54,316,296,612
29961,48399,55-59,328,350,678
29962,48399,60-64,315,324,639
29963,48399,65+,1041,1000,2041
29964,48401,15-19,1538,1725,3263
29965,48401,20-24,1394,2097,3491
29966,48401,25-29,1346,2147,3493
29967,48401,30-34,1494,2014,3508
29968,48401,35-39,1465,1970,3435
29969,48401,40-44,1518,2098,3616
29970,48401,45-49,1429,1967,3396
29971,48401,50-54,1408,1816,3224
29972,48401,55-59,1573,1736,3309
29973,48401,60-64,1663,1725,3388
29974,48401,65+,4818,4157,8975
29975,48403,15-19,257,265,522
29976,48403,20-24,204,211,415
29977,48403,25-29,208,223,431
29978,48403,30-34,242,202,444
29979,48403,35-39,218,225,443
29980,48403,40-44,236,231,467
29981,48403,45-49,226,221,447
29982,48403,50-54,311,294,605
29983,48403,55-59,399,383,782
29984,48403,60-64,446,513,959
29985,48403,65+,1539,1540,3079
29986,48405,15-19,201,215,416
29987,48405,20-24,173,176,349
29988,48405,25-29,202,194,396
29989,48405,30-34,185,208,393
29990,48405,35-39,191,183,374
29991,48405,40-44,201,168,369
29992,48405,45-49,193,204,397
29993,48405,50-54,249,231,480
29994,48405,55-59,312,307,619
29995,48405,60-64,360,379,739
29996,48405,65+,1087,998,2085
29997,48407,15-19,762,889,1651
29998,48407,20-24,681,728,1409
29999,48407,25-29,785,772,1557
30000,48407,30-34,750,749,1499
30001,48407,35-39,780,708,1488
30002,48407,40-44,733,721,1454
30003,48407,45-49,817,803,1620
30004,48407,50-54,879,798,1677
30005,48407,55-59,968,1038,2006
30006,48407,60-64,1145,1166,2311
30007,48407,65+,3223,3193,6416
30008,48409,15-19,2444,2634,5078
30009,48409,20-24,2038,2173,4211
30010,48409,25-29,2103,2351,4454
30011,48409,30-34,2311,2473,4784
30012,48409,35-39,2412,2460,4872
30013,48409,40-44,2190,2404,4594
30014,48409,45-49,1948,2100,4048
30015,48409,50-54,2015,1990,4005
30016,48409,55-59,2082,2092,4174
30017,48409,60-64,1964,1955,3919
30018,48409,65+,5561,4915,10476
30019,48411,15-19,165,195,360
30020,48411,20-24,100,304,404
30021,48411,25-29,138,315,453
30022,48411,30-34,137,243,380
30023,48411,35-39,146,176,322
30024,48411,40-44,145,139,284
30025,48411,45-49,116,125,241
30026,48411,50-54,149,166,315
30027,48411,55-59,184,178,362
30028,48411,60-64,216,183,399
30029,48411,65+,695,660,1355
30030,48413,15-19,87,88,175
30031,48413,20-24,73,71,144
30032,48413,25-29,57,49,106
30033,48413,30-34,78,69,147
30034,48413,35-39,83,106,189
30035,48413,40-44,71,78,149
30036,48413,45-49,71,57,128
30037,48413,50-54,65,64,129
30038,48413,55-59,81,86,167
30039,48413,60-64,63,63,126
30040,48413,65+,248,256,504
30041,48415,15-19,556,652,1208
30042,48415,20-24,468,660,1128
30043,48415,25-29,448,679,1127
30044,48415,30-34,457,676,1133
30045,48415,35-39,485,681,1166
30046,48415,40-44,445,697,1142
30047,48415,45-49,355,615,970
30048,48415,50-54,431,549,980
30049,48415,55-59,470,536,1006
30050,48415,60-64,477,517,994
30051,48415,65+,1372,1156,2528
30052,48417,15-19,115,113,228
30053,48417,20-24,82,87,169
30054,48417,25-29,85,71,156
30055,48417,30-34,81,94,175
30056,48417,35-39,93,89,182
30057,48417,40-44,83,81,164
30058,48417,45-49,97,92,189
30059,48417,50-54,84,91,175
30060,48417,55-59,126,105,231
30061,48417,60-64,125,148,273
30062,48417,65+,364,322,686
30063,48419,15-19,789,852,1641
30064,48419,20-24,671,721,1392
30065,48419,25-29,685,683,1368
30066,48419,30-34,721,725,1446
30067,48419,35-39,672,692,1364
30068,48419,40-44,689,698,1387
30069,48419,45-49,693,689,1382
30070,48419,50-54,703,727,1430
30071,48419,55-59,766,743,1509
30072,48419,60-64,815,773,1588
30073,48419,65+,2247,2035,4282
30074,48421,15-19,99,112,211
30075,48421,20-24,62,95,157
30076,48421,25-29,88,94,182
30077,48421,30-34,73,84,157
30078,48421,35-39,88,87,175
30079,48421,40-44,62,64,126
30080,48421,45-49,62,83,145
30081,48421,50-54,96,85,181
30082,48421,55-59,97,108,205
30083,48421,60-64,81,104,185
30084,48421,65+,230,225,455
30085,48423,15-19,8433,8718,17151
30086,48423,20-24,8113,7655,15768
30087,48423,25-29,8041,7696,15737
30088,48423,30-34,8372,7584,15956
30089,48423,35-39,7899,7332,15231
30090,48423,40-44,7126,6907,14033
30091,48423,45-49,6828,6236,13064
30092,48423,50-54,7067,6665,13732
30093,48423,55-59,7185,6779,13964
30094,48423,60-64,7496,6822,14318
30095,48423,65+,22411,18147,40558
30096,48425,15-19,321,303,624
30097,48425,20-24,224,248,472
30098,48425,25-29,247,255,502
30099,48425,30-34,266,263,529
30100,48425,35-39,310,298,608
30101,48425,40-44,304,318,622
30102,48425,45-49,303,271,574
30103,48425,50-54,331,302,633
30104,48425,55-59,342,353,695
30105,48425,60-64,348,359,707
30106,48425,65+,969,902,1871
30107,48427,15-19,2819,2742,5561
30108,48427,20-24,2566,2677,5243
30109,48427,25-29,2397,2459,4856
30110,48427,30-34,1934,2186,4120
30111,48427,35-39,1894,2034,3928
30112,48427,40-44,1894,1846,3740
30113,48427,45-49,1905,1837,3742
30114,48427,50-54,1909,1724,3633
30115,48427,55-59,1634,1375,3009
30116,48427,60-64,1467,1220,2687
30117,48427,65+,4235,3261,7496
30118,48429,15-19,272,337,609
30119,48429,20-24,208,385,593
30120,48429,25-29,220,345,565
30121,48429,30-34,242,305,547
30122,48429,35-39,253,318,571
30123,48429,40-44,270,323,593
30124,48429,45-49,211,252,463
30125,48429,50-54,231,278,509
30126,48429,55-59,275,280,555
30127,48429,60-64,323,294,617
30128,48429,65+,1025,894,1919
30129,48431,15-19,58,60,118
30130,48431,20-24,32,39,71
30131,48431,25-29,23,37,60
30132,48431,30-34,39,43,82
30133,48431,35-39,52,56,108
30134,48431,40-44,60,49,109
30135,48431,45-49,30,44,74
30136,48431,50-54,39,33,72
30137,48431,55-59,32,34,66
30138,48431,60-64,41,57,98
30139,48431,65+,112,85,197
30140,48433,15-19,37,47,84
30141,48433,20-24,27,24,51
30142,48433,25-29,23,29,52
30143,48433,30-34,32,27,59
30144,48433,35-39,26,29,55
30145,48433,40-44,45,31,76
30146,48433,45-49,24,43,67
30147,48433,50-54,30,37,67
30148,48433,55-59,41,45,86
30149,48433,60-64,45,45,90
30150,48433,65+,170,146,316
30151,48435,15-19,113,112,225
30152,48435,20-24,96,89,185
30153,48435,25-29,81,75,156
30154,48435,30-34,85,100,185
30155,48435,35-39,80,104,184
30156,48435,40-44,89,89,178
30157,48435,45-49,101,97,198
30158,48435,50-54,108,133,241
30159,48435,55-59,116,105,221
30160,48435,60-64,112,110,222
30161,48435,65+,331,325,656
30162,48437,15-19,227,256,483
30163,48437,20-24,209,346,555
30164,48437,25-29,195,316,511
30165,48437,30-34,159,293,452
30166,48437,35-39,220,249,469
30167,48437,40-44,172,227,399
30168,48437,45-49,153,207,360
30169,48437,50-54,181,213,394
30170,48437,55-59,200,219,419
30171,48437,60-64,192,198,390
30172,48437,65+,659,557,1216
30173,48439,15-19,77633,79303,156936
30174,48439,20-24,71287,70366,141653
30175,48439,25-29,78132,76509,154641
30176,48439,30-34,80789,77338,158127
30177,48439,35-39,78031,75798,153829
30178,48439,40-44,73741,69960,143701
30179,48439,45-49,68738,64870,133608
30180,48439,50-54,67484,66036,133520
30181,48439,55-59,64969,64048,129017
30182,48439,60-64,59452,57707,117159
30183,48439,65+,141623,113311,254934
30184,48441,15-19,5598,5552,11150
30185,48441,20-24,7247,7204,14451
30186,48441,25-29,5275,5378,10653
30187,48441,30-34,4912,4863,9775
30188,48441,35-39,4841,4935,9776
30189,48441,40-44,3965,3941,7906
30190,48441,45-49,3396,3323,6719
30191,48441,50-54,3492,3308,6800
30192,48441,55-59,3868,3591,7459
30193,48441,60-64,4029,3631,7660
30194,48441,65+,11912,9149,21061
30195,48443,15-19,22,16,38
30196,48443,20-24,8,14,22
30197,48443,25-29,10,10,20
30198,48443,30-34,16,14,30
30199,48443,35-39,21,16,37
30200,48443,40-44,21,18,39
30201,48443,45-49,17,23,40
30202,48443,50-54,17,19,36
30203,48443,55-59,23,31,54
30204,48443,60-64,26,17,43
30205,48443,65+,115,133,248
30206,48445,15-19,412,435,847
30207,48445,20-24,324,495,819
30208,48445,25-29,295,485,780
30209,48445,30-34,328,465,793
30210,48445,35-39,318,485,803
30211,48445,40-44,309,399,708
30212,48445,45-49,265,356,621
30213,48445,50-54,288,335,623
30214,48445,55-59,336,329,665
30215,48445,60-64,317,331,648
30216,48445,65+,949,791,1740
30217,48447,15-19,38,44,82
30218,48447,20-24,27,32,59
30219,48447,25-29,37,49,86
30220,48447,30-34,31,33,64
30221,48447,35-39,39,33,72
30222,48447,40-44,41,38,79
30223,48447,45-49,48,35,83
30224,48447,50-54,44,38,82
30225,48447,55-59,50,52,102
30226,48447,60-64,63,60,123
30227,48447,65+,192,186,378
30228,48449,15-19,1272,1266,2538
30229,48449,20-24,1041,1076,2117
30230,48449,25-29,994,1006,2000
30231,48449,30-34,979,916,1895
30232,48449,35-39,863,819,1682
30233,48449,40-44,926,809,1735
30234,48449,45-49,923,908,1831
30235,48449,50-54,934,993,1927
30236,48449,55-59,927,972,1899
30237,48449,60-64,838,817,1655
30238,48449,65+,2461,2092,4553
30239,48451,15-19,4447,4746,9193
30240,48451,20-24,4345,4920,9265
30241,48451,25-29,4098,4422,8520
30242,48451,30-34,4254,4518,8772
30243,48451,35-39,4048,4359,8407
30244,48451,40-44,3451,3547,6998
30245,48451,45-49,2890,2851,5741
30246,48451,50-54,3061,3054,6115
30247,48451,55-59,3466,3137,6603
30248,48451,60-64,3578,3224,6802
30249,48451,65+,10432,8773,19205
30250,48453,15-19,38810,39516,78326
30251,48453,20-24,41446,40769,82215
30252,48453,25-29,59326,62124,121450
30253,48453,30-34,63661,70043,133704
30254,48453,35-39,55931,62236,118167
30255,48453,40-44,48374,52750,101124
30256,48453,45-49,43041,46466,89507
30257,48453,50-54,39231,42317,81548
30258,48453,55-59,35064,35762,70826
30259,48453,60-64,32866,31842,64708
30260,48453,65+,75239,63649,138888
30261,48455,15-19,384,369,753
30262,48455,20-24,319,307,626
30263,48455,25-29,333,314,647
30264,48455,30-34,324,335,659
30265,48455,35-39,381,321,702
30266,48455,40-44,358,350,708
30267,48455,45-49,386,344,730
30268,48455,50-54,431,398,829
30269,48455,55-59,565,518,1083
30270,48455,60-64,598,524,1122
30271,48455,65+,1929,1806,3735
30272,48457,15-19,524,585,1109
30273,48457,20-24,413,840,1253
30274,48457,25-29,445,983,1428
30275,48457,30-34,425,837,1262
30276,48457,35-39,471,660,1131
30277,48457,40-44,500,650,1150
30278,48457,45-49,492,580,1072
30279,48457,50-54,595,564,1159
30280,48457,55-59,648,645,1293
30281,48457,60-64,703,692,1395
30282,48457,65+,2438,2210,4648
30283,48459,15-19,1321,1531,2852
30284,48459,20-24,1042,1193,2235
30285,48459,25-29,1158,1134,2292
30286,48459,30-34,1324,1170,2494
30287,48459,35-39,1278,1239,2517
30288,48459,40-44,1280,1251,2531
30289,48459,45-49,1185,1160,2345
30290,48459,50-54,1274,1308,2582
30291,48459,55-59,1502,1421,2923
30292,48459,60-64,1548,1481,3029
30293,48459,65+,4204,3686,7890
30294,48461,15-19,140,127,267
30295,48461,20-24,84,107,191
30296,48461,25-29,87,97,184
30297,48461,30-34,100,97,197
30298,48461,35-39,104,117,221
30299,48461,40-44,102,98,200
30300,48461,45-49,89,87,176
30301,48461,50-54,101,98,199
30302,48461,55-59,79,85,164
30303,48461,60-64,95,98,193
30304,48461,65+,262,257,519
30305,48463,15-19,908,1007,1915
30306,48463,20-24,855,907,1762
30307,48463,25-29,860,893,1753
30308,48463,30-34,779,818,1597
30309,48463,35-39,702,710,1412
30310,48463,40-44,703,703,1406
30311,48463,45-49,688,683,1371
30312,48463,50-54,696,657,1353
30313,48463,55-59,662,611,1273
30314,48463,60-64,680,605,1285
30315,48463,65+,2194,1787,3981
30316,48465,15-19,1731,1827,3558
30317,48465,20-24,1638,2197,3835
30318,48465,25-29,1613,2049,3662
30319,48465,30-34,1504,1837,3341
30320,48465,35-39,1367,1656,3023
30321,48465,40-44,1307,1404,2711
30322,48465,45-49,1287,1311,2598
30323,48465,50-54,1242,1218,2460
30324,48465,55-59,1171,1257,2428
30325,48465,60-64,1083,952,2035
30326,48465,65+,3573,2958,6531
30327,48467,15-19,1968,2061,4029
30328,48467,20-24,1613,1637,3250
30329,48467,25-29,1554,1622,3176
30330,48467,30-34,1726,1682,3408
30331,48467,35-39,1814,1753,3567
30332,48467,40-44,1813,1745,3558
30333,48467,45-49,1866,1867,3733
30334,48467,50-54,2002,1917,3919
30335,48467,55-59,2207,2136,4343
30336,48467,60-64,2211,2197,4408
30337,48467,65+,6658,5806,12464
30338,48469,15-19,3204,3254,6458
30339,48469,20-24,2990,2942,5932
30340,48469,25-29,2998,3048,6046
30341,48469,30-34,3057,3126,6183
30342,48469,35-39,2982,3089,6071
30343,48469,40-44,2781,2696,5477
30344,48469,45-49,2492,2359,4851
30345,48469,50-54,2435,2299,4734
30346,48469,55-59,2693,2599,5292
30347,48469,60-64,2845,2703,5548
30348,48469,65+,8382,6853,15235
30349,48471,15-19,2905,2677,5582
30350,48471,20-24,5300,5457,10757
30351,48471,25-29,2080,3614,5694
30352,48471,30-34,1783,3678,5461
30353,48471,35-39,1674,3727,5401
30354,48471,40-44,1609,3634,5243
30355,48471,45-49,1540,3673,5213
30356,48471,50-54,1714,3497,5211
30357,48471,55-59,1903,2752,4655
30358,48471,60-64,1916,2331,4247
30359,48471,65+,5730,5280,11010
30360,48473,15-19,3408,2985,6393
30361,48473,20-24,3854,3786,7640
30362,48473,25-29,1620,1705,3325
30363,48473,30-34,1689,1669,3358
30364,48473,35-39,1755,1866,3621
30365,48473,40-44,1694,1770,3464
30366,48473,45-49,1501,1600,3101
30367,48473,50-54,1583,1567,3150
30368,48473,55-59,1644,1669,3313
30369,48473,60-64,1597,1636,3233
30370,48473,65+,3744,3479,7223
30371,48475,15-19,405,418,823
30372,48475,20-24,303,335,638
30373,48475,25-29,360,384,744
30374,48475,30-34,356,412,768
30375,48475,35-39,380,409,789
30376,48475,40-44,308,388,696
30377,48475,45-49,288,287,575
30378,48475,50-54,275,326,601
30379,48475,55-59,327,318,645
30380,48475,60-64,309,304,613
30381,48475,65+,851,690,1541
30382,48477,15-19,1473,1633,3106
30383,48477,20-24,1034,1201,2235
30384,48477,25-29,897,803,1700
30385,48477,30-34,960,873,1833
30386,48477,35-39,1015,962,1977
30387,48477,40-44,958,971,1929
30388,48477,45-49,936,908,1844
30389,48477,50-54,965,972,1937
30390,48477,55-59,1194,1141,2335
30391,48477,60-64,1328,1224,2552
30392,48477,65+,4477,3693,8170
30393,48479,15-19,11532,12034,23566
30394,48479,20-24,10566,10570,21136
30395,48479,25-29,9536,10078,19614
30396,48479,30-34,8301,8869,17170
30397,48479,35-39,7972,8466,16438
30398,48479,40-44,8221,8221,16442
30399,48479,45-49,8453,8235,16688
30400,48479,50-54,7972,7169,15141
30401,48479,55-59,6664,6073,12737
30402,48479,60-64,5906,5304,11210
30403,48479,65+,15008,11687,26695
30404,48481,15-19,1484,1566,3050
30405,48481,20-24,1345,1294,2639
30406,48481,25-29,1204,1339,2543
30407,48481,30-34,1215,1232,2447
30408,48481,35-39,1361,1298,2659
30409,48481,40-44,1238,1187,2425
30410,48481,45-49,1086,1058,2144
30411,48481,50-54,1163,1174,2337
30412,48481,55-59,1324,1300,2624
30413,48481,60-64,1316,1288,2604
30414,48481,65+,3998,3396,7394
30415,48483,15-19,163,175,338
30416,48483,20-24,110,109,219
30417,48483,25-29,126,138,264
30418,48483,30-34,129,132,261
30419,48483,35-39,162,170,332
30420,48483,40-44,144,123,267
30421,48483,45-49,153,146,299
30422,48483,50-54,130,138,268
30423,48483,55-59,153,146,299
30424,48483,60-64,180,179,359
30425,48483,65+,538,492,1030
30426,48485,15-19,4546,5879,10425
30427,48485,20-24,4598,6644,11242
30428,48485,25-29,4187,5333,9520
30429,48485,30-34,4395,5091,9486
30430,48485,35-39,4103,4692,8795
30431,48485,40-44,3409,4041,7450
30432,48485,45-49,3096,3551,6647
30433,48485,50-54,3227,3440,6667
30434,48485,55-59,3812,3705,7517
30435,48485,60-64,3999,3898,7897
30436,48485,65+,10957,8711,19668
30437,48487,15-19,421,500,921
30438,48487,20-24,335,407,742
30439,48487,25-29,385,412,797
30440,48487,30-34,458,391,849
30441,48487,35-39,456,439,895
30442,48487,40-44,371,414,785
30443,48487,45-49,369,372,741
30444,48487,50-54,361,324,685
30445,48487,55-59,428,412,840
30446,48487,60-64,435,409,844
30447,48487,65+,1291,1115,2406
30448,48489,15-19,680,850,1530
30449,48489,20-24,646,1241,1887
30450,48489,25-29,636,1195,1831
30451,48489,30-34,532,995,1527
30452,48489,35-39,523,945,1468
30453,48489,40-44,518,772,1290
30454,48489,45-49,492,656,1148
30455,48489,50-54,472,545,1017
30456,48489,55-59,497,419,916
30457,48489,60-64,465,475,940
30458,48489,65+,1562,1276,2838
30459,48491,15-19,20663,21908,42571
30460,48491,20-24,17735,17950,35685
30461,48491,25-29,20703,20558,41261
30462,48491,30-34,24879,24436,49315
30463,48491,35-39,27500,28021,55521
30464,48491,40-44,26291,26686,52977
30465,48491,45-49,22454,23512,45966
30466,48491,50-54,20284,21110,41394
30467,48491,55-59,17833,17411,35244
30468,48491,60-64,16467,15437,31904
30469,48491,65+,45129,36170,81299
30470,48493,15-19,1684,1806,3490
30471,48493,20-24,1371,1487,2858
30472,48493,25-29,1312,1396,2708
30473,48493,30-34,1474,1503,2977
30474,48493,35-39,1705,1703,3408
30475,48493,40-44,1619,1690,3309
30476,48493,45-49,1650,1683,3333
30477,48493,50-54,1783,1822,3605
30478,48493,55-59,1798,1883,3681
30479,48493,60-64,1765,1765,3530
30480,48493,65+,4415,4028,8443
30481,48495,15-19,284,296,580
30482,48495,20-24,232,262,494
30483,48495,25-29,192,255,447
30484,48495,30-34,219,255,474
30485,48495,35-39,241,251,492
30486,48495,40-44,219,233,452
30487,48495,45-49,235,275,510
30488,48495,50-54,199,229,428
30489,48495,55-59,209,270,479
30490,48495,60-64,180,197,377
30491,48495,65+,484,429,913
30492,48497,15-19,2334,2510,4844
30493,48497,20-24,1876,1976,3852
30494,48497,25-29,2018,2086,4104
30495,48497,30-34,2319,2332,4651
30496,48497,35-39,2329,2451,4780
30497,48497,40-44,2295,2285,4580
30498,48497,45-49,2091,2232,4323
30499,48497,50-54,2400,2517,4917
30500,48497,55-59,2558,2580,5138
30501,48497,60-64,2516,2524,5040
30502,48497,65+,5728,5279,11007
30503,48499,15-19,1306,1431,2737
30504,48499,20-24,1208,1417,2625
30505,48499,25-29,1020,1165,2185
30506,48499,30-34,1033,1153,2186
30507,48499,35-39,1107,1168,2275
30508,48499,40-44,1144,1168,2312
30509,48499,45-49,1127,1127,2254
30510,48499,50-54,1262,1352,2614
30511,48499,55-59,1675,1527,3202
30512,48499,60-64,1974,1928,3902
30513,48499,65+,6667,5905,12572
30514,48501,15-19,324,329,653
30515,48501,20-24,264,282,546
30516,48501,25-29,193,261,454
30517,48501,30-34,226,241,467
30518,48501,35-39,216,248,464
30519,48501,40-44,250,194,444
30520,48501,45-49,184,210,394
30521,48501,50-54,182,175,357
30522,48501,55-59,197,209,406
30523,48501,60-64,183,204,387
30524,48501,65+,482,434,916
30525,48503,15-19,574,586,1160
30526,48503,20-24,444,518,962
30527,48503,25-29,479,511,990
30528,48503,30-34,533,497,1030
30529,48503,35-39,539,573,1112
30530,48503,40-44,539,519,1058
30531,48503,45-49,460,482,942
30532,48503,50-54,518,504,1022
30533,48503,55-59,542,597,1139
30534,48503,60-64,671,671,1342
30535,48503,65+,1999,1723,3722
30536,48505,15-19,553,641,1194
30537,48505,20-24,489,504,993
30538,48505,25-29,415,442,857
30539,48505,30-34,419,385,804
30540,48505,35-39,415,420,835
30541,48505,40-44,437,394,831
30542,48505,45-49,427,373,800
30543,48505,50-54,399,327,726
30544,48505,55-59,369,307,676
30545,48505,60-64,277,294,571
30546,48505,65+,964,861,1825
30547,48507,15-19,356,435,791
30548,48507,20-24,343,452,795
30549,48507,25-29,319,369,688
30550,48507,30-34,290,324,614
30551,48507,35-39,269,270,539
30552,48507,40-44,250,301,551
30553,48507,45-49,252,288,540
30554,48507,50-54,262,226,488
30555,48507,55-59,234,235,469
30556,48507,60-64,228,218,446
30557,48507,65+,751,614,1365
30558,49001,15-19,308,349,657
30559,49001,20-24,217,252,469
30560,49001,25-29,199,195,394
30561,49001,30-34,163,179,342
30562,49001,35-39,226,224,450
30563,49001,40-44,237,253,490
30564,49001,45-49,190,184,374
30565,49001,50-54,156,174,330
30566,49001,55-59,162,205,367
30567,49001,60-64,220,227,447
30568,49001,65+,553,569,1122
30569,49003,15-19,2244,2579,4823
30570,49003,20-24,1782,2012,3794
30571,49003,25-29,1871,1989,3860
30572,49003,30-34,1836,1848,3684
30573,49003,35-39,2042,2080,4122
30574,49003,40-44,2001,2176,4177
30575,49003,45-49,1663,1629,3292
30576,49003,50-54,1376,1475,2851
30577,49003,55-59,1482,1489,2971
30578,49003,60-64,1601,1651,3252
30579,49003,65+,3932,3743,7675
30580,49005,15-19,7222,6285,13507
30581,49005,20-24,9744,9602,19346
30582,49005,25-29,5154,5954,11108
30583,49005,30-34,3876,4148,8024
30584,49005,35-39,3947,4075,8022
30585,49005,40-44,4062,4084,8146
30586,49005,45-49,3204,3326,6530
30587,49005,50-54,2605,2762,5367
30588,49005,55-59,2517,2496,5013
30589,49005,60-64,2593,2455,5048
30590,49005,65+,7163,6488,13651
30591,49007,15-19,853,761,1614
30592,49007,20-24,647,667,1314
30593,49007,25-29,549,588,1137
30594,49007,30-34,588,596,1184
30595,49007,35-39,668,640,1308
30596,49007,40-44,650,667,1317
30597,49007,45-49,557,554,1111
30598,49007,50-54,507,504,1011
30599,49007,55-59,559,509,1068
30600,49007,60-64,633,679,1312
30601,49007,65+,1972,1814,3786
30602,49009,15-19,27,49,76
30603,49009,20-24,11,17,28
30604,49009,25-29,12,10,22
30605,49009,30-34,20,23,43
30606,49009,35-39,24,27,51
30607,49009,40-44,36,35,71
30608,49009,45-49,31,31,62
30609,49009,50-54,25,32,57
30610,49009,55-59,25,45,70
30611,49009,60-64,37,41,78
30612,49009,65+,104,148,252
30613,49011,15-19,14517,16132,30649
30614,49011,20-24,11539,12963,24502
30615,49011,25-29,12135,12619,24754
30616,49011,30-34,12825,12635,25460
30617,49011,35-39,13646,13811,27457
30618,49011,40-44,13747,14484,28231
30619,49011,45-49,10838,11034,21872
30620,49011,50-54,9171,9367,18538
30621,49011,55-59,8415,8635,17050
30622,49011,60-64,8469,8477,16946
30623,49011,65+,20766,18369,39135
30624,49013,15-19,785,851,1636
30625,49013,20-24,497,575,1072
30626,49013,25-29,540,488,1028
30627,49013,30-34,608,626,1234
30628,49013,35-39,701,664,1365
30629,49013,40-44,692,783,1475
30630,49013,45-49,517,576,1093
30631,49013,50-54,443,461,904
30632,49013,55-59,482,468,950
30633,49013,60-64,555,549,1104
30634,49013,65+,1253,1292,2545
30635,49015,15-19,390,425,815
30636,49015,20-24,265,284,549
30637,49015,25-29,243,275,518
30638,49015,30-34,265,240,505
30639,49015,35-39,304,288,592
30640,49015,40-44,333,329,662
30641,49015,45-49,289,280,569
30642,49015,50-54,241,246,487
30643,49015,55-59,268,252,520
30644,49015,60-64,354,337,691
30645,49015,65+,895,900,1795
30646,49017,15-19,162,217,379
30647,49017,20-24,124,132,256
30648,49017,25-29,125,154,279
30649,49017,30-34,144,146,290
30650,49017,35-39,154,171,325
30651,49017,40-44,135,165,300
30652,49017,45-49,123,155,278
30653,49017,50-54,113,114,227
30654,49017,55-59,151,166,317
30655,49017,60-64,187,182,369
30656,49017,65+,585,637,1222
30657,49019,15-19,248,263,511
30658,49019,20-24,240,232,472
30659,49019,25-29,339,307,646
30660,49019,30-34,360,339,699
30661,49019,35-39,340,352,692
30662,49019,40-44,324,322,646
30663,49019,45-49,271,290,561
30664,49019,50-54,258,270,528
30665,49019,55-59,283,293,576
30666,49019,60-64,363,357,720
30667,49019,65+,980,984,1964
30668,49021,15-19,2963,2642,5605
30669,49021,20-24,3212,3233,6445
30670,49021,25-29,2026,2173,4199
30671,49021,30-34,1781,1841,3622
30672,49021,35-39,1802,1783,3585
30673,49021,40-44,1861,1903,3764
30674,49021,45-49,1483,1509,2992
30675,49021,50-54,1312,1285,2597
30676,49021,55-59,1316,1345,2661
30677,49021,60-64,1507,1488,2995
30678,49021,65+,4214,4005,8219
30679,49023,15-19,471,616,1087
30680,49023,20-24,399,445,844
30681,49023,25-29,399,384,783
30682,49023,30-34,341,382,723
30683,49023,35-39,382,387,769
30684,49023,40-44,413,459,872
30685,49023,45-49,320,342,662
30686,49023,50-54,277,290,567
30687,49023,55-59,276,280,556
30688,49023,60-64,238,272,510
30689,49023,65+,743,681,1424
30690,49025,15-19,260,262,522
30691,49025,20-24,143,210,353
30692,49025,25-29,203,205,408
30693,49025,30-34,198,243,441
30694,49025,35-39,245,231,476
30695,49025,40-44,239,259,498
30696,49025,45-49,193,210,403
30697,49025,50-54,190,188,378
30698,49025,55-59,268,232,500
30699,49025,60-64,306,291,597
30700,49025,65+,954,933,1887
30701,49027,15-19,539,572,1111
30702,49027,20-24,331,380,711
30703,49027,25-29,340,331,671
30704,49027,30-34,352,332,684
30705,49027,35-39,392,426,818
30706,49027,40-44,376,437,813
30707,49027,45-49,318,350,668
30708,49027,50-54,300,311,611
30709,49027,55-59,319,320,639
30710,49027,60-64,389,394,783
30711,49027,65+,1145,1153,2298
30712,49029,15-19,577,700,1277
30713,49029,20-24,335,409,744
30714,49029,25-29,288,272,560
30715,49029,30-34,308,245,553
30716,49029,35-39,430,399,829
30717,49029,40-44,462,509,971
30718,49029,45-49,373,430,803
30719,49029,50-54,351,357,708
30720,49029,55-59,308,319,627
30721,49029,60-64,274,323,597
30722,49029,65+,780,773,1553
30723,49031,15-19,55,68,123
30724,49031,20-24,35,39,74
30725,49031,25-29,42,27,69
30726,49031,30-34,37,31,68
30727,49031,35-39,32,34,66
30728,49031,40-44,42,39,81
30729,49031,45-49,38,41,79
30730,49031,50-54,32,38,70
30731,49031,55-59,43,48,91
30732,49031,60-64,45,54,99
30733,49031,65+,204,213,417
30734,49033,15-19,104,103,207
30735,49033,20-24,61,68,129
30736,49033,25-29,56,55,111
30737,49033,30-34,80,63,143
30738,49033,35-39,73,90,163
30739,49033,40-44,86,87,173
30740,49033,45-49,57,78,135
30741,49033,50-54,50,63,113
30742,49033,55-59,75,59,134
30743,49033,60-64,85,95,180
30744,49033,65+,221,285,506
30745,49035,15-19,41308,43843,85151
30746,49035,20-24,40893,42416,83309
30747,49035,25-29,47843,50040,97883
30748,49035,30-34,46794,48969,95763
30749,49035,35-39,43910,45945,89855
30750,49035,40-44,42546,45165,87711
30751,49035,45-49,35107,37520,72627
30752,49035,50-54,31729,33782,65511
30753,49035,55-59,29844,30098,59942
30754,49035,60-64,29489,28538,58027
30755,49035,65+,74147,63862,138009
30756,49037,15-19,629,634,1263
30757,49037,20-24,444,449,893
30758,49037,25-29,423,447,870
30759,49037,30-34,452,460,912
30760,49037,35-39,387,403,790
30761,49037,40-44,415,432,847
30762,49037,45-49,426,411,837
30763,49037,50-54,353,418,771
30764,49037,55-59,464,450,914
30765,49037,60-64,488,397,885
30766,49037,65+,1135,1029,2164
30767,49039,15-19,1550,1401,2951
30768,49039,20-24,1167,1477,2644
30769,49039,25-29,767,1070,1837
30770,49039,30-34,766,1011,1777
30771,49039,35-39,818,1044,1862
30772,49039,40-44,855,1117,1972
30773,49039,45-49,752,1007,1759
30774,49039,50-54,672,784,1456
30775,49039,55-59,677,743,1420
30776,49039,60-64,736,804,1540
30777,49039,65+,2183,2113,4296
30778,49041,15-19,797,949,1746
30779,49041,20-24,623,685,1308
30780,49041,25-29,577,630,1207
30781,49041,30-34,618,606,1224
30782,49041,35-39,693,711,1404
30783,49041,40-44,768,766,1534
30784,49041,45-49,585,659,1244
30785,49041,50-54,479,553,1032
30786,49041,55-59,615,564,1179
30787,49041,60-64,654,634,1288
30788,49041,65+,1903,1834,3737
30789,49043,15-19,1461,1648,3109
30790,49043,20-24,1164,1250,2414
30791,49043,25-29,1144,1273,2417
30792,49043,30-34,1174,1247,2421
30793,49043,35-39,1309,1367,2676
30794,49043,40-44,1506,1527,3033
30795,49043,45-49,1441,1538,2979
30796,49043,50-54,1653,1689,3342
30797,49043,55-59,1592,1633,3225
30798,49043,60-64,1605,1637,3242
30799,49043,65+,3000,3332,6332
30800,49045,15-19,3108,3328,6436
30801,49045,20-24,2325,2447,4772
30802,49045,25-29,2628,2530,5158
30803,49045,30-34,2739,2719,5458
30804,49045,35-39,2894,2968,5862
30805,49045,40-44,2925,3063,5988
30806,49045,45-49,2359,2594,4953
30807,49045,50-54,1944,2196,4140
30808,49045,55-59,1765,1890,3655
30809,49045,60-64,1582,1752,3334
30810,49045,65+,3626,3460,7086
30811,49047,15-19,1472,1559,3031
30812,49047,20-24,964,1071,2035
30813,49047,25-29,1102,1127,2229
30814,49047,30-34,1243,1218,2461
30815,49047,35-39,1336,1401,2737
30816,49047,40-44,1278,1363,2641
30817,49047,45-49,989,1019,2008
30818,49047,50-54,804,913,1717
30819,49047,55-59,889,816,1705
30820,49047,60-64,919,907,1826
30821,49047,65+,2231,2114,4345
30822,49049,15-19,32775,32721,65496
30823,49049,20-24,41571,43277,84848
30824,49049,25-29,27687,30375,58062
30825,49049,30-34,21765,22648,44413
30826,49049,35-39,20845,21702,42547
30827,49049,40-44,21364,22412,43776
30828,49049,45-49,16862,17586,34448
30829,49049,50-54,13752,14374,28126
30830,49049,55-59,11732,12135,23867
30831,49049,60-64,11250,11045,22295
30832,49049,65+,28857,25046,53903
30833,49051,15-19,1449,1591,3040
30834,49051,20-24,1003,1155,2158
30835,49051,25-29,907,981,1888
30836,49051,30-34,999,1003,2002
30837,49051,35-39,1235,1259,2494
30838,49051,40-44,1357,1373,2730
30839,49051,45-49,1083,1192,2275
30840,49051,50-54,1036,1063,2099
30841,49051,55-59,1003,1001,2004
30842,49051,60-64,1051,1143,2194
30843,49051,65+,2265,2398,4663
30844,49053,15-19,6758,7239,13997
30845,49053,20-24,6012,6205,12217
30846,49053,25-29,5477,5699,11176
30847,49053,30-34,5335,5185,10520
30848,49053,35-39,5803,5685,11488
30849,49053,40-44,5710,5978,11688
30850,49053,45-49,4800,4890,9690
30851,49053,50-54,4586,4612,9198
30852,49053,55-59,4869,4354,9223
30853,49053,60-64,6028,5093,11121
30854,49053,65+,21831,20371,42202
30855,49055,15-19,78,81,159
30856,49055,20-24,69,77,146
30857,49055,25-29,68,71,139
30858,49055,30-34,54,63,117
30859,49055,35-39,67,90,157
30860,49055,40-44,64,76,140
30861,49055,45-49,75,62,137
30862,49055,50-54,55,80,135
30863,49055,55-59,83,92,175
30864,49055,60-64,104,90,194
30865,49055,65+,282,305,587
30866,49057,15-19,9377,9996,19373
30867,49057,20-24,9413,9812,19225
30868,49057,25-29,10118,10656,20774
30869,49057,30-34,9641,10093,19734
30870,49057,35-39,9278,9927,19205
30871,49057,40-44,9200,9594,18794
30872,49057,45-49,7562,8060,15622
30873,49057,50-54,6975,7129,14104
30874,49057,55-59,6910,7167,14077
30875,49057,60-64,6860,6958,13818
30876,49057,65+,17232,15141,32373
30877,50001,15-19,1382,1444,2826
30878,50001,20-24,1546,1695,3241
30879,50001,25-29,937,917,1854
30880,50001,30-34,1017,1061,2078
30881,50001,35-39,1074,1055,2129
30882,50001,40-44,975,1017,1992
30883,50001,45-49,1029,1031,2060
30884,50001,50-54,1241,1215,2456
30885,50001,55-59,1333,1368,2701
30886,50001,60-64,1464,1447,2911
30887,50001,65+,4236,3927,8163
30888,50003,15-19,1205,1287,2492
30889,50003,20-24,1225,1083,2308
30890,50003,25-29,865,928,1793
30891,50003,30-34,888,919,1807
30892,50003,35-39,1031,973,2004
30893,50003,40-44,1002,978,1980
30894,50003,45-49,949,976,1925
30895,50003,50-54,1350,1212,2562
30896,50003,55-59,1455,1414,2869
30897,50003,60-64,1587,1567,3154
30898,50003,65+,4759,4083,8842
30899,50005,15-19,968,1149,2117
30900,50005,20-24,823,941,1764
30901,50005,25-29,780,840,1620
30902,50005,30-34,854,845,1699
30903,50005,35-39,807,852,1659
30904,50005,40-44,949,855,1804
30905,50005,45-49,889,940,1829
30906,50005,50-54,966,1036,2002
30907,50005,55-59,1130,1055,2185
30908,50005,60-64,1253,1182,2435
30909,50005,65+,3477,3234,6711
30910,50007,15-19,6949,6821,13770
30911,50007,20-24,9146,8706,17852
30912,50007,25-29,6294,6667,12961
30913,50007,30-34,5666,5822,11488
30914,50007,35-39,5421,5619,11040
30915,50007,40-44,5053,4992,10045
30916,50007,45-49,4581,4499,9080
30917,50007,50-54,5130,5001,10131
30918,50007,55-59,5350,5170,10520
30919,50007,60-64,5524,5286,10810
30920,50007,65+,15196,12096,27292
30921,50009,15-19,150,149,299
30922,50009,20-24,114,120,234
30923,50009,25-29,132,125,257
30924,50009,30-34,141,128,269
30925,50009,35-39,156,147,303
30926,50009,40-44,145,154,299
30927,50009,45-49,160,184,344
30928,50009,50-54,218,218,436
30929,50009,55-59,252,257,509
30930,50009,60-64,281,277,558
30931,50009,65+,802,802,1604
30932,50011,15-19,1372,1492,2864
30933,50011,20-24,1330,1313,2643
30934,50011,25-29,1563,1609,3172
30935,50011,30-34,1684,1750,3434
30936,50011,35-39,1713,1614,3327
30937,50011,40-44,1591,1620,3211
30938,50011,45-49,1505,1586,3091
30939,50011,50-54,1735,1709,3444
30940,50011,55-59,1865,1868,3733
30941,50011,60-64,1834,1889,3723
30942,50011,65+,4507,4112,8619
30943,50013,15-19,172,201,373
30944,50013,20-24,154,178,332
30945,50013,25-29,183,193,376
30946,50013,30-34,216,249,465
30947,50013,35-39,209,209,418
30948,50013,40-44,210,207,417
30949,50013,45-49,214,196,410
30950,50013,50-54,262,267,529
30951,50013,55-59,342,335,677
30952,50013,60-64,348,384,732
30953,50013,65+,822,840,1662
30954,50015,15-19,835,850,1685
30955,50015,20-24,711,765,1476
30956,50015,25-29,778,807,1585
30957,50015,30-34,869,904,1773
30958,50015,35-39,847,853,1700
30959,50015,40-44,870,890,1760
30960,50015,45-49,799,849,1648
30961,50015,50-54,816,895,1711
30962,50015,55-59,916,911,1827
30963,50015,60-64,978,929,1907
30964,50015,65+,2451,2316,4767
30965,50017,15-19,701,908,1609
30966,50017,20-24,685,809,1494
30967,50017,25-29,769,752,1521
30968,50017,30-34,824,863,1687
30969,50017,35-39,950,939,1889
30970,50017,40-44,870,925,1795
30971,50017,45-49,853,835,1688
30972,50017,50-54,973,973,1946
30973,50017,55-59,1171,1123,2294
30974,50017,60-64,1307,1281,2588
30975,50017,65+,3504,3149,6653
30976,50019,15-19,727,761,1488
30977,50019,20-24,708,774,1482
30978,50019,25-29,711,824,1535
30979,50019,30-34,731,810,1541
30980,50019,35-39,753,829,1582
30981,50019,40-44,820,812,1632
30982,50019,45-49,750,813,1563
30983,50019,50-54,877,924,1801
30984,50019,55-59,982,968,1950
30985,50019,60-64,1052,1055,2107
30986,50019,65+,3433,3064,6497
30987,50021,15-19,1847,1922,3769
30988,50021,20-24,1735,1872,3607
30989,50021,25-29,1528,1696,3224
30990,50021,30-34,1614,1770,3384
30991,50021,35-39,1711,1706,3417
30992,50021,40-44,1599,1599,3198
30993,50021,45-49,1597,1612,3209
30994,50021,50-54,2005,2019,4024
30995,50021,55-59,2411,2390,4801
30996,50021,60-64,2650,2480,5130
30997,50021,65+,7566,6741,14307
30998,50023,15-19,1768,2339,4107
30999,50023,20-24,1673,2231,3904
31000,50023,25-29,1579,1593,3172
31001,50023,30-34,1854,1827,3681
31002,50023,35-39,1891,1849,3740
31003,50023,40-44,1943,1815,3758
31004,50023,45-49,1787,1820,3607
31005,50023,50-54,2066,1986,4052
31006,50023,55-59,2209,2160,4369
31007,50023,60-64,2291,2121,4412
31008,50023,65+,6698,5762,12460
31009,50025,15-19,1152,1294,2446
31010,50025,20-24,1124,1275,2399
31011,50025,25-29,1167,1180,2347
31012,50025,30-34,1289,1262,2551
31013,50025,35-39,1381,1350,2731
31014,50025,40-44,1401,1265,2666
31015,50025,45-49,1243,1204,2447
31016,50025,50-54,1474,1366,2840
31017,50025,55-59,1854,1703,3557
31018,50025,60-64,2060,2074,4134
31019,50025,65+,5952,5392,11344
31020,50027,15-19,1416,1497,2913
31021,50027,20-24,1272,1352,2624
31022,50027,25-29,1552,1543,3095
31023,50027,30-34,1661,1629,3290
31024,50027,35-39,1877,1796,3673
31025,50027,40-44,1695,1718,3413
31026,50027,45-49,1560,1620,3180
31027,50027,50-54,1819,1888,3707
31028,50027,55-59,2337,2141,4478
31029,50027,60-64,2666,2442,5108
31030,50027,65+,7580,6757,14337
31031,51001,15-19,845,960,1805
31032,51001,20-24,720,844,1564
31033,51001,25-29,816,812,1628
31034,51001,30-34,929,889,1818
31035,51001,35-39,865,813,1678
31036,51001,40-44,863,857,1720
31037,51001,45-49,894,835,1729
31038,51001,50-54,1045,1011,2056
31039,51001,55-59,1266,1126,2392
31040,51001,60-64,1475,1360,2835
31041,51001,65+,4513,3869,8382
31042,51003,15-19,4930,4646,9576
31043,51003,20-24,3770,3673,7443
31044,51003,25-29,3699,3418,7117
31045,51003,30-34,3708,3562,7270
31046,51003,35-39,3706,3669,7375
31047,51003,40-44,3423,3346,6769
31048,51003,45-49,3034,2994,6028
31049,51003,50-54,3416,3295,6711
31050,51003,55-59,3707,3235,6942
31051,51003,60-64,4006,3433,7439
31052,51003,65+,12477,9939,22416
31053,51005,15-19,378,452,830
31054,51005,20-24,398,401,799
31055,51005,25-29,390,396,786
31056,51005,30-34,368,381,749
31057,51005,35-39,370,354,724
31058,51005,40-44,388,383,771
31059,51005,45-49,423,408,831
31060,51005,50-54,528,552,1080
31061,51005,55-59,596,593,1189
31062,51005,60-64,613,562,1175
31063,51005,65+,2121,1748,3869
31064,51007,15-19,357,387,744
31065,51007,20-24,338,333,671
31066,51007,25-29,352,363,715
31067,51007,30-34,402,383,785
31068,51007,35-39,364,399,763
31069,51007,40-44,355,362,717
31070,51007,45-49,388,365,753
31071,51007,50-54,458,457,915
31072,51007,55-59,549,537,1086
31073,51007,60-64,600,582,1182
31074,51007,65+,1432,1294,2726
31075,51009,15-19,888,878,1766
31076,51009,20-24,853,911,1764
31077,51009,25-29,834,843,1677
31078,51009,30-34,1001,926,1927
31079,51009,35-39,898,871,1769
31080,51009,40-44,856,860,1716
31081,51009,45-49,940,885,1825
31082,51009,50-54,1095,1057,2152
31083,51009,55-59,1225,1176,2401
31084,51009,60-64,1225,1159,2384
31085,51009,65+,3772,3009,6781
31086,51011,15-19,442,450,892
31087,51011,20-24,435,418,853
31088,51011,25-29,488,514,1002
31089,51011,30-34,508,519,1027
31090,51011,35-39,505,464,969
31091,51011,40-44,469,459,928
31092,51011,45-49,445,463,908
31093,51011,50-54,524,517,1041
31094,51011,55-59,575,549,1124
31095,51011,60-64,641,585,1226
31096,51011,65+,1844,1553,3397
31097,51013,15-19,5041,5275,10316
31098,51013,20-24,7731,7856,15587
31099,51013,25-29,14250,14375,28625
31100,51013,30-34,11508,11931,23439
31101,51013,35-39,10062,10558,20620
31102,51013,40-44,8901,8945,17846
31103,51013,45-49,7689,7851,15540
31104,51013,50-54,7003,7588,14591
31105,51013,55-59,6056,6710,12766
31106,51013,60-64,5311,5570,10881
31107,51013,65+,14567,12439,27006
31108,51015,15-19,2066,2333,4399
31109,51015,20-24,1856,2270,4126
31110,51015,25-29,2053,2446,4499
31111,51015,30-34,2129,2492,4621
31112,51015,35-39,2225,2515,4740
31113,51015,40-44,2194,2473,4667
31114,51015,45-49,2220,2387,4607
31115,51015,50-54,2552,2740,5292
31116,51015,55-59,2978,2985,5963
31117,51015,60-64,2941,2937,5878
31118,51015,65+,9029,8003,17032
31119,51017,15-19,82,86,168
31120,51017,20-24,91,86,177
31121,51017,25-29,84,95,179
31122,51017,30-34,108,122,230
31123,51017,35-39,83,106,189
31124,51017,40-44,99,94,193
31125,51017,45-49,107,123,230
31126,51017,50-54,149,153,302
31127,51017,55-59,176,182,358
31128,51017,60-64,177,183,360
31129,51017,65+,565,618,1183
31130,51019,15-19,2281,2384,4665
31131,51019,20-24,2064,2101,4165
31132,51019,25-29,2081,2159,4240
31133,51019,30-34,2095,2100,4195
31134,51019,35-39,2159,2057,4216
31135,51019,40-44,2096,2128,4224
31136,51019,45-49,2426,2328,4754
31137,51019,50-54,2909,2864,5773
31138,51019,55-59,3269,3193,6462
31139,51019,60-64,3422,3373,6795
31140,51019,65+,9414,8626,18040
31141,51021,15-19,136,150,286
31142,51021,20-24,123,155,278
31143,51021,25-29,128,245,373
31144,51021,30-34,141,251,392
31145,51021,35-39,114,243,357
31146,51021,40-44,156,272,428
31147,51021,45-49,166,286,452
31148,51021,50-54,201,288,489
31149,51021,55-59,213,230,443
31150,51021,60-64,233,220,453
31151,51021,65+,777,732,1509
31152,51023,15-19,936,1032,1968
31153,51023,20-24,790,830,1620
31154,51023,25-29,776,814,1590
31155,51023,30-34,894,894,1788
31156,51023,35-39,899,1020,1919
31157,51023,40-44,937,919,1856
31158,51023,45-49,1040,1045,2085
31159,51023,50-54,1240,1260,2500
31160,51023,55-59,1435,1409,2844
31161,51023,60-64,1358,1386,2744
31162,51023,65+,4160,3718,7878
31163,51025,15-19,341,445,786
31164,51025,20-24,361,675,1036
31165,51025,25-29,382,836,1218
31166,51025,30-34,354,780,1134
31167,51025,35-39,385,578,963
31168,51025,40-44,399,571,970
31169,51025,45-49,392,509,901
31170,51025,50-54,479,508,987
31171,51025,55-59,596,571,1167
31172,51025,60-64,662,583,1245
31173,51025,65+,1899,1580,3479
31174,51027,15-19,502,496,998
31175,51027,20-24,454,497,951
31176,51027,25-29,459,637,1096
31177,51027,30-34,474,639,1113
31178,51027,35-39,512,574,1086
31179,51027,40-44,559,667,1226
31180,51027,45-49,591,656,1247
31181,51027,50-54,713,766,1479
31182,51027,55-59,756,756,1512
31183,51027,60-64,818,834,1652
31184,51027,65+,2546,2145,4691
31185,51029,15-19,364,412,776
31186,51029,20-24,339,553,892
31187,51029,25-29,396,698,1094
31188,51029,30-34,455,757,1212
31189,51029,35-39,424,712,1136
31190,51029,40-44,413,737,1150
31191,51029,45-49,427,680,1107
31192,51029,50-54,464,704,1168
31193,51029,55-59,590,657,1247
31194,51029,60-64,607,620,1227
31195,51029,65+,1834,1561,3395
31196,51031,15-19,1446,1528,2974
31197,51031,20-24,1502,1583,3085
31198,51031,25-29,1819,1740,3559
31199,51031,30-34,1834,1868,3702
31200,51031,35-39,1587,1698,3285
31201,51031,40-44,1588,1569,3157
31202,51031,45-49,1643,1599,3242
31203,51031,50-54,1889,1837,3726
31204,51031,55-59,2078,1950,4028
31205,51031,60-64,2102,2016,4118
31206,51031,65+,6322,5167,11489
31207,51033,15-19,851,863,1714
31208,51033,20-24,780,790,1570
31209,51033,25-29,1050,1012,2062
31210,51033,30-34,1105,1151,2256
31211,51033,35-39,1027,1145,2172
31212,51033,40-44,961,1004,1965
31213,51033,45-49,914,984,1898
31214,51033,50-54,1031,1048,2079
31215,51033,55-59,1083,1079,2162
31216,51033,60-64,1154,1055,2209
31217,51033,65+,2926,2396,5322
31218,51035,15-19,721,732,1453
31219,51035,20-24,640,739,1379
31220,51035,25-29,702,716,1418
31221,51035,30-34,779,748,1527
31222,51035,35-39,700,786,1486
31223,51035,40-44,739,768,1507
31224,51035,45-49,902,908,1810
31225,51035,50-54,1017,1095,2112
31226,51035,55-59,1175,1149,2324
31227,51035,60-64,1201,1181,2382
31228,51035,65+,3907,3564,7471
31229,51036,15-19,129,163,292
31230,51036,20-24,141,161,302
31231,51036,25-29,180,178,358
31232,51036,30-34,146,160,306
31233,51036,35-39,166,167,333
31234,51036,40-44,167,148,315
31235,51036,45-49,192,176,368
31236,51036,50-54,251,254,505
31237,51036,55-59,342,319,661
31238,51036,60-64,328,330,658
31239,51036,65+,939,801,1740
31240,51037,15-19,331,358,689
31241,51037,20-24,289,310,599
31242,51037,25-29,279,344,623
31243,51037,30-34,283,298,581
31244,51037,35-39,293,271,564
31245,51037,40-44,291,304,595
31246,51037,45-49,320,289,609
31247,51037,50-54,381,382,763
31248,51037,55-59,457,455,912
31249,51037,60-64,480,483,963
31250,51037,65+,1403,1160,2563
31251,51041,15-19,12812,13074,25886
31252,51041,20-24,10897,10544,21441
31253,51041,25-29,10894,10302,21196
31254,51041,30-34,12412,11239,23651
31255,51041,35-39,13414,12429,25843
31256,51041,40-44,13367,12422,25789
31257,51041,45-49,12276,11493,23769
31258,51041,50-54,12873,12012,24885
31259,51041,55-59,12851,11811,24662
31260,51041,60-64,12309,10971,23280
31261,51041,65+,32462,26043,58505
31262,51043,15-19,457,476,933
31263,51043,20-24,384,379,763
31264,51043,25-29,339,392,731
31265,51043,30-34,349,332,681
31266,51043,35-39,401,417,818
31267,51043,40-44,436,416,852
31268,51043,45-49,416,432,848
31269,51043,50-54,581,561,1142
31270,51043,55-59,604,666,1270
31271,51043,60-64,625,649,1274
31272,51043,65+,1726,1560,3286
31273,51045,15-19,116,133,249
31274,51045,20-24,117,123,240
31275,51045,25-29,135,133,268
31276,51045,30-34,122,148,270
31277,51045,35-39,104,123,227
31278,51045,40-44,130,119,249
31279,51045,45-49,152,157,309
31280,51045,50-54,178,187,365
31281,51045,55-59,199,222,421
31282,51045,60-64,211,215,426
31283,51045,65+,619,549,1168
31284,51047,15-19,1782,1817,3599
31285,51047,20-24,1426,1463,2889
31286,51047,25-29,1460,1538,2998
31287,51047,30-34,1607,1661,3268
31288,51047,35-39,1689,1815,3504
31289,51047,40-44,1712,1887,3599
31290,51047,45-49,1561,1670,3231
31291,51047,50-54,1642,1810,3452
31292,51047,55-59,1902,1925,3827
31293,51047,60-64,1771,1735,3506
31294,51047,65+,4660,4051,8711
31295,51049,15-19,246,271,517
31296,51049,20-24,262,240,502
31297,51049,25-29,285,274,559
31298,51049,30-34,308,254,562
31299,51049,35-39,230,270,500
31300,51049,40-44,284,241,525
31301,51049,45-49,263,236,499
31302,51049,50-54,355,328,683
31303,51049,55-59,381,408,789
31304,51049,60-64,387,368,755
31305,51049,65+,1213,1028,2241
31306,51051,15-19,354,410,764
31307,51051,20-24,302,340,642
31308,51051,25-29,335,389,724
31309,51051,30-34,362,413,775
31310,51051,35-39,382,421,803
31311,51051,40-44,432,495,927
31312,51051,45-49,408,473,881
31313,51051,50-54,412,490,902
31314,51051,55-59,459,507,966
31315,51051,60-64,512,513,1025
31316,51051,65+,1693,1546,3239
31317,51053,15-19,830,855,1685
31318,51053,20-24,652,742,1394
31319,51053,25-29,879,849,1728
31320,51053,30-34,934,936,1870
31321,51053,35-39,824,850,1674
31322,51053,40-44,840,769,1609
31323,51053,45-49,831,854,1685
31324,51053,50-54,1039,1031,2070
31325,51053,55-59,1160,1195,2355
31326,51053,60-64,1089,1050,2139
31327,51053,65+,2739,2346,5085
31328,51057,15-19,348,258,606
31329,51057,20-24,260,241,501
31330,51057,25-29,304,288,592
31331,51057,30-34,294,297,591
31332,51057,35-39,305,263,568
31333,51057,40-44,290,273,563
31334,51057,45-49,318,267,585
31335,51057,50-54,385,323,708
31336,51057,55-59,477,410,887
31337,51057,60-64,465,440,905
31338,51057,65+,1385,1168,2553
31339,51059,15-19,35754,38176,73930
31340,51059,20-24,33227,33796,67023
31341,51059,25-29,35456,37669,73125
31342,51059,30-34,36989,38443,75432
31343,51059,35-39,41470,42008,83478
31344,51059,40-44,41633,40865,82498
31345,51059,45-49,39734,38927,78661
31346,51059,50-54,39626,39346,78972
31347,51059,55-59,37944,37990,75934
31348,51059,60-64,34295,34178,68473
31349,51059,65+,88792,76552,165344
31350,51061,15-19,2396,2488,4884
31351,51061,20-24,1907,2083,3990
31352,51061,25-29,1900,1858,3758
31353,51061,30-34,2220,2188,4408
31354,51061,35-39,2334,2356,4690
31355,51061,40-44,2276,2309,4585
31356,51061,45-49,2253,2302,4555
31357,51061,50-54,2752,2609,5361
31358,51061,55-59,2960,2933,5893
31359,51061,60-64,2581,2647,5228
31360,51061,65+,6725,5896,12621
31361,51063,15-19,403,444,847
31362,51063,20-24,360,373,733
31363,51063,25-29,383,387,770
31364,51063,30-34,389,392,781
31365,51063,35-39,387,403,790
31366,51063,40-44,434,450,884
31367,51063,45-49,480,520,1000
31368,51063,50-54,548,582,1130
31369,51063,55-59,568,646,1214
31370,51063,60-64,674,573,1247
31371,51063,65+,1959,1823,3782
31372,51065,15-19,761,789,1550
31373,51065,20-24,778,635,1413
31374,51065,25-29,938,643,1581
31375,51065,30-34,1100,782,1882
31376,51065,35-39,985,807,1792
31377,51065,40-44,1017,807,1824
31378,51065,45-49,939,765,1704
31379,51065,50-54,989,870,1859
31380,51065,55-59,1038,904,1942
31381,51065,60-64,1115,983,2098
31382,51065,65+,3119,2623,5742
31383,51067,15-19,1586,1670,3256
31384,51067,20-24,1453,1450,2903
31385,51067,25-29,1372,1350,2722
31386,51067,30-34,1447,1369,2816
31387,51067,35-39,1370,1338,2708
31388,51067,40-44,1309,1359,2668
31389,51067,45-49,1538,1511,3049
31390,51067,50-54,1936,1909,3845
31391,51067,55-59,2263,2271,4534
31392,51067,60-64,2313,2321,4634
31393,51067,65+,7010,6459,13469
31394,51069,15-19,2804,3144,5948
31395,51069,20-24,2472,2610,5082
31396,51069,25-29,2627,2702,5329
31397,51069,30-34,2952,2943,5895
31398,51069,35-39,3038,3050,6088
31399,51069,40-44,2954,3035,5989
31400,51069,45-49,2698,2811,5509
31401,51069,50-54,3160,3244,6404
31402,51069,55-59,3362,3378,6740
31403,51069,60-64,3216,3061,6277
31404,51069,65+,9054,8012,17066
31405,51071,15-19,471,477,948
31406,51071,20-24,424,431,855
31407,51071,25-29,445,449,894
31408,51071,30-34,485,498,983
31409,51071,35-39,421,474,895
31410,51071,40-44,477,468,945
31411,51071,45-49,511,528,1039
31412,51071,50-54,608,597,1205
31413,51071,55-59,662,668,1330
31414,51071,60-64,565,591,1156
31415,51071,65+,1984,1681,3665
31416,51073,15-19,996,1110,2106
31417,51073,20-24,901,946,1847
31418,51073,25-29,1071,1102,2173
31419,51073,30-34,1249,1179,2428
31420,51073,35-39,1244,1289,2533
31421,51073,40-44,1124,1117,2241
31422,51073,45-49,1120,1088,2208
31423,51073,50-54,1292,1272,2564
31424,51073,55-59,1602,1582,3184
31425,51073,60-64,1743,1603,3346
31426,51073,65+,4264,3707,7971
31427,51075,15-19,631,669,1300
31428,51075,20-24,624,674,1298
31429,51075,25-29,642,703,1345
31430,51075,30-34,679,708,1387
31431,51075,35-39,665,679,1344
31432,51075,40-44,739,711,1450
31433,51075,45-49,806,755,1561
31434,51075,50-54,923,917,1840
31435,51075,55-59,1197,1063,2260
31436,51075,60-64,1220,1102,2322
31437,51075,65+,3095,2858,5953
31438,51077,15-19,344,357,701
31439,51077,20-24,341,462,803
31440,51077,25-29,336,483,819
31441,51077,30-34,346,506,852
31442,51077,35-39,359,463,822
31443,51077,40-44,349,485,834
31444,51077,45-49,459,552,1011
31445,51077,50-54,485,592,1077
31446,51077,55-59,610,581,1191
31447,51077,60-64,628,646,1274
31448,51077,65+,2095,1850,3945
31449,51079,15-19,619,741,1360
31450,51079,20-24,462,542,1004
31451,51079,25-29,590,594,1184
31452,51079,30-34,725,667,1392
31453,51079,35-39,668,677,1345
31454,51079,40-44,655,662,1317
31455,51079,45-49,586,588,1174
31456,51079,50-54,671,683,1354
31457,51079,55-59,795,746,1541
31458,51079,60-64,705,712,1417
31459,51079,65+,2091,1745,3836
31460,51081,15-19,271,288,559
31461,51081,20-24,217,562,779
31462,51081,25-29,209,649,858
31463,51081,30-34,255,747,1002
31464,51081,35-39,204,655,859
31465,51081,40-44,217,701,918
31466,51081,45-49,233,651,884
31467,51081,50-54,295,560,855
31468,51081,55-59,290,504,794
31469,51081,60-64,318,369,687
31470,51081,65+,965,829,1794
31471,51083,15-19,987,952,1939
31472,51083,20-24,842,887,1729
31473,51083,25-29,932,962,1894
31474,51083,30-34,859,849,1708
31475,51083,35-39,894,862,1756
31476,51083,40-44,866,807,1673
31477,51083,45-49,870,871,1741
31478,51083,50-54,1133,1030,2163
31479,51083,55-59,1217,1123,2340
31480,51083,60-64,1324,1283,2607
31481,51083,65+,4804,3739,8543
31482,51085,15-19,3680,3882,7562
31483,51085,20-24,3087,3390,6477
31484,51085,25-29,2669,2834,5503
31485,51085,30-34,3182,3084,6266
31486,51085,35-39,3633,3553,7186
31487,51085,40-44,3481,3447,6928
31488,51085,45-49,3520,3445,6965
31489,51085,50-54,4038,3891,7929
31490,51085,55-59,4422,4075,8497
31491,51085,60-64,4148,4004,8152
31492,51085,65+,11358,9477,20835
31493,51087,15-19,9812,10605,20417
31494,51087,20-24,9160,9123,18283
31495,51087,25-29,11477,10913,22390
31496,51087,30-34,12904,11761,24665
31497,51087,35-39,12299,11663,23962
31498,51087,40-44,11670,10888,22558
31499,51087,45-49,10796,9736,20532
31500,51087,50-54,11549,10620,22169
31501,51087,55-59,11629,10261,21890
31502,51087,60-64,11385,9594,20979
31503,51087,65+,32037,22886,54923
31504,51089,15-19,1369,1439,2808
31505,51089,20-24,1230,1288,2518
31506,51089,25-29,1231,1284,2515
31507,51089,30-34,1427,1303,2730
31508,51089,35-39,1360,1220,2580
31509,51089,40-44,1314,1283,2597
31510,51089,45-49,1422,1443,2865
31511,51089,50-54,1800,1689,3489
31512,51089,55-59,2061,1943,4004
31513,51089,60-64,2046,1967,4013
31514,51089,65+,6801,5509,12310
31515,51091,15-19,39,26,65
31516,51091,20-24,36,40,76
31517,51091,25-29,52,37,89
31518,51091,30-34,64,55,119
31519,51091,35-39,39,35,74
31520,51091,40-44,46,56,102
31521,51091,45-49,45,47,92
31522,51091,50-54,50,62,112
31523,51091,55-59,80,88,168
31524,51091,60-64,145,129,274
31525,51091,65+,407,398,805
31526,51093,15-19,1152,1118,2270
31527,51093,20-24,942,972,1914
31528,51093,25-29,972,997,1969
31529,51093,30-34,1236,1136,2372
31530,51093,35-39,1251,1242,2493
31531,51093,40-44,1171,1269,2440
31532,51093,45-49,1135,1055,2190
31533,51093,50-54,1350,1289,2639
31534,51093,55-59,1642,1622,3264
31535,51093,60-64,1559,1559,3118
31536,51093,65+,4213,3554,7767
31537,51095,15-19,2205,2339,4544
31538,51095,20-24,1890,1972,3862
31539,51095,25-29,1820,1977,3797
31540,51095,30-34,2103,1963,4066
31541,51095,35-39,2378,2321,4699
31542,51095,40-44,2319,2236,4555
31543,51095,45-49,2303,2118,4421
31544,51095,50-54,2501,2428,4929
31545,51095,55-59,2901,2614,5515
31546,51095,60-64,3071,2719,5790
31547,51095,65+,11429,9631,21060
31548,51097,15-19,177,155,332
31549,51097,20-24,142,206,348
31550,51097,25-29,147,172,319
31551,51097,30-34,173,184,357
31552,51097,35-39,157,194,351
31553,51097,40-44,175,211,386
31554,51097,45-49,178,181,359
31555,51097,50-54,249,246,495
31556,51097,55-59,282,312,594
31557,51097,60-64,289,310,599
31558,51097,65+,827,733,1560
31559,51099,15-19,865,938,1803
31560,51099,20-24,756,898,1654
31561,51099,25-29,772,873,1645
31562,51099,30-34,911,955,1866
31563,51099,35-39,964,949,1913
31564,51099,40-44,920,945,1865
31565,51099,45-49,844,908,1752
31566,51099,50-54,896,943,1839
31567,51099,55-59,1020,971,1991
31568,51099,60-64,899,865,1764
31569,51099,65+,1956,1883,3839
31570,51101,15-19,527,599,1126
31571,51101,20-24,457,454,911
31572,51101,25-29,611,552,1163
31573,51101,30-34,643,595,1238
31574,51101,35-39,620,655,1275
31575,51101,40-44,564,550,1114
31576,51101,45-49,529,523,1052
31577,51101,50-54,594,609,1203
31578,51101,55-59,731,682,1413
31579,51101,60-64,629,620,1249
31580,51101,65+,1665,1371,3036
31581,51103,15-19,226,273,499
31582,51103,20-24,193,212,405
31583,51103,25-29,205,212,417
31584,51103,30-34,234,240,474
31585,51103,35-39,226,222,448
31586,51103,40-44,231,190,421
31587,51103,45-49,234,203,437
31588,51103,50-54,290,262,552
31589,51103,55-59,420,382,802
31590,51103,60-64,574,504,1078
31591,51103,65+,2195,1819,4014
31592,51105,15-19,527,616,1143
31593,51105,20-24,497,570,1067
31594,51105,25-29,520,779,1299
31595,51105,30-34,563,939,1502
31596,51105,35-39,510,718,1228
31597,51105,40-44,592,724,1316
31598,51105,45-49,666,777,1443
31599,51105,50-54,756,748,1504
31600,51105,55-59,780,706,1486
31601,51105,60-64,823,820,1643
31602,51105,65+,2612,2415,5027
31603,51107,15-19,15407,16075,31482
31604,51107,20-24,11221,11539,22760
31605,51107,25-29,10579,10557,21136
31606,51107,30-34,13612,12612,26224
31607,51107,35-39,18086,17241,35327
31608,51107,40-44,18710,18673,37383
31609,51107,45-49,16977,18027,35004
31610,51107,50-54,15650,16697,32347
31611,51107,55-59,13131,14103,27234
31612,51107,60-64,10053,10379,20432
31613,51107,65+,23642,19801,43443
31614,51109,15-19,976,1021,1997
31615,51109,20-24,861,933,1794
31616,51109,25-29,1149,1147,2296
31617,51109,30-34,1231,1162,2393
31618,51109,35-39,1195,1229,2424
31619,51109,40-44,1096,1164,2260
31620,51109,45-49,1039,1091,2130
31621,51109,50-54,1287,1325,2612
31622,51109,55-59,1658,1539,3197
31623,51109,60-64,1702,1645,3347
31624,51109,65+,4122,3890,8012
31625,51111,15-19,309,334,643
31626,51111,20-24,232,310,542
31627,51111,25-29,259,359,618
31628,51111,30-34,319,435,754
31629,51111,35-39,286,443,729
31630,51111,40-44,303,489,792
31631,51111,45-49,314,458,772
31632,51111,50-54,307,391,698
31633,51111,55-59,389,444,833
31634,51111,60-64,430,454,884
31635,51111,65+,1500,1251,2751
31636,51113,15-19,392,381,773
31637,51113,20-24,378,324,702
31638,51113,25-29,329,361,690
31639,51113,30-34,429,376,805
31640,51113,35-39,385,377,762
31641,51113,40-44,387,370,757
31642,51113,45-49,380,368,748
31643,51113,50-54,439,451,890
31644,51113,55-59,560,545,1105
31645,51113,60-64,634,582,1216
31646,51113,65+,1722,1499,3221
31647,51115,15-19,195,178,373
31648,51115,20-24,191,205,396
31649,51115,25-29,174,191,365
31650,51115,30-34,191,178,369
31651,51115,35-39,180,197,377
31652,51115,40-44,180,177,357
31653,51115,45-49,223,239,462
31654,51115,50-54,283,266,549
31655,51115,55-59,378,355,733
31656,51115,60-64,392,368,760
31657,51115,65+,1443,1257,2700
31658,51117,15-19,756,791,1547
31659,51117,20-24,722,793,1515
31660,51117,25-29,747,785,1532
31661,51117,30-34,761,807,1568
31662,51117,35-39,739,779,1518
31663,51117,40-44,748,797,1545
31664,51117,45-49,865,763,1628
31665,51117,50-54,947,894,1841
31666,51117,55-59,1221,1172,2393
31667,51117,60-64,1332,1201,2533
31668,51117,65+,4424,3613,8037
31669,51119,15-19,219,231,450
31670,51119,20-24,196,234,430
31671,51119,25-29,239,264,503
31672,51119,30-34,234,254,488
31673,51119,35-39,242,259,501
31674,51119,40-44,218,225,443
31675,51119,45-49,230,246,476
31676,51119,50-54,325,305,630
31677,51119,55-59,453,426,879
31678,51119,60-64,555,506,1061
31679,51119,65+,1870,1646,3516
31680,51121,15-19,5012,5941,10953
31681,51121,20-24,7683,10207,17890
31682,51121,25-29,3117,3551,6668
31683,51121,30-34,2926,3128,6054
31684,51121,35-39,2668,2799,5467
31685,51121,40-44,2355,2608,4963
31686,51121,45-49,2503,2597,5100
31687,51121,50-54,2493,2642,5135
31688,51121,55-59,2562,2525,5087
31689,51121,60-64,2554,2285,4839
31690,51121,65+,7521,6225,13746
31691,51125,15-19,348,401,749
31692,51125,20-24,330,331,661
31693,51125,25-29,317,328,645
31694,51125,30-34,376,344,720
31695,51125,35-39,366,367,733
31696,51125,40-44,415,378,793
31697,51125,45-49,392,390,782
31698,51125,50-54,454,481,935
31699,51125,55-59,603,528,1131
31700,51125,60-64,663,643,1306
31701,51125,65+,2244,2015,4259
31702,51127,15-19,597,670,1267
31703,51127,20-24,486,682,1168
31704,51127,25-29,717,876,1593
31705,51127,30-34,769,886,1655
31706,51127,35-39,781,868,1649
31707,51127,40-44,722,761,1483
31708,51127,45-49,756,806,1562
31709,51127,50-54,823,894,1717
31710,51127,55-59,941,910,1851
31711,51127,60-64,929,919,1848
31712,51127,65+,2228,2080,4308
31713,51131,15-19,333,315,648
31714,51131,20-24,240,266,506
31715,51131,25-29,270,264,534
31716,51131,30-34,314,296,610
31717,51131,35-39,307,283,590
31718,51131,40-44,289,252,541
31719,51131,45-49,279,263,542
31720,51131,50-54,350,337,687
31721,51131,55-59,522,387,909
31722,51131,60-64,632,555,1187
31723,51131,65+,1936,1545,3481
31724,51133,15-19,213,281,494
31725,51133,20-24,239,244,483
31726,51133,25-29,230,231,461
31727,51133,30-34,267,235,502
31728,51133,35-39,238,234,472
31729,51133,40-44,229,249,478
31730,51133,45-49,233,208,441
31731,51133,50-54,336,297,633
31732,51133,55-59,533,442,975
31733,51133,60-64,631,621,1252
31734,51133,65+,2262,2134,4396
31735,51135,15-19,382,429,811
31736,51135,20-24,377,589,966
31737,51135,25-29,370,721,1091
31738,51135,30-34,392,717,1109
31739,51135,35-39,415,609,1024
31740,51135,40-44,405,602,1007
31741,51135,45-49,354,613,967
31742,51135,50-54,408,607,1015
31743,51135,55-59,515,607,1122
31744,51135,60-64,535,540,1075
31745,51135,65+,1651,1319,2970
31746,51137,15-19,984,1010,1994
31747,51137,20-24,971,1018,1989
31748,51137,25-29,1089,1190,2279
31749,51137,30-34,1116,1132,2248
31750,51137,35-39,1144,1156,2300
31751,51137,40-44,1082,1078,2160
31752,51137,45-49,1087,1038,2125
31753,51137,50-54,1247,1233,2480
31754,51137,55-59,1428,1374,2802
31755,51137,60-64,1385,1354,2739
31756,51137,65+,4171,3386,7557
31757,51139,15-19,665,685,1350
31758,51139,20-24,557,589,1146
31759,51139,25-29,676,658,1334
31760,51139,30-34,693,683,1376
31761,51139,35-39,642,703,1345
31762,51139,40-44,711,670,1381
31763,51139,45-49,683,720,1403
31764,51139,50-54,796,877,1673
31765,51139,55-59,960,971,1931
31766,51139,60-64,919,872,1791
31767,51139,65+,2764,2431,5195
31768,51141,15-19,418,490,908
31769,51141,20-24,391,393,784
31770,51141,25-29,353,432,785
31771,51141,30-34,370,407,777
31772,51141,35-39,409,435,844
31773,51141,40-44,450,442,892
31774,51141,45-49,544,571,1115
31775,51141,50-54,610,690,1300
31776,51141,55-59,739,692,1431
31777,51141,60-64,785,773,1558
31778,51141,65+,2514,2250,4764
31779,51143,15-19,1633,1746,3379
31780,51143,20-24,1468,1707,3175
31781,51143,25-29,1460,1579,3039
31782,51143,30-34,1460,1637,3097
31783,51143,35-39,1595,1635,3230
31784,51143,40-44,1603,1629,3232
31785,51143,45-49,1742,1891,3633
31786,51143,50-54,2032,2143,4175
31787,51143,55-59,2500,2382,4882
31788,51143,60-64,2509,2429,4938
31789,51143,65+,7810,6639,14449
31790,51145,15-19,721,912,1633
31791,51145,20-24,625,865,1490
31792,51145,25-29,726,935,1661
31793,51145,30-34,811,944,1755
31794,51145,35-39,920,1064,1984
31795,51145,40-44,984,1126,2110
31796,51145,45-49,1036,1142,2178
31797,51145,50-54,1214,1329,2543
31798,51145,55-59,1298,1403,2701
31799,51145,60-64,1248,1195,2443
31800,51145,65+,3098,2923,6021
31801,51147,15-19,1327,1167,2494
31802,51147,20-24,1553,2123,3676
31803,51147,25-29,564,749,1313
31804,51147,30-34,561,639,1200
31805,51147,35-39,487,537,1024
31806,51147,40-44,477,526,1003
31807,51147,45-49,483,494,977
31808,51147,50-54,575,510,1085
31809,51147,55-59,645,616,1261
31810,51147,60-64,689,609,1298
31811,51147,65+,2080,1606,3686
31812,51149,15-19,1236,1413,2649
31813,51149,20-24,1071,1443,2514
31814,51149,25-29,1175,1727,2902
31815,51149,30-34,1513,2031,3544
31816,51149,35-39,1463,2158,3621
31817,51149,40-44,1226,1845,3071
31818,51149,45-49,1076,1363,2439
31819,51149,50-54,1145,1369,2514
31820,51149,55-59,1311,1415,2726
31821,51149,60-64,1245,1248,2493
31822,51149,65+,3391,3033,6424
31823,51153,15-19,16773,18063,34836
31824,51153,20-24,14590,16177,30767
31825,51153,25-29,15176,15287,30463
31826,51153,30-34,16274,15930,32204
31827,51153,35-39,17987,18100,36087
31828,51153,40-44,18310,18658,36968
31829,51153,45-49,16957,17112,34069
31830,51153,50-54,16611,17009,33620
31831,51153,55-59,15411,16000,31411
31832,51153,60-64,12583,12811,25394
31833,51153,65+,28532,23923,52455
31834,51155,15-19,773,870,1643
31835,51155,20-24,826,955,1781
31836,51155,25-29,918,1168,2086
31837,51155,30-34,925,1070,1995
31838,51155,35-39,846,969,1815
31839,51155,40-44,843,948,1791
31840,51155,45-49,1024,1120,2144
31841,51155,50-54,1292,1309,2601
31842,51155,55-59,1238,1343,2581
31843,51155,60-64,1302,1273,2575
31844,51155,65+,4263,3550,7813
31845,51157,15-19,170,172,342
31846,51157,20-24,154,194,348
31847,51157,25-29,176,171,347
31848,51157,30-34,171,193,364
31849,51157,35-39,193,187,380
31850,51157,40-44,175,168,343
31851,51157,45-49,182,201,383
31852,51157,50-54,241,257,498
31853,51157,55-59,332,294,626
31854,51157,60-64,358,333,691
31855,51157,65+,1077,1007,2084
31856,51159,15-19,202,236,438
31857,51159,20-24,183,273,456
31858,51159,25-29,195,441,636
31859,51159,30-34,206,481,687
31860,51159,35-39,215,489,704
31861,51159,40-44,185,419,604
31862,51159,45-49,190,414,604
31863,51159,50-54,214,323,537
31864,51159,55-59,268,331,599
31865,51159,60-64,294,320,614
31866,51159,65+,1106,789,1895
31867,51161,15-19,2875,2866,5741
31868,51161,20-24,2621,2627,5248
31869,51161,25-29,2726,2723,5449
31870,51161,30-34,2879,2809,5688
31871,51161,35-39,3012,2941,5953
31872,51161,40-44,2879,2920,5799
31873,51161,45-49,2991,2996,5987
31874,51161,50-54,3332,3260,6592
31875,51161,55-59,3495,3270,6765
31876,51161,60-64,3461,3230,6691
31877,51161,65+,12143,9218,21361
31878,51163,15-19,662,690,1352
31879,51163,20-24,549,552,1101
31880,51163,25-29,538,545,1083
31881,51163,30-34,604,626,1230
31882,51163,35-39,560,602,1162
31883,51163,40-44,575,568,1143
31884,51163,45-49,591,632,1223
31885,51163,50-54,765,703,1468
31886,51163,55-59,868,839,1707
31887,51163,60-64,955,930,1885
31888,51163,65+,3155,2976,6131
31889,51165,15-19,2826,2810,5636
31890,51165,20-24,2565,2507,5072
31891,51165,25-29,2422,2432,4854
31892,51165,30-34,2510,2483,4993
31893,51165,35-39,2513,2564,5077
31894,51165,40-44,2494,2566,5060
31895,51165,45-49,2346,2407,4753
31896,51165,50-54,2675,2674,5349
31897,51165,55-59,2883,2915,5798
31898,51165,60-64,2940,2821,5761
31899,51165,65+,8963,7741,16704
31900,51167,15-19,665,665,1330
31901,51167,20-24,631,663,1294
31902,51167,25-29,652,715,1367
31903,51167,30-34,702,696,1398
31904,51167,35-39,652,710,1362
31905,51167,40-44,764,779,1543
31906,51167,45-49,825,813,1638
31907,51167,50-54,884,881,1765
31908,51167,55-59,979,900,1879
31909,51167,60-64,1058,1049,2107
31910,51167,65+,3172,2705,5877
31911,51169,15-19,529,596,1125
31912,51169,20-24,498,554,1052
31913,51169,25-29,499,611,1110
31914,51169,30-34,540,629,1169
31915,51169,35-39,577,586,1163
31916,51169,40-44,609,693,1302
31917,51169,45-49,632,676,1308
31918,51169,50-54,726,757,1483
31919,51169,55-59,792,835,1627
31920,51169,60-64,810,837,1647
31921,51169,65+,2820,2525,5345
31922,51171,15-19,1220,1305,2525
31923,51171,20-24,1178,1086,2264
31924,51171,25-29,1269,1283,2552
31925,51171,30-34,1283,1380,2663
31926,51171,35-39,1272,1298,2570
31927,51171,40-44,1243,1279,2522
31928,51171,45-49,1222,1260,2482
31929,51171,50-54,1511,1502,3013
31930,51171,55-59,1617,1634,3251
31931,51171,60-64,1668,1589,3257
31932,51171,65+,5263,4573,9836
31933,51173,15-19,848,873,1721
31934,51173,20-24,801,811,1612
31935,51173,25-29,808,890,1698
31936,51173,30-34,815,913,1728
31937,51173,35-39,737,780,1517
31938,51173,40-44,825,873,1698
31939,51173,45-49,951,944,1895
31940,51173,50-54,1110,1041,2151
31941,51173,55-59,1048,1107,2155
31942,51173,60-64,1073,1009,2082
31943,51173,65+,3729,2955,6684
31944,51175,15-19,464,518,982
31945,51175,20-24,389,427,816
31946,51175,25-29,462,514,976
31947,51175,30-34,506,518,1024
31948,51175,35-39,495,497,992
31949,51175,40-44,479,507,986
31950,51175,45-49,484,729,1213
31951,51175,50-54,595,837,1432
31952,51175,55-59,686,819,1505
31953,51175,60-64,674,828,1502
31954,51175,65+,2016,1843,3859
31955,51177,15-19,4761,5022,9783
31956,51177,20-24,4108,4399,8507
31957,51177,25-29,4480,4572,9052
31958,51177,30-34,4734,4696,9430
31959,51177,35-39,4840,4762,9602
31960,51177,40-44,4688,4684,9372
31961,51177,45-49,4531,4393,8924
31962,51177,50-54,5040,4843,9883
31963,51177,55-59,5085,5026,10111
31964,51177,60-64,4588,4354,8942
31965,51177,65+,11776,9738,21514
31966,51179,15-19,5786,6101,11887
31967,51179,20-24,4877,6301,11178
31968,51179,25-29,4661,5646,10307
31969,51179,30-34,5185,5451,10636
31970,51179,35-39,6106,6065,12171
31971,51179,40-44,5826,5869,11695
31972,51179,45-49,5335,5595,10930
31973,51179,50-54,5508,5533,11041
31974,51179,55-59,5458,5512,10970
31975,51179,60-64,4289,4269,8558
31976,51179,65+,9443,8085,17528
31977,51181,15-19,132,167,299
31978,51181,20-24,160,145,305
31979,51181,25-29,167,190,357
31980,51181,30-34,170,210,380
31981,51181,35-39,151,151,302
31982,51181,40-44,166,159,325
31983,51181,45-49,157,156,313
31984,51181,50-54,221,222,443
31985,51181,55-59,315,328,643
31986,51181,60-64,320,319,639
31987,51181,65+,856,768,1624
31988,51183,15-19,221,227,448
31989,51183,20-24,209,580,789
31990,51183,25-29,236,805,1041
31991,51183,30-34,236,706,942
31992,51183,35-39,230,578,808
31993,51183,40-44,208,459,667
31994,51183,45-49,235,412,647
31995,51183,50-54,288,405,693
31996,51183,55-59,347,395,742
31997,51183,60-64,323,369,692
31998,51183,65+,1075,876,1951
31999,51185,15-19,1145,1165,2310
32000,51185,20-24,982,1127,2109
32001,51185,25-29,1010,1227,2237
32002,51185,30-34,977,1231,2208
32003,51185,35-39,1012,1228,2240
32004,51185,40-44,1144,1314,2458
32005,51185,45-49,1216,1352,2568
32006,51185,50-54,1268,1284,2552
32007,51185,55-59,1404,1302,2706
32008,51185,60-64,1516,1412,2928
32009,51185,65+,5137,4202,9339
32010,51187,15-19,1234,1288,2522
32011,51187,20-24,1133,1150,2283
32012,51187,25-29,1266,1250,2516
32013,51187,30-34,1422,1390,2812
32014,51187,35-39,1226,1344,2570
32015,51187,40-44,1185,1263,2448
32016,51187,45-49,1162,1181,2343
32017,51187,50-54,1339,1399,2738
32018,51187,55-59,1578,1672,3250
32019,51187,60-64,1510,1518,3028
32020,51187,65+,3694,3283,6977
32021,51191,15-19,1515,1632,3147
32022,51191,20-24,1465,1529,2994
32023,51191,25-29,1304,1405,2709
32024,51191,30-34,1367,1470,2837
32025,51191,35-39,1426,1493,2919
32026,51191,40-44,1558,1524,3082
32027,51191,45-49,1670,1701,3371
32028,51191,50-54,1816,1816,3632
32029,51191,55-59,1996,1978,3974
32030,51191,60-64,2226,2006,4232
32031,51191,65+,7008,6034,13042
32032,51193,15-19,454,473,927
32033,51193,20-24,419,389,808
32034,51193,25-29,514,519,1033
32035,51193,30-34,536,557,1093
32036,51193,35-39,495,526,1021
32037,51193,40-44,443,450,893
32038,51193,45-49,503,451,954
32039,51193,50-54,553,569,1122
32040,51193,55-59,765,650,1415
32041,51193,60-64,814,809,1623
32042,51193,65+,2608,2338,4946
32043,51195,15-19,1043,1117,2160
32044,51195,20-24,931,1385,2316
32045,51195,25-29,922,1427,2349
32046,51195,30-34,1011,1443,2454
32047,51195,35-39,948,1202,2150
32048,51195,40-44,981,1218,2199
32049,51195,45-49,1090,1243,2333
32050,51195,50-54,1161,1270,2431
32051,51195,55-59,1068,1162,2230
32052,51195,60-64,1294,1151,2445
32053,51195,65+,3696,3194,6890
32054,51197,15-19,752,838,1590
32055,51197,20-24,652,670,1322
32056,51197,25-29,772,792,1564
32057,51197,30-34,801,795,1596
32058,51197,35-39,811,825,1636
32059,51197,40-44,818,801,1619
32060,51197,45-49,915,927,1842
32061,51197,50-54,1061,1032,2093
32062,51197,55-59,1099,1082,2181
32063,51197,60-64,1077,965,2042
32064,51197,65+,3416,2849,6265
32065,51199,15-19,2323,2422,4745
32066,51199,20-24,1880,2310,4190
32067,51199,25-29,1860,1978,3838
32068,51199,30-34,2231,2140,4371
32069,51199,35-39,2618,2592,5210
32070,51199,40-44,2484,2469,4953
32071,51199,45-49,2060,1982,4042
32072,51199,50-54,2216,2104,4320
32073,51199,55-59,2535,2374,4909
32074,51199,60-64,2392,2264,4656
32075,51199,65+,6561,5579,12140
32076,51510,15-19,2897,2954,5851
32077,51510,20-24,3778,3060,6838
32078,51510,25-29,7377,6353,13730
32079,51510,30-34,8619,8255,16874
32080,51510,35-39,8120,8086,16206
32081,51510,40-44,6373,6435,12808
32082,51510,45-49,5237,5407,10644
32083,51510,50-54,5243,4955,10198
32084,51510,55-59,4702,4573,9275
32085,51510,60-64,4207,3911,8118
32086,51510,65+,11121,8521,19642
32087,51520,15-19,445,494,939
32088,51520,20-24,408,424,832
32089,51520,25-29,529,555,1084
32090,51520,30-34,564,577,1141
32091,51520,35-39,527,507,1034
32092,51520,40-44,532,460,992
32093,51520,45-49,504,505,1009
32094,51520,50-54,588,545,1133
32095,51520,55-59,592,557,1149
32096,51520,60-64,591,564,1155
32097,51520,65+,2250,1503,3753
32098,51530,15-19,325,252,577
32099,51530,20-24,328,313,641
32100,51530,25-29,233,227,460
32101,51530,30-34,181,192,373
32102,51530,35-39,136,178,314
32103,51530,40-44,173,173,346
32104,51530,45-49,160,136,296
32105,51530,50-54,203,189,392
32106,51530,55-59,193,210,403
32107,51530,60-64,205,172,377
32108,51530,65+,737,528,1265
32109,51540,15-19,1179,1085,2264
32110,51540,20-24,3779,3467,7246
32111,51540,25-29,2202,2132,4334
32112,51540,30-34,2018,2050,4068
32113,51540,35-39,1660,1608,3268
32114,51540,40-44,1446,1390,2836
32115,51540,45-49,1114,1124,2238
32116,51540,50-54,1218,1094,2312
32117,51540,55-59,1240,1147,2387
32118,51540,60-64,1210,1118,2328
32119,51540,65+,3419,2651,6070
32120,51550,15-19,7998,8720,16718
32121,51550,20-24,7008,7514,14522
32122,51550,25-29,7941,8316,16257
32123,51550,30-34,9310,9120,18430
32124,51550,35-39,9834,9694,19528
32125,51550,40-44,8905,8849,17754
32126,51550,45-49,7733,7368,15101
32127,51550,50-54,7817,7478,15295
32128,51550,55-59,8564,7910,16474
32129,51550,60-64,8255,7688,15943
32130,51550,65+,19901,15281,35182
32131,51570,15-19,582,559,1141
32132,51570,20-24,496,481,977
32133,51570,25-29,582,603,1185
32134,51570,30-34,636,616,1252
32135,51570,35-39,621,476,1097
32136,51570,40-44,556,481,1037
32137,51570,45-49,552,485,1037
32138,51570,50-54,640,468,1108
32139,51570,55-59,594,585,1179
32140,51570,60-64,653,551,1204
32141,51570,65+,2054,1384,3438
32142,51580,15-19,148,179,327
32143,51580,20-24,168,156,324
32144,51580,25-29,180,186,366
32145,51580,30-34,171,195,366
32146,51580,35-39,157,158,315
32147,51580,40-44,165,136,301
32148,51580,45-49,158,158,316
32149,51580,50-54,179,198,377
32150,51580,55-59,214,193,407
32151,51580,60-64,204,213,417
32152,51580,65+,645,479,1124
32153,51590,15-19,1295,1409,2704
32154,51590,20-24,1338,1341,2679
32155,51590,25-29,1329,1140,2469
32156,51590,30-34,1425,1303,2728
32157,51590,35-39,1203,1116,2319
32158,51590,40-44,1233,985,2218
32159,51590,45-49,1129,977,2106
32160,51590,50-54,1329,1118,2447
32161,51590,55-59,1592,1254,2846
32162,51590,60-64,1716,1394,3110
32163,51590,65+,5347,3483,8830
32164,51595,15-19,170,179,349
32165,51595,20-24,161,144,305
32166,51595,25-29,179,134,313
32167,51595,30-34,200,175,375
32168,51595,35-39,168,127,295
32169,51595,40-44,171,111,282
32170,51595,45-49,176,140,316
32171,51595,50-54,176,171,347
32172,51595,55-59,215,170,385
32173,51595,60-64,198,163,361
32174,51595,65+,657,481,1138
32175,51600,15-19,663,686,1349
32176,51600,20-24,821,758,1579
32177,51600,25-29,811,875,1686
32178,51600,30-34,858,930,1788
32179,51600,35-39,814,846,1660
32180,51600,40-44,798,764,1562
32181,51600,45-49,720,715,1435
32182,51600,50-54,757,788,1545
32183,51600,55-59,857,788,1645
32184,51600,60-64,765,740,1505
32185,51600,65+,2074,1556,3630
32186,51610,15-19,467,540,1007
32187,51610,20-24,385,357,742
32188,51610,25-29,465,490,955
32189,51610,30-34,356,440,796
32190,51610,35-39,504,434,938
32191,51610,40-44,577,514,1091
32192,51610,45-49,559,572,1131
32193,51610,50-54,529,538,1067
32194,51610,55-59,459,456,915
32195,51610,60-64,430,466,896
32196,51610,65+,1183,904,2087
32197,51620,15-19,254,289,543
32198,51620,20-24,215,209,424
32199,51620,25-29,256,210,466
32200,51620,30-34,269,239,508
32201,51620,35-39,259,186,445
32202,51620,40-44,223,175,398
32203,51620,45-49,205,185,390
32204,51620,50-54,277,186,463
32205,51620,55-59,299,213,512
32206,51620,60-64,363,280,643
32207,51620,65+,958,644,1602
32208,51630,15-19,1479,1032,2511
32209,51630,20-24,2207,1547,3754
32210,51630,25-29,1258,1180,2438
32211,51630,30-34,1108,1066,2174
32212,51630,35-39,811,852,1663
32213,51630,40-44,802,753,1555
32214,51630,45-49,770,658,1428
32215,51630,50-54,808,748,1556
32216,51630,55-59,772,746,1518
32217,51630,60-64,737,602,1339
32218,51630,65+,1923,1377,3300
32219,51640,15-19,206,221,427
32220,51640,20-24,208,184,392
32221,51640,25-29,210,209,419
32222,51640,30-34,212,167,379
32223,51640,35-39,164,180,344
32224,51640,40-44,214,172,386
32225,51640,45-49,211,217,428
32226,51640,50-54,229,212,441
32227,51640,55-59,217,212,429
32228,51640,60-64,243,184,427
32229,51640,65+,756,454,1210
32230,51650,15-19,4609,4541,9150
32231,51650,20-24,5432,6011,11443
32232,51650,25-29,5395,5751,11146
32233,51650,30-34,5235,5110,10345
32234,51650,35-39,4686,4356,9042
32235,51650,40-44,4157,3681,7838
32236,51650,45-49,3478,3009,6487
32237,51650,50-54,3934,3340,7274
32238,51650,55-59,4754,4185,8939
32239,51650,60-64,4929,4358,9287
32240,51650,65+,12667,9461,22128
32241,51660,15-19,4400,2973,7373
32242,51660,20-24,5530,5034,10564
32243,51660,25-29,1674,1747,3421
32244,51660,30-34,1504,1649,3153
32245,51660,35-39,1546,1577,3123
32246,51660,40-44,1322,1482,2804
32247,51660,45-49,1074,1251,2325
32248,51660,50-54,1058,1161,2219
32249,51660,55-59,1090,1008,2098
32250,51660,60-64,979,946,1925
32251,51660,65+,2852,2278,5130
32252,51670,15-19,736,756,1492
32253,51670,20-24,666,658,1324
32254,51670,25-29,919,809,1728
32255,51670,30-34,901,772,1673
32256,51670,35-39,789,714,1503
32257,51670,40-44,708,560,1268
32258,51670,45-49,657,594,1251
32259,51670,50-54,748,642,1390
32260,51670,55-59,802,665,1467
32261,51670,60-64,800,631,1431
32262,51670,65+,2143,1422,3565
32263,51678,15-19,546,946,1492
32264,51678,20-24,582,1376,1958
32265,51678,25-29,156,172,328
32266,51678,30-34,135,126,261
32267,51678,35-39,148,121,269
32268,51678,40-44,117,133,250
32269,51678,45-49,127,118,245
32270,51678,50-54,120,127,247
32271,51678,55-59,133,125,258
32272,51678,60-64,162,133,295
32273,51678,65+,630,441,1071
32274,51680,15-19,4644,3876,8520
32275,51680,20-24,7106,6332,13438
32276,51680,25-29,3308,3335,6643
32277,51680,30-34,2470,2487,4957
32278,51680,35-39,1988,1886,3874
32279,51680,40-44,1832,1646,3478
32280,51680,45-49,1635,1536,3171
32281,51680,50-54,1860,1576,3436
32282,51680,55-59,2013,1826,3839
32283,51680,60-64,2069,1734,3803
32284,51680,65+,6627,4678,11305
32285,51683,15-19,1330,1412,2742
32286,51683,20-24,1332,1406,2738
32287,51683,25-29,1619,1597,3216
32288,51683,30-34,1508,1628,3136
32289,51683,35-39,1424,1613,3037
32290,51683,40-44,1449,1638,3087
32291,51683,45-49,1310,1438,2748
32292,51683,50-54,1289,1424,2713
32293,51683,55-59,1442,1311,2753
32294,51683,60-64,1265,1199,2464
32295,51683,65+,2561,2147,4708
32296,51685,15-19,539,559,1098
32297,51685,20-24,551,619,1170
32298,51685,25-29,659,670,1329
32299,51685,30-34,629,746,1375
32300,51685,35-39,671,708,1379
32301,51685,40-44,589,701,1290
32302,51685,45-49,579,696,1275
32303,51685,50-54,593,654,1247
32304,51685,55-59,548,581,1129
32305,51685,60-64,423,460,883
32306,51685,65+,801,697,1498
32307,51690,15-19,428,442,870
32308,51690,20-24,370,391,761
32309,51690,25-29,448,403,851
32310,51690,30-34,412,390,802
32311,51690,35-39,403,336,739
32312,51690,40-44,392,376,768
32313,51690,45-49,391,319,710
32314,51690,50-54,446,422,868
32315,51690,55-59,521,421,942
32316,51690,60-64,536,417,953
32317,51690,65+,1382,911,2293
32318,51700,15-19,6205,6525,12730
32319,51700,20-24,7272,7797,15069
32320,51700,25-29,7493,7771,15264
32321,51700,30-34,7766,7321,15087
32322,51700,35-39,6568,6430,12998
32323,51700,40-44,5616,5174,10790
32324,51700,45-49,4786,4243,9029
32325,51700,50-54,5259,4538,9797
32326,51700,55-59,5957,5210,11167
32327,51700,60-64,5808,5152,10960
32328,51700,65+,14813,10462,25275
32329,51710,15-19,7210,8066,15276
32330,51710,20-24,11684,20343,32027
32331,51710,25-29,10779,14129,24908
32332,51710,30-34,9338,11220,20558
32333,51710,35-39,7410,8719,16129
32334,51710,40-44,6132,6376,12508
32335,51710,45-49,5260,5175,10435
32336,51710,50-54,5783,5260,11043
32337,51710,55-59,6456,5831,12287
32338,51710,60-64,6676,5875,12551
32339,51710,65+,16107,12062,28169
32340,51720,15-19,95,107,202
32341,51720,20-24,90,109,199
32342,51720,25-29,127,149,276
32343,51720,30-34,140,127,267
32344,51720,35-39,119,119,238
32345,51720,40-44,102,100,202
32346,51720,45-49,122,104,226
32347,51720,50-54,96,116,212
32348,51720,55-59,119,104,223
32349,51720,60-64,138,111,249
32350,51720,65+,414,260,674
32351,51730,15-19,814,807,1621
32352,51730,20-24,1271,976,2247
32353,51730,25-29,1575,1256,2831
32354,51730,30-34,1378,1124,2502
32355,51730,35-39,1052,862,1914
32356,51730,40-44,916,849,1765
32357,51730,45-49,827,757,1584
32358,51730,50-54,1090,922,2012
32359,51730,55-59,1282,1145,2427
32360,51730,60-64,1259,940,2199
32361,51730,65+,3474,2255,5729
32362,51735,15-19,416,432,848
32363,51735,20-24,301,344,645
32364,51735,25-29,245,287,532
32365,51735,30-34,346,370,716
32366,51735,35-39,462,448,910
32367,51735,40-44,426,451,877
32368,51735,45-49,399,397,796
32369,51735,50-54,404,401,805
32370,51735,55-59,452,485,937
32371,51735,60-64,424,391,815
32372,51735,65+,1253,1141,2394
32373,51740,15-19,2689,2868,5557
32374,51740,20-24,3172,3627,6799
32375,51740,25-29,4023,4068,8091
32376,51740,30-34,4191,3976,8167
32377,51740,35-39,3592,3401,6993
32378,51740,40-44,3090,2732,5822
32379,51740,45-49,2574,2326,4900
32380,51740,50-54,2882,2503,5385
32381,51740,55-59,3137,2739,5876
32382,51740,60-64,3367,2750,6117
32383,51740,65+,8660,6203,14863
32384,51750,15-19,1561,1096,2657
32385,51750,20-24,2206,1922,4128
32386,51750,25-29,541,601,1142
32387,51750,30-34,440,461,901
32388,51750,35-39,380,359,739
32389,51750,40-44,404,327,731
32390,51750,45-49,358,345,703
32391,51750,50-54,350,415,765
32392,51750,55-59,402,363,765
32393,51750,60-64,345,331,676
32394,51750,65+,884,708,1592
32395,51760,15-19,7097,6105,13202
32396,51760,20-24,9858,8076,17934
32397,51760,25-29,13469,11819,25288
32398,51760,30-34,12500,11779,24279
32399,51760,35-39,8747,8854,17601
32400,51760,40-44,6381,6373,12754
32401,51760,45-49,5562,5291,10853
32402,51760,50-54,6216,5928,12144
32403,51760,55-59,7157,6253,13410
32404,51760,60-64,7563,6297,13860
32405,51760,65+,18248,13652,31900
32406,51770,15-19,2589,2738,5327
32407,51770,20-24,2840,2688,5528
32408,51770,25-29,3917,3687,7604
32409,51770,30-34,3896,3648,7544
32410,51770,35-39,3275,3247,6522
32411,51770,40-44,3230,2916,6146
32412,51770,45-49,2943,2769,5712
32413,51770,50-54,3033,3027,6060
32414,51770,55-59,3238,3043,6281
32415,51770,60-64,3325,3001,6326
32416,51770,65+,9971,7083,17054
32417,51775,15-19,1129,1032,2161
32418,51775,20-24,1097,1000,2097
32419,51775,25-29,702,725,1427
32420,51775,30-34,763,690,1453
32421,51775,35-39,732,768,1500
32422,51775,40-44,743,728,1471
32423,51775,45-49,702,671,1373
32424,51775,50-54,817,779,1596
32425,51775,55-59,877,799,1676
32426,51775,60-64,935,862,1797
32427,51775,65+,2842,2096,4938
32428,51790,15-19,732,668,1400
32429,51790,20-24,895,566,1461
32430,51790,25-29,931,780,1711
32431,51790,30-34,960,866,1826
32432,51790,35-39,854,832,1686
32433,51790,40-44,869,834,1703
32434,51790,45-49,734,685,1419
32435,51790,50-54,789,788,1577
32436,51790,55-59,880,794,1674
32437,51790,60-64,947,751,1698
32438,51790,65+,3117,2269,5386
32439,51800,15-19,2863,2991,5854
32440,51800,20-24,2689,2807,5496
32441,51800,25-29,3075,3036,6111
32442,51800,30-34,3616,3381,6997
32443,51800,35-39,3463,3415,6878
32444,51800,40-44,3192,2975,6167
32445,51800,45-49,2913,2786,5699
32446,51800,50-54,3367,2934,6301
32447,51800,55-59,3561,3381,6942
32448,51800,60-64,3224,3067,6291
32449,51800,65+,8099,6440,14539
32450,51810,15-19,13151,13998,27149
32451,51810,20-24,14048,16295,30343
32452,51810,25-29,17307,18438,35745
32453,51810,30-34,18128,18341,36469
32454,51810,35-39,17138,17324,34462
32455,51810,40-44,14930,14881,29811
32456,51810,45-49,13110,12559,25669
32457,51810,50-54,14357,13052,27409
32458,51810,55-59,15434,13859,29293
32459,51810,60-64,14771,13262,28033
32460,51810,65+,39310,30219,69529
32461,51820,15-19,638,631,1269
32462,51820,20-24,674,576,1250
32463,51820,25-29,804,769,1573
32464,51820,30-34,782,774,1556
32465,51820,35-39,774,825,1599
32466,51820,40-44,788,667,1455
32467,51820,45-49,651,649,1300
32468,51820,50-54,672,610,1282
32469,51820,55-59,744,698,1442
32470,51820,60-64,803,693,1496
32471,51820,65+,2262,1691,3953
32472,51830,15-19,1324,1097,2421
32473,51830,20-24,1797,1392,3189
32474,51830,25-29,452,423,875
32475,51830,30-34,407,427,834
32476,51830,35-39,356,353,709
32477,51830,40-44,286,287,573
32478,51830,45-49,270,259,529
32479,51830,50-54,347,263,610
32480,51830,55-59,400,352,752
32481,51830,60-64,462,395,857
32482,51830,65+,1509,1213,2722
32483,51840,15-19,1092,1141,2233
32484,51840,20-24,972,988,1960
32485,51840,25-29,1016,1030,2046
32486,51840,30-34,919,975,1894
32487,51840,35-39,821,867,1688
32488,51840,40-44,847,847,1694
32489,51840,45-49,778,762,1540
32490,51840,50-54,870,797,1667
32491,51840,55-59,908,905,1813
32492,51840,60-64,880,826,1706
32493,51840,65+,2631,2075,4706
32494,53001,15-19,862,1007,1869
32495,53001,20-24,690,780,1470
32496,53001,25-29,609,658,1267
32497,53001,30-34,598,648,1246
32498,53001,35-39,540,615,1155
32499,53001,40-44,560,546,1106
32500,53001,45-49,487,496,983
32501,53001,50-54,475,516,991
32502,53001,55-59,484,510,994
32503,53001,60-64,499,461,960
32504,53001,65+,1255,1155,2410
32505,53003,15-19,617,628,1245
32506,53003,20-24,533,537,1070
32507,53003,25-29,622,610,1232
32508,53003,30-34,599,606,1205
32509,53003,35-39,693,653,1346
32510,53003,40-44,627,640,1267
32511,53003,45-49,596,579,1175
32512,53003,50-54,683,639,1322
32513,53003,55-59,773,756,1529
32514,53003,60-64,989,845,1834
32515,53003,65+,2859,2612,5471
32516,53005,15-19,6922,7496,14418
32517,53005,20-24,6061,6475,12536
32518,53005,25-29,6833,7068,13901
32519,53005,30-34,7203,7380,14583
32520,53005,35-39,7257,7587,14844
32521,53005,40-44,6634,6862,13496
32522,53005,45-49,5543,5885,11428
32523,53005,50-54,5851,5984,11835
32524,53005,55-59,6083,6059,12142
32525,53005,60-64,6359,6199,12558
32526,53005,65+,17265,15341,32606
32527,53007,15-19,2346,2560,4906
32528,53007,20-24,2154,2274,4428
32529,53007,25-29,2286,2506,4792
32530,53007,30-34,2407,2657,5064
32531,53007,35-39,2511,2596,5107
32532,53007,40-44,2432,2417,4849
32533,53007,45-49,2116,2034,4150
32534,53007,50-54,2199,2292,4491
32535,53007,55-59,2486,2441,4927
32536,53007,60-64,2887,2852,5739
32537,53007,65+,8401,7655,16056
32538,53009,15-19,1692,1769,3461
32539,53009,20-24,1549,1969,3518
32540,53009,25-29,1769,2069,3838
32541,53009,30-34,2103,2281,4384
32542,53009,35-39,2143,2247,4390
32543,53009,40-44,2030,2171,4201
32544,53009,45-49,1804,1794,3598
32545,53009,50-54,2060,2005,4065
32546,53009,55-59,2606,2355,4961
32547,53009,60-64,3649,3204,6853
32548,53009,65+,12901,11336,24237
32549,53011,15-19,15861,16480,32341
32550,53011,20-24,14728,15204,29932
32551,53011,25-29,16685,17255,33940
32552,53011,30-34,17698,18201,35899
32553,53011,35-39,17383,17524,34907
32554,53011,40-44,17701,17290,34991
32555,53011,45-49,16114,16009,32123
32556,53011,50-54,16280,16987,33267
32557,53011,55-59,16496,16061,32557
32558,53011,60-64,16039,15637,31676
32559,53011,65+,45159,38317,83476
32560,53013,15-19,99,112,211
32561,53013,20-24,86,89,175
32562,53013,25-29,129,92,221
32563,53013,30-34,124,87,211
32564,53013,35-39,103,104,207
32565,53013,40-44,104,124,228
32566,53013,45-49,86,93,179
32567,53013,50-54,113,118,231
32568,53013,55-59,153,148,301
32569,53013,60-64,181,154,335
32570,53013,65+,591,565,1156
32571,53015,15-19,3192,3352,6544
32572,53015,20-24,2885,3016,5901
32573,53015,25-29,3512,3496,7008
32574,53015,30-34,3651,3667,7318
32575,53015,35-39,3327,3461,6788
32576,53015,40-44,3340,3436,6776
32577,53015,45-49,3121,3280,6401
32578,53015,50-54,3485,3504,6989
32579,53015,55-59,3692,3603,7295
32580,53015,60-64,3996,4010,8006
32581,53015,65+,11417,10256,21673
32582,53017,15-19,1458,1544,3002
32583,53017,20-24,1152,1333,2485
32584,53017,25-29,1254,1402,2656
32585,53017,30-34,1309,1469,2778
32586,53017,35-39,1334,1501,2835
32587,53017,40-44,1252,1368,2620
32588,53017,45-49,1217,1285,2502
32589,53017,50-54,1202,1278,2480
32590,53017,55-59,1297,1302,2599
32591,53017,60-64,1385,1400,2785
32592,53017,65+,4166,3767,7933
32593,53019,15-19,142,241,383
32594,53019,20-24,150,199,349
32595,53019,25-29,139,140,279
32596,53019,30-34,167,155,322
32597,53019,35-39,173,182,355
32598,53019,40-44,210,185,395
32599,53019,45-49,193,226,419
32600,53019,50-54,243,196,439
32601,53019,55-59,287,263,550
32602,53019,60-64,314,313,627
32603,53019,65+,1076,1104,2180
32604,53021,15-19,4084,4128,8212
32605,53021,20-24,3203,3624,6827
32606,53021,25-29,3347,3727,7074
32607,53021,30-34,3410,3909,7319
32608,53021,35-39,3351,3980,7331
32609,53021,40-44,3030,3621,6651
32610,53021,45-49,2704,2993,5697
32611,53021,50-54,2357,2723,5080
32612,53021,55-59,2147,2352,4499
32613,53021,60-64,1987,2102,4089
32614,53021,65+,5085,4680,9765
32615,53023,15-19,51,73,124
32616,53023,20-24,47,47,94
32617,53023,25-29,48,52,100
32618,53023,30-34,60,55,115
32619,53023,35-39,52,58,110
32620,53023,40-44,86,71,157
32621,53023,45-49,96,62,158
32622,53023,50-54,57,46,103
32623,53023,55-59,71,75,146
32624,53023,60-64,98,102,200
32625,53023,65+,322,313,635
32626,53025,15-19,3684,4014,7698
32627,53025,20-24,3113,3396,6509
32628,53025,25-29,3262,3637,6899
32629,53025,30-34,3246,3588,6834
32630,53025,35-39,2847,3302,6149
32631,53025,40-44,2919,3020,5939
32632,53025,45-49,2761,2731,5492
32633,53025,50-54,2570,2797,5367
32634,53025,55-59,2627,2845,5472
32635,53025,60-64,2746,2833,5579
32636,53025,65+,7340,6971,14311
32637,53027,15-19,1995,2135,4130
32638,53027,20-24,1696,2082,3778
32639,53027,25-29,1880,2290,4170
32640,53027,30-34,2196,2561,4757
32641,53027,35-39,2130,2494,4624
32642,53027,40-44,2182,2388,4570
32643,53027,45-49,1890,2288,4178
32644,53027,50-54,2226,2454,4680
32645,53027,55-59,2635,2695,5330
32646,53027,60-64,3151,3038,6189
32647,53027,65+,9115,8519,17634
32648,53029,15-19,1808,1970,3778
32649,53029,20-24,2383,3253,5636
32650,53029,25-29,2820,3352,6172
32651,53029,30-34,2717,3121,5838
32652,53029,35-39,2589,2870,5459
32653,53029,40-44,2175,2296,4471
32654,53029,45-49,1927,1902,3829
32655,53029,50-54,2243,2150,4393
32656,53029,55-59,2859,2595,5454
32657,53029,60-64,3495,2999,6494
32658,53029,65+,12078,10658,22736
32659,53031,15-19,535,567,1102
32660,53031,20-24,491,551,1042
32661,53031,25-29,578,621,1199
32662,53031,30-34,718,816,1534
32663,53031,35-39,812,852,1664
32664,53031,40-44,795,816,1611
32665,53031,45-49,704,752,1456
32666,53031,50-54,903,936,1839
32667,53031,55-59,1279,1070,2349
32668,53031,60-64,1901,1520,3421
32669,53031,65+,6810,6349,13159
32670,53033,15-19,60182,61338,121520
32671,53033,20-24,63268,65280,128548
32672,53033,25-29,91788,101084,192872
32673,53033,30-34,101875,113622,215497
32674,53033,35-39,92147,101347,193494
32675,53033,40-44,79594,85605,165199
32676,53033,45-49,71607,75306,146913
32677,53033,50-54,71054,75762,146816
32678,53033,55-59,65698,68455,134153
32679,53033,60-64,62397,62846,125243
32680,53033,65+,169642,140318,309960
32681,53035,15-19,7066,7715,14781
32682,53035,20-24,7293,11598,18891
32683,53035,25-29,8757,11064,19821
32684,53035,30-34,9360,10488,19848
32685,53035,35-39,8997,10146,19143
32686,53035,40-44,8184,8593,16777
32687,53035,45-49,7025,7350,14375
32688,53035,50-54,8064,8096,16160
32689,53035,55-59,9006,8866,17872
32690,53035,60-64,9649,9162,18811
32691,53035,65+,28144,24379,52523
32692,53037,15-19,1968,1790,3758
32693,53037,20-24,3498,3423,6921
32694,53037,25-29,1291,1611,2902
32695,53037,30-34,1254,1390,2644
32696,53037,35-39,1264,1312,2576
32697,53037,40-44,1196,1244,2440
32698,53037,45-49,1004,1140,2144
32699,53037,50-54,1146,1212,2358
32700,53037,55-59,1325,1272,2597
32701,53037,60-64,1563,1470,3033
32702,53037,65+,3897,3859,7756
32703,53039,15-19,562,634,1196
32704,53039,20-24,453,513,966
32705,53039,25-29,524,600,1124
32706,53039,30-34,621,678,1299
32707,53039,35-39,700,658,1358
32708,53039,40-44,667,757,1424
32709,53039,45-49,706,673,1379
32710,53039,50-54,663,763,1426
32711,53039,55-59,808,834,1642
32712,53039,60-64,1005,937,1942
32713,53039,65+,2911,2907,5818
32714,53041,15-19,2224,2532,4756
32715,53041,20-24,2079,2223,4302
32716,53041,25-29,2396,2591,4987
32717,53041,30-34,2654,2721,5375
32718,53041,35-39,2599,2684,5283
32719,53041,40-44,2510,2644,5154
32720,53041,45-49,2292,2375,4667
32721,53041,50-54,2487,2490,4977
32722,53041,55-59,2802,2729,5531
32723,53041,60-64,3189,3064,6253
32724,53041,65+,9221,8585,17806
32725,53043,15-19,340,354,694
32726,53043,20-24,255,270,525
32727,53043,25-29,227,257,484
32728,53043,30-34,251,254,505
32729,53043,35-39,310,298,608
32730,53043,40-44,307,319,626
32731,53043,45-49,277,286,563
32732,53043,50-54,303,314,617
32733,53043,55-59,355,371,726
32734,53043,60-64,493,513,1006
32735,53043,65+,1446,1462,2908
32736,53045,15-19,1611,1861,3472
32737,53045,20-24,1437,1922,3359
32738,53045,25-29,1689,2347,4036
32739,53045,30-34,1921,2255,4176
32740,53045,35-39,1868,2216,4084
32741,53045,40-44,1780,2122,3902
32742,53045,45-49,1607,1922,3529
32743,53045,50-54,1901,1989,3890
32744,53045,55-59,2355,2268,4623
32745,53045,60-64,2820,2785,5605
32746,53045,65+,8211,7841,16052
32747,53047,15-19,1182,1298,2480
32748,53047,20-24,938,1067,2005
32749,53047,25-29,1164,1108,2272
32750,53047,30-34,1192,1246,2438
32751,53047,35-39,1203,1247,2450
32752,53047,40-44,1206,1311,2517
32753,53047,45-49,1116,1165,2281
32754,53047,50-54,1179,1260,2439
32755,53047,55-59,1324,1289,2613
32756,53047,60-64,1691,1592,3283
32757,53047,65+,4880,4842,9722
32758,53049,15-19,500,578,1078
32759,53049,20-24,399,463,862
32760,53049,25-29,486,545,1031
32761,53049,30-34,585,528,1113
32762,53049,35-39,647,645,1292
32763,53049,40-44,564,646,1210
32764,53049,45-49,588,572,1160
32765,53049,50-54,724,701,1425
32766,53049,55-59,855,836,1691
32767,53049,60-64,1175,1097,2272
32768,53049,65+,4084,3816,7900
32769,53051,15-19,331,393,724
32770,53051,20-24,283,301,584
32771,53051,25-29,280,321,601
32772,53051,30-34,346,336,682
32773,53051,35-39,354,351,705
32774,53051,40-44,356,355,711
32775,53051,45-49,345,351,696
32776,53051,50-54,368,471,839
32777,53051,55-59,545,563,1108
32778,53051,60-64,666,626,1292
32779,53051,65+,1808,1891,3699
32780,53053,15-19,26642,28626,55268
32781,53053,20-24,27275,32802,60077
32782,53053,25-29,33164,36490,69654
32783,53053,30-34,36124,37271,73395
32784,53053,35-39,34728,35488,70216
32785,53053,40-44,31026,31066,62092
32786,53053,45-49,26510,26937,53447
32787,53053,50-54,28195,28180,56375
32788,53053,55-59,28281,28213,56494
32789,53053,60-64,28322,27161,55483
32790,53053,65+,73266,60143,133409
32791,53055,15-19,374,336,710
32792,53055,20-24,309,349,658
32793,53055,25-29,380,373,753
32794,53055,30-34,426,425,851
32795,53055,35-39,474,469,943
32796,53055,40-44,521,492,1013
32797,53055,45-49,471,479,950
32798,53055,50-54,561,567,1128
32799,53055,55-59,685,638,1323
32800,53055,60-64,999,867,1866
32801,53055,65+,3325,3180,6505
32802,53057,15-19,3586,3849,7435
32803,53057,20-24,3386,3479,6865
32804,53057,25-29,3945,4155,8100
32805,53057,30-34,4045,4322,8367
32806,53057,35-39,4210,4351,8561
32807,53057,40-44,3851,4049,7900
32808,53057,45-49,3488,3531,7019
32809,53057,50-54,3735,3762,7497
32810,53057,55-59,4152,4021,8173
32811,53057,60-64,4816,4456,9272
32812,53057,65+,15168,13296,28464
32813,53059,15-19,271,327,598
32814,53059,20-24,236,251,487
32815,53059,25-29,260,306,566
32816,53059,30-34,331,353,684
32817,53059,35-39,372,339,711
32818,53059,40-44,399,387,786
32819,53059,45-49,358,376,734
32820,53059,50-54,423,425,848
32821,53059,55-59,469,510,979
32822,53059,60-64,560,546,1106
32823,53059,65+,1429,1515,2944
32824,53061,15-19,22878,24501,47379
32825,53061,20-24,21578,23039,44617
32826,53061,25-29,27185,28454,55639
32827,53061,30-34,33097,34382,67479
32828,53061,35-39,32895,35259,68154
32829,53061,40-44,28714,31353,60067
32830,53061,45-49,25370,26769,52139
32831,53061,50-54,26704,28529,55233
32832,53061,55-59,27220,28201,55421
32833,53061,60-64,26527,26610,53137
32834,53061,65+,65197,54509,119706
32835,53063,15-19,16788,17596,34384
32836,53063,20-24,17172,18233,35405
32837,53063,25-29,19450,20428,39878
32838,53063,30-34,20339,21459,41798
32839,53063,35-39,18864,19628,38492
32840,53063,40-44,16781,17514,34295
32841,53063,45-49,15070,15471,30541
32842,53063,50-54,16069,16282,32351
32843,53063,55-59,17299,16523,33822
32844,53063,60-64,17933,16996,34929
32845,53063,65+,49651,42144,91795
32846,53065,15-19,1372,1436,2808
32847,53065,20-24,1012,1072,2084
32848,53065,25-29,1105,1149,2254
32849,53065,30-34,1146,1194,2340
32850,53065,35-39,1252,1331,2583
32851,53065,40-44,1364,1293,2657
32852,53065,45-49,1209,1247,2456
32853,53065,50-54,1474,1424,2898
32854,53065,55-59,1683,1667,3350
32855,53065,60-64,2116,2030,4146
32856,53065,65+,5891,5817,11708
32857,53067,15-19,8161,8500,16661
32858,53067,20-24,8424,8588,17012
32859,53067,25-29,10111,10653,20764
32860,53067,30-34,11013,11280,22293
32861,53067,35-39,11101,11029,22130
32862,53067,40-44,10216,10157,20373
32863,53067,45-49,8725,8648,17373
32864,53067,50-54,9045,8992,18037
32865,53067,55-59,9369,8632,18001
32866,53067,60-64,9904,8977,18881
32867,53067,65+,29845,24235,54080
32868,53069,15-19,119,126,245
32869,53069,20-24,96,95,191
32870,53069,25-29,84,100,184
32871,53069,30-34,89,107,196
32872,53069,35-39,107,104,211
32873,53069,40-44,103,108,211
32874,53069,45-49,108,113,221
32875,53069,50-54,125,124,249
32876,53069,55-59,185,183,368
32877,53069,60-64,205,217,422
32878,53069,65+,739,763,1502
32879,53071,15-19,2392,2440,4832
32880,53071,20-24,2508,2971,5479
32881,53071,25-29,1713,2178,3891
32882,53071,30-34,1766,2126,3892
32883,53071,35-39,1797,2172,3969
32884,53071,40-44,1643,1950,3593
32885,53071,45-49,1552,1756,3308
32886,53071,50-54,1604,1788,3392
32887,53071,55-59,1848,1851,3699
32888,53071,60-64,1992,1881,3873
32889,53071,65+,6495,5506,12001
32890,53073,15-19,7538,7503,15041
32891,53073,20-24,11599,11178,22777
32892,53073,25-29,7840,8334,16174
32893,53073,30-34,7354,7957,15311
32894,53073,35-39,7437,7601,15038
32895,53073,40-44,7088,7178,14266
32896,53073,45-49,6089,6258,12347
32897,53073,50-54,6531,6546,13077
32898,53073,55-59,6744,6393,13137
32899,53073,60-64,7314,6848,14162
32900,53073,65+,22516,19422,41938
32901,53075,15-19,3281,3042,6323
32902,53075,20-24,5410,5752,11162
32903,53075,25-29,1741,1944,3685
32904,53075,30-34,1319,1648,2967
32905,53075,35-39,1133,1303,2436
32906,53075,40-44,1070,1110,2180
32907,53075,45-49,906,910,1816
32908,53075,50-54,904,932,1836
32909,53075,55-59,999,969,1968
32910,53075,60-64,1069,1096,2165
32911,53075,65+,2786,2565,5351
32912,53077,15-19,9756,10293,20049
32913,53077,20-24,8469,8819,17288
32914,53077,25-29,8774,8794,17568
32915,53077,30-34,8305,8535,16840
32916,53077,35-39,7790,7858,15648
32917,53077,40-44,7508,7719,15227
32918,53077,45-49,6783,6861,13644
32919,53077,50-54,6821,6972,13793
32920,53077,55-59,6869,7004,13873
32921,53077,60-64,6624,6806,13430
32922,53077,65+,19388,16805,36193
32923,54001,15-19,608,525,1133
32924,54001,20-24,573,536,1109
32925,54001,25-29,417,424,841
32926,54001,30-34,438,444,882
32927,54001,35-39,405,429,834
32928,54001,40-44,434,410,844
32929,54001,45-49,491,481,972
32930,54001,50-54,509,504,1013
32931,54001,55-59,515,528,1043
32932,54001,60-64,559,521,1080
32933,54001,65+,1644,1555,3199
32934,54003,15-19,3573,3876,7449
32935,54003,20-24,3423,3466,6889
32936,54003,25-29,4268,4382,8650
32937,54003,30-34,4701,4799,9500
32938,54003,35-39,4309,4387,8696
32939,54003,40-44,4197,4241,8438
32940,54003,45-49,3957,3914,7871
32941,54003,50-54,4248,4356,8604
32942,54003,55-59,4356,4386,8742
32943,54003,60-64,4094,4073,8167
32944,54003,65+,10172,8973,19145
32945,54005,15-19,625,710,1335
32946,54005,20-24,505,582,1087
32947,54005,25-29,492,559,1051
32948,54005,30-34,530,580,1110
32949,54005,35-39,526,510,1036
32950,54005,40-44,745,691,1436
32951,54005,45-49,759,788,1547
32952,54005,50-54,752,771,1523
32953,54005,55-59,727,731,1458
32954,54005,60-64,808,789,1597
32955,54005,65+,2460,2158,4618
32956,54007,15-19,310,340,650
32957,54007,20-24,272,286,558
32958,54007,25-29,328,378,706
32959,54007,30-34,336,391,727
32960,54007,35-39,299,319,618
32961,54007,40-44,344,386,730
32962,54007,45-49,369,387,756
32963,54007,50-54,420,428,848
32964,54007,55-59,438,466,904
32965,54007,60-64,429,501,930
32966,54007,65+,1528,1411,2939
32967,54009,15-19,628,693,1321
32968,54009,20-24,671,725,1396
32969,54009,25-29,548,617,1165
32970,54009,30-34,560,652,1212
32971,54009,35-39,520,552,1072
32972,54009,40-44,616,646,1262
32973,54009,45-49,654,654,1308
32974,54009,50-54,719,739,1458
32975,54009,55-59,782,804,1586
32976,54009,60-64,931,874,1805
32977,54009,65+,2985,2448,5433
32978,54011,15-19,3098,3188,6286
32979,54011,20-24,4797,4568,9365
32980,54011,25-29,3075,3116,6191
32981,54011,30-34,2592,2706,5298
32982,54011,35-39,2642,2844,5486
32983,54011,40-44,2766,2759,5525
32984,54011,45-49,2638,2599,5237
32985,54011,50-54,2764,2764,5528
32986,54011,55-59,2722,2639,5361
32987,54011,60-64,3038,2736,5774
32988,54011,65+,10052,7934,17986
32989,54013,15-19,167,166,333
32990,54013,20-24,127,127,254
32991,54013,25-29,140,136,276
32992,54013,30-34,143,147,290
32993,54013,35-39,161,157,318
32994,54013,40-44,182,206,388
32995,54013,45-49,171,186,357
32996,54013,50-54,206,193,399
32997,54013,55-59,266,258,524
32998,54013,60-64,241,286,527
32999,54013,65+,803,786,1589
33000,54015,15-19,228,259,487
33001,54015,20-24,166,189,355
33002,54015,25-29,190,183,373
33003,54015,30-34,209,202,411
33004,54015,35-39,190,194,384
33005,54015,40-44,250,249,499
33006,54015,45-49,250,238,488
33007,54015,50-54,258,250,508
33008,54015,55-59,301,271,572
33009,54015,60-64,316,323,639
33010,54015,65+,859,901,1760
33011,54017,15-19,155,284,439
33012,54017,20-24,154,342,496
33013,54017,25-29,197,350,547
33014,54017,30-34,185,277,462
33015,54017,35-39,187,279,466
33016,54017,40-44,231,317,548
33017,54017,45-49,222,284,506
33018,54017,50-54,230,307,537
33019,54017,55-59,269,326,595
33020,54017,60-64,296,303,599
33021,54017,65+,830,865,1695
33022,54019,15-19,1112,1246,2358
33023,54019,20-24,913,1167,2080
33024,54019,25-29,974,1174,2148
33025,54019,30-34,1058,1175,2233
33026,54019,35-39,1033,1103,2136
33027,54019,40-44,1257,1352,2609
33028,54019,45-49,1211,1359,2570
33029,54019,50-54,1207,1336,2543
33030,54019,55-59,1309,1389,2698
33031,54019,60-64,1486,1412,2898
33032,54019,65+,4787,4116,8903
33033,54021,15-19,222,263,485
33034,54021,20-24,324,507,831
33035,54021,25-29,126,334,460
33036,54021,30-34,142,428,570
33037,54021,35-39,142,399,541
33038,54021,40-44,159,305,464
33039,54021,45-49,162,299,461
33040,54021,50-54,151,285,436
33041,54021,55-59,218,272,490
33042,54021,60-64,200,203,403
33043,54021,65+,677,632,1309
33044,54023,15-19,276,288,564
33045,54023,20-24,253,282,535
33046,54023,25-29,289,320,609
33047,54023,30-34,264,305,569
33048,54023,35-39,277,293,570
33049,54023,40-44,288,295,583
33050,54023,45-49,310,331,641
33051,54023,50-54,374,405,779
33052,54023,55-59,396,419,815
33053,54023,60-64,405,397,802
33054,54023,65+,1393,1327,2720
33055,54025,15-19,842,876,1718
33056,54025,20-24,759,955,1714
33057,54025,25-29,882,867,1749
33058,54025,30-34,916,884,1800
33059,54025,35-39,913,870,1783
33060,54025,40-44,962,949,1911
33061,54025,45-49,969,905,1874
33062,54025,50-54,1078,1044,2122
33063,54025,55-59,1167,1175,2342
33064,54025,60-64,1282,1282,2564
33065,54025,65+,4199,3595,7794
33066,54027,15-19,592,622,1214
33067,54027,20-24,536,602,1138
33068,54027,25-29,568,680,1248
33069,54027,30-34,574,612,1186
33070,54027,35-39,577,619,1196
33071,54027,40-44,684,682,1366
33072,54027,45-49,697,706,1403
33073,54027,50-54,842,897,1739
33074,54027,55-59,932,972,1904
33075,54027,60-64,978,985,1963
33076,54027,65+,2754,2799,5553
33077,54029,15-19,736,846,1582
33078,54029,20-24,672,724,1396
33079,54029,25-29,741,784,1525
33080,54029,30-34,773,817,1590
33081,54029,35-39,749,755,1504
33082,54029,40-44,880,806,1686
33083,54029,45-49,926,933,1859
33084,54029,50-54,980,1019,1999
33085,54029,55-59,1039,1007,2046
33086,54029,60-64,1195,1114,2309
33087,54029,65+,3781,3069,6850
33088,54031,15-19,334,410,744
33089,54031,20-24,326,335,661
33090,54031,25-29,347,364,711
33091,54031,30-34,371,380,751
33092,54031,35-39,343,369,712
33093,54031,40-44,389,464,853
33094,54031,45-49,431,463,894
33095,54031,50-54,492,526,1018
33096,54031,55-59,548,570,1118
33097,54031,60-64,573,570,1143
33098,54031,65+,1680,1576,3256
33099,54033,15-19,1821,1974,3795
33100,54033,20-24,1675,1717,3392
33101,54033,25-29,1917,1924,3841
33102,54033,30-34,1922,1938,3860
33103,54033,35-39,2006,2010,4016
33104,54033,40-44,2067,2119,4186
33105,54033,45-49,2024,2036,4060
33106,54033,50-54,2133,2170,4303
33107,54033,55-59,2273,2274,4547
33108,54033,60-64,2364,2313,4677
33109,54033,65+,7191,5803,12994
33110,54035,15-19,770,866,1636
33111,54035,20-24,686,719,1405
33112,54035,25-29,703,803,1506
33113,54035,30-34,753,797,1550
33114,54035,35-39,786,746,1532
33115,54035,40-44,819,840,1659
33116,54035,45-49,839,870,1709
33117,54035,50-54,946,920,1866
33118,54035,55-59,1082,1019,2101
33119,54035,60-64,1011,1062,2073
33120,54035,65+,3138,2695,5833
33121,54037,15-19,1948,2102,4050
33122,54037,20-24,1580,1681,3261
33123,54037,25-29,1524,1495,3019
33124,54037,30-34,1780,1746,3526
33125,54037,35-39,1889,1918,3807
33126,54037,40-44,1945,1899,3844
33127,54037,45-49,1905,1938,3843
33128,54037,50-54,2213,2198,4411
33129,54037,55-59,2235,2258,4493
33130,54037,60-64,1995,1987,3982
33131,54037,65+,5344,4753,10097
33132,54039,15-19,4943,5293,10236
33133,54039,20-24,4894,4822,9716
33134,54039,25-29,5494,5517,11011
33135,54039,30-34,5476,5347,10823
33136,54039,35-39,5190,5201,10391
33137,54039,40-44,5643,5468,11111
33138,54039,45-49,5299,5300,10599
33139,54039,50-54,5759,5565,11324
33140,54039,55-59,6200,5812,12012
33141,54039,60-64,6956,6271,13227
33142,54039,65+,21494,17020,38514
33143,54041,15-19,451,469,920
33144,54041,20-24,389,390,779
33145,54041,25-29,505,552,1057
33146,54041,30-34,489,506,995
33147,54041,35-39,477,464,941
33148,54041,40-44,533,534,1067
33149,54041,45-49,491,554,1045
33150,54041,50-54,574,574,1148
33151,54041,55-59,615,605,1220
33152,54041,60-64,601,590,1191
33153,54041,65+,1865,1682,3547
33154,54043,15-19,573,645,1218
33155,54043,20-24,480,515,995
33156,54043,25-29,566,555,1121
33157,54043,30-34,527,509,1036
33158,54043,35-39,560,501,1061
33159,54043,40-44,626,630,1256
33160,54043,45-49,639,647,1286
33161,54043,50-54,706,751,1457
33162,54043,55-59,713,725,1438
33163,54043,60-64,729,758,1487
33164,54043,65+,2192,1930,4122
33165,54045,15-19,849,946,1795
33166,54045,20-24,799,833,1632
33167,54045,25-29,880,936,1816
33168,54045,30-34,854,928,1782
33169,54045,35-39,857,874,1731
33170,54045,40-44,1028,1054,2082
33171,54045,45-49,1072,1152,2224
33172,54045,50-54,1014,1047,2061
33173,54045,55-59,1038,960,1998
33174,54045,60-64,1252,1134,2386
33175,54045,65+,3793,3169,6962
33176,54047,15-19,459,523,982
33177,54047,20-24,375,386,761
33178,54047,25-29,459,476,935
33179,54047,30-34,499,502,1001
33180,54047,35-39,442,535,977
33181,54047,40-44,538,591,1129
33182,54047,45-49,536,610,1146
33183,54047,50-54,582,566,1148
33184,54047,55-59,676,599,1275
33185,54047,60-64,855,744,1599
33186,54047,65+,2329,2006,4335
33187,54049,15-19,1753,1978,3731
33188,54049,20-24,2262,2344,4606
33189,54049,25-29,1737,1790,3527
33190,54049,30-34,1606,1648,3254
33191,54049,35-39,1565,1695,3260
33192,54049,40-44,1673,1674,3347
33193,54049,45-49,1613,1653,3266
33194,54049,50-54,1802,1806,3608
33195,54049,55-59,1693,1693,3386
33196,54049,60-64,1893,1843,3736
33197,54049,65+,5953,5047,11000
33198,54051,15-19,789,814,1603
33199,54051,20-24,699,770,1469
33200,54051,25-29,807,940,1747
33201,54051,30-34,811,925,1736
33202,54051,35-39,750,821,1571
33203,54051,40-44,844,916,1760
33204,54051,45-49,865,976,1841
33205,54051,50-54,971,1058,2029
33206,54051,55-59,1100,1054,2154
33207,54051,60-64,1218,1193,2411
33208,54051,65+,3856,3282,7138
33209,54053,15-19,703,743,1446
33210,54053,20-24,622,635,1257
33211,54053,25-29,735,705,1440
33212,54053,30-34,747,622,1369
33213,54053,35-39,785,641,1426
33214,54053,40-44,855,762,1617
33215,54053,45-49,793,752,1545
33216,54053,50-54,791,793,1584
33217,54053,55-59,886,851,1737
33218,54053,60-64,1031,963,1994
33219,54053,65+,3011,2529,5540
33220,54055,15-19,1620,1754,3374
33221,54055,20-24,1666,1684,3350
33222,54055,25-29,1689,1764,3453
33223,54055,30-34,1785,1731,3516
33224,54055,35-39,1578,1490,3068
33225,54055,40-44,1853,1671,3524
33226,54055,45-49,1811,1713,3524
33227,54055,50-54,1851,1849,3700
33228,54055,55-59,1936,1782,3718
33229,54055,60-64,2177,1898,4075
33230,54055,65+,7496,5883,13379
33231,54057,15-19,784,930,1714
33232,54057,20-24,660,770,1430
33233,54057,25-29,725,769,1494
33234,54057,30-34,759,800,1559
33235,54057,35-39,722,753,1475
33236,54057,40-44,739,752,1491
33237,54057,45-49,764,784,1548
33238,54057,50-54,939,954,1893
33239,54057,55-59,965,956,1921
33240,54057,60-64,1014,914,1928
33241,54057,65+,3200,2800,6000
33242,54059,15-19,642,699,1341
33243,54059,20-24,517,578,1095
33244,54059,25-29,613,588,1201
33245,54059,30-34,611,611,1222
33246,54059,35-39,660,628,1288
33247,54059,40-44,757,720,1477
33248,54059,45-49,780,755,1535
33249,54059,50-54,768,754,1522
33250,54059,55-59,841,794,1635
33251,54059,60-64,888,843,1731
33252,54059,65+,2498,2230,4728
33253,54061,15-19,4038,4581,8619
33254,54061,20-24,7444,8071,15515
33255,54061,25-29,4028,4666,8694
33256,54061,30-34,3844,4465,8309
33257,54061,35-39,3416,4010,7426
33258,54061,40-44,3028,3540,6568
33259,54061,45-49,2597,2853,5450
33260,54061,50-54,2654,2850,5504
33261,54061,55-59,2826,2749,5575
33262,54061,60-64,2865,2759,5624
33263,54061,65+,7632,6720,14352
33264,54063,15-19,312,358,670
33265,54063,20-24,254,285,539
33266,54063,25-29,310,278,588
33267,54063,30-34,316,312,628
33268,54063,35-39,304,327,631
33269,54063,40-44,360,352,712
33270,54063,45-49,357,355,712
33271,54063,50-54,416,421,837
33272,54063,55-59,466,459,925
33273,54063,60-64,481,467,948
33274,54063,65+,1641,1506,3147
33275,54065,15-19,422,473,895
33276,54065,20-24,390,446,836
33277,54065,25-29,432,458,890
33278,54065,30-34,462,448,910
33279,54065,35-39,391,470,861
33280,54065,40-44,486,482,968
33281,54065,45-49,489,563,1052
33282,54065,50-54,623,661,1284
33283,54065,55-59,721,744,1465
33284,54065,60-64,727,749,1476
33285,54065,65+,2174,2006,4180
33286,54067,15-19,655,696,1351
33287,54067,20-24,534,545,1079
33288,54067,25-29,579,624,1203
33289,54067,30-34,681,675,1356
33290,54067,35-39,642,684,1326
33291,54067,40-44,764,677,1441
33292,54067,45-49,764,743,1507
33293,54067,50-54,813,795,1608
33294,54067,55-59,867,877,1744
33295,54067,60-64,985,916,1901
33296,54067,65+,2985,2783,5768
33297,54069,15-19,1491,1424,2915
33298,54069,20-24,1454,1393,2847
33299,54069,25-29,1108,1196,2304
33300,54069,30-34,1150,1202,2352
33301,54069,35-39,1184,1228,2412
33302,54069,40-44,1195,1178,2373
33303,54069,45-49,1147,1166,2313
33304,54069,50-54,1238,1198,2436
33305,54069,55-59,1382,1278,2660
33306,54069,60-64,1581,1519,3100
33307,54069,65+,5318,4110,9428
33308,54071,15-19,138,162,300
33309,54071,20-24,121,122,243
33310,54071,25-29,136,151,287
33311,54071,30-34,142,152,294
33312,54071,35-39,151,155,306
33313,54071,40-44,150,187,337
33314,54071,45-49,139,159,298
33315,54071,50-54,180,192,372
33316,54071,55-59,240,245,485
33317,54071,60-64,267,270,537
33318,54071,65+,896,830,1726
33319,54073,15-19,184,213,397
33320,54073,20-24,167,265,432
33321,54073,25-29,195,306,501
33322,54073,30-34,170,293,463
33323,54073,35-39,188,278,466
33324,54073,40-44,218,295,513
33325,54073,45-49,220,311,531
33326,54073,50-54,229,292,521
33327,54073,55-59,269,308,577
33328,54073,60-64,274,286,560
33329,54073,65+,751,691,1442
33330,54075,15-19,173,180,353
33331,54075,20-24,160,201,361
33332,54075,25-29,174,198,372
33333,54075,30-34,207,239,446
33334,54075,35-39,174,237,411
33335,54075,40-44,218,240,458
33336,54075,45-49,195,231,426
33337,54075,50-54,233,250,483
33338,54075,55-59,280,316,596
33339,54075,60-64,326,364,690
33340,54075,65+,1070,1038,2108
33341,54077,15-19,824,808,1632
33342,54077,20-24,774,876,1650
33343,54077,25-29,964,1266,2230
33344,54077,30-34,1108,1147,2255
33345,54077,35-39,984,1117,2101
33346,54077,40-44,1066,1248,2314
33347,54077,45-49,977,1140,2117
33348,54077,50-54,1097,1281,2378
33349,54077,55-59,1169,1252,2421
33350,54077,60-64,1204,1271,2475
33351,54077,65+,3854,3439,7293
33352,54079,15-19,1760,1847,3607
33353,54079,20-24,1398,1464,2862
33354,54079,25-29,1494,1528,3022
33355,54079,30-34,1635,1623,3258
33356,54079,35-39,1853,1815,3668
33357,54079,40-44,1958,1998,3956
33358,54079,45-49,1967,1952,3919
33359,54079,50-54,1953,1989,3942
33360,54079,55-59,1971,1956,3927
33361,54079,60-64,2005,1981,3986
33362,54079,65+,5970,5026,10996
33363,54081,15-19,2046,2150,4196
33364,54081,20-24,1823,2147,3970
33365,54081,25-29,1987,2378,4365
33366,54081,30-34,2147,2546,4693
33367,54081,35-39,1983,2301,4284
33368,54081,40-44,2337,2455,4792
33369,54081,45-49,2313,2531,4844
33370,54081,50-54,2156,2370,4526
33371,54081,55-59,2178,2146,4324
33372,54081,60-64,2664,2359,5023
33373,54081,65+,8657,7223,15880
33374,54083,15-19,729,859,1588
33375,54083,20-24,674,937,1611
33376,54083,25-29,727,1024,1751
33377,54083,30-34,739,966,1705
33378,54083,35-39,671,881,1552
33379,54083,40-44,742,931,1673
33380,54083,45-49,755,862,1617
33381,54083,50-54,834,963,1797
33382,54083,55-59,945,1045,1990
33383,54083,60-64,980,1011,1991
33384,54083,65+,3301,2964,6265
33385,54085,15-19,226,268,494
33386,54085,20-24,178,192,370
33387,54085,25-29,200,219,419
33388,54085,30-34,198,232,430
33389,54085,35-39,215,205,420
33390,54085,40-44,245,250,495
33391,54085,45-49,258,229,487
33392,54085,50-54,300,302,602
33393,54085,55-59,321,365,686
33394,54085,60-64,328,369,697
33395,54085,65+,1005,925,1930
33396,54087,15-19,411,435,846
33397,54087,20-24,315,357,672
33398,54087,25-29,307,353,660
33399,54087,30-34,336,359,695
33400,54087,35-39,372,351,723
33401,54087,40-44,440,409,849
33402,54087,45-49,454,443,897
33403,54087,50-54,478,482,960
33404,54087,55-59,490,499,989
33405,54087,60-64,611,539,1150
33406,54087,65+,1633,1552,3185
33407,54089,15-19,309,288,597
33408,54089,20-24,259,241,500
33409,54089,25-29,389,287,676
33410,54089,30-34,384,235,619
33411,54089,35-39,386,263,649
33412,54089,40-44,449,339,788
33413,54089,45-49,447,316,763
33414,54089,50-54,397,368,765
33415,54089,55-59,477,404,881
33416,54089,60-64,519,448,967
33417,54089,65+,1688,1518,3206
33418,54091,15-19,397,480,877
33419,54091,20-24,377,395,772
33420,54091,25-29,417,537,954
33421,54091,30-34,481,546,1027
33422,54091,35-39,482,537,1019
33423,54091,40-44,533,559,1092
33424,54091,45-49,525,573,1098
33425,54091,50-54,553,609,1162
33426,54091,55-59,594,617,1211
33427,54091,60-64,551,615,1166
33428,54091,65+,1878,1618,3496
33429,54093,15-19,114,204,318
33430,54093,20-24,133,150,283
33431,54093,25-29,169,184,353
33432,54093,30-34,173,171,344
33433,54093,35-39,197,164,361
33434,54093,40-44,205,204,409
33435,54093,45-49,187,217,404
33436,54093,50-54,250,225,475
33437,54093,55-59,281,306,587
33438,54093,60-64,282,280,562
33439,54093,65+,912,919,1831
33440,54095,15-19,223,220,443
33441,54095,20-24,197,187,384
33442,54095,25-29,199,192,391
33443,54095,30-34,205,217,422
33444,54095,35-39,186,195,381
33445,54095,40-44,215,235,450
33446,54095,45-49,273,255,528
33447,54095,50-54,276,361,637
33448,54095,55-59,307,296,603
33449,54095,60-64,348,311,659
33450,54095,65+,1003,949,1952
33451,54097,15-19,886,856,1742
33452,54097,20-24,845,815,1660
33453,54097,25-29,642,646,1288
33454,54097,30-34,663,723,1386
33455,54097,35-39,671,650,1321
33456,54097,40-44,668,709,1377
33457,54097,45-49,658,662,1320
33458,54097,50-54,723,773,1496
33459,54097,55-59,774,774,1548
33460,54097,60-64,844,800,1644
33461,54097,65+,2626,2421,5047
33462,54099,15-19,1091,1148,2239
33463,54099,20-24,1018,1079,2097
33464,54099,25-29,1027,1172,2199
33465,54099,30-34,1119,1093,2212
33466,54099,35-39,1054,924,1978
33467,54099,40-44,1196,1140,2336
33468,54099,45-49,1280,1192,2472
33469,54099,50-54,1354,1369,2723
33470,54099,55-59,1365,1287,2652
33471,54099,60-64,1447,1340,2787
33472,54099,65+,4572,3937,8509
33473,54101,15-19,194,228,422
33474,54101,20-24,180,192,372
33475,54101,25-29,204,222,426
33476,54101,30-34,191,201,392
33477,54101,35-39,194,206,400
33478,54101,40-44,232,227,459
33479,54101,45-49,275,262,537
33480,54101,50-54,272,307,579
33481,54101,55-59,308,302,610
33482,54101,60-64,333,349,682
33483,54101,65+,1082,958,2040
33484,54103,15-19,388,403,791
33485,54103,20-24,358,399,757
33486,54103,25-29,398,411,809
33487,54103,30-34,353,377,730
33488,54103,35-39,329,377,706
33489,54103,40-44,410,373,783
33490,54103,45-49,425,400,825
33491,54103,50-54,503,507,1010
33492,54103,55-59,535,503,1038
33493,54103,60-64,542,574,1116
33494,54103,65+,1747,1458,3205
33495,54105,15-19,130,159,289
33496,54105,20-24,111,116,227
33497,54105,25-29,110,122,232
33498,54105,30-34,115,114,229
33499,54105,35-39,160,144,304
33500,54105,40-44,138,162,300
33501,54105,45-49,157,136,293
33502,54105,50-54,175,167,342
33503,54105,55-59,194,188,382
33504,54105,60-64,230,237,467
33505,54105,65+,535,583,1118
33506,54107,15-19,2333,2466,4799
33507,54107,20-24,2211,2211,4422
33508,54107,25-29,2371,2363,4734
33509,54107,30-34,2496,2374,4870
33510,54107,35-39,2396,2413,4809
33511,54107,40-44,2562,2548,5110
33512,54107,45-49,2548,2585,5133
33513,54107,50-54,2784,2809,5593
33514,54107,55-59,3061,2925,5986
33515,54107,60-64,3160,3012,6172
33516,54107,65+,9729,7845,17574
33517,54109,15-19,605,633,1238
33518,54109,20-24,520,558,1078
33519,54109,25-29,529,561,1090
33520,54109,30-34,572,563,1135
33521,54109,35-39,536,522,1058
33522,54109,40-44,699,641,1340
33523,54109,45-49,712,751,1463
33524,54109,50-54,675,688,1363
33525,54109,55-59,734,691,1425
33526,54109,60-64,795,802,1597
33527,54109,65+,2476,2328,4804
33528,55001,15-19,428,429,857
33529,55001,20-24,347,472,819
33530,55001,25-29,380,591,971
33531,55001,30-34,371,636,1007
33532,55001,35-39,401,619,1020
33533,55001,40-44,428,601,1029
33534,55001,45-49,464,590,1054
33535,55001,50-54,615,676,1291
33536,55001,55-59,883,949,1832
33537,55001,60-64,1063,1171,2234
33538,55001,65+,3111,3356,6467
33539,55003,15-19,555,563,1118
33540,55003,20-24,509,515,1024
33541,55003,25-29,397,446,843
33542,55003,30-34,392,471,863
33543,55003,35-39,449,473,922
33544,55003,40-44,466,448,914
33545,55003,45-49,374,413,787
33546,55003,50-54,469,478,947
33547,55003,55-59,604,581,1185
33548,55003,60-64,681,633,1314
33549,55003,65+,1722,1613,3335
33550,55005,15-19,1362,1387,2749
33551,55005,20-24,1065,1178,2243
33552,55005,25-29,1234,1303,2537
33553,55005,30-34,1139,1283,2422
33554,55005,35-39,1401,1411,2812
33555,55005,40-44,1291,1336,2627
33556,55005,45-49,1188,1324,2512
33557,55005,50-54,1355,1452,2807
33558,55005,55-59,1704,1730,3434
33559,55005,60-64,1879,1922,3801
33560,55005,65+,5527,5073,10600
33561,55007,15-19,353,408,761
33562,55007,20-24,305,358,663
33563,55007,25-29,320,354,674
33564,55007,30-34,312,327,639
33565,55007,35-39,407,398,805
33566,55007,40-44,411,418,829
33567,55007,45-49,369,405,774
33568,55007,50-54,524,513,1037
33569,55007,55-59,681,705,1386
33570,55007,60-64,816,839,1655
33571,55007,65+,2388,2448,4836
33572,55009,15-19,9146,9175,18321
33573,55009,20-24,8693,8729,17422
33574,55009,25-29,8713,9193,17906
33575,55009,30-34,8688,9142,17830
33576,55009,35-39,8840,9312,18152
33577,55009,40-44,8473,8882,17355
33578,55009,45-49,7521,7833,15354
33579,55009,50-54,8258,8529,16787
33580,55009,55-59,9302,9171,18473
33581,55009,60-64,8838,8671,17509
33582,55009,65+,23171,19605,42776
33583,55011,15-19,400,364,764
33584,55011,20-24,310,348,658
33585,55011,25-29,324,342,666
33586,55011,30-34,326,366,692
33587,55011,35-39,348,410,758
33588,55011,40-44,374,378,752
33589,55011,45-49,367,392,759
33590,55011,50-54,418,436,854
33591,55011,55-59,515,546,1061
33592,55011,60-64,539,563,1102
33593,55011,65+,1481,1570,3051
33594,55013,15-19,355,441,796
33595,55013,20-24,274,337,611
33596,55013,25-29,353,335,688
33597,55013,30-34,334,326,660
33598,55013,35-39,355,374,729
33599,55013,40-44,423,396,819
33600,55013,45-49,399,413,812
33601,55013,50-54,502,555,1057
33602,55013,55-59,726,705,1431
33603,55013,60-64,876,930,1806
33604,55013,65+,2484,2661,5145
33605,55015,15-19,1700,1844,3544
33606,55015,20-24,1362,1433,2795
33607,55015,25-29,1344,1411,2755
33608,55015,30-34,1517,1580,3097
33609,55015,35-39,1660,1711,3371
33610,55015,40-44,1798,1866,3664
33611,55015,45-49,1623,1687,3310
33612,55015,50-54,1894,1990,3884
33613,55015,55-59,1963,2092,4055
33614,55015,60-64,1827,1944,3771
33615,55015,65+,4593,4163,8756
33616,55017,15-19,1951,2051,4002
33617,55017,20-24,1589,1890,3479
33618,55017,25-29,1773,2244,4017
33619,55017,30-34,1850,2253,4103
33620,55017,35-39,2079,2522,4601
33621,55017,40-44,1912,2432,4344
33622,55017,45-49,1750,2116,3866
33623,55017,50-54,1995,2293,4288
33624,55017,55-59,2272,2595,4867
33625,55017,60-64,2457,2525,4982
33626,55017,65+,6527,6033,12560
33627,55019,15-19,1284,1391,2675
33628,55019,20-24,995,1010,2005
33629,55019,25-29,852,979,1831
33630,55019,30-34,792,834,1626
33631,55019,35-39,883,937,1820
33632,55019,40-44,907,959,1866
33633,55019,45-49,864,896,1760
33634,55019,50-54,954,1046,2000
33635,55019,55-59,1105,1183,2288
33636,55019,60-64,1114,1280,2394
33637,55019,65+,3072,2856,5928
33638,55021,15-19,1655,1822,3477
33639,55021,20-24,1412,1566,2978
33640,55021,25-29,1571,1835,3406
33641,55021,30-34,1670,1903,3573
33642,55021,35-39,1803,2054,3857
33643,55021,40-44,1758,2019,3777
33644,55021,45-49,1638,1794,3432
33645,55021,50-54,1925,2156,4081
33646,55021,55-59,2198,2340,4538
33647,55021,60-64,2231,2189,4420
33648,55021,65+,5702,5381,11083
33649,55023,15-19,466,556,1022
33650,55023,20-24,330,497,827
33651,55023,25-29,330,477,807
33652,55023,30-34,348,438,786
33653,55023,35-39,430,455,885
33654,55023,40-44,448,509,957
33655,55023,45-49,372,445,817
33656,55023,50-54,449,540,989
33657,55023,55-59,605,603,1208
33658,55023,60-64,658,684,1342
33659,55023,65+,1979,1918,3897
33660,55025,15-19,18736,18980,37716
33661,55025,20-24,28321,28627,56948
33662,55025,25-29,22119,24127,46246
33663,55025,30-34,19765,21177,40942
33664,55025,35-39,20072,21224,41296
33665,55025,40-44,18557,19150,37707
33666,55025,45-49,15395,15900,31295
33667,55025,50-54,16016,16086,32102
33668,55025,55-59,16602,15809,32411
33669,55025,60-64,16288,15324,31612
33670,55025,65+,45102,37648,82750
33671,55027,15-19,2489,2815,5304
33672,55027,20-24,2189,2842,5031
33673,55027,25-29,2290,3461,5751
33674,55027,30-34,2245,3269,5514
33675,55027,35-39,2602,3419,6021
33676,55027,40-44,2505,3368,5873
33677,55027,45-49,2443,2991,5434
33678,55027,50-54,2933,3310,6243
33679,55027,55-59,3279,3586,6865
33680,55027,60-64,3386,3631,7017
33681,55027,65+,8683,7709,16392
33682,55029,15-19,684,834,1518
33683,55029,20-24,614,607,1221
33684,55029,25-29,638,680,1318
33685,55029,30-34,659,633,1292
33686,55029,35-39,694,717,1411
33687,55029,40-44,752,841,1593
33688,55029,45-49,767,799,1566
33689,55029,50-54,851,918,1769
33690,55029,55-59,1191,1112,2303
33691,55029,60-64,1528,1510,3038
33692,55029,65+,4939,4498,9437
33693,55031,15-19,1268,1375,2643
33694,55031,20-24,1280,1344,2624
33695,55031,25-29,1325,1392,2717
33696,55031,30-34,1347,1410,2757
33697,55031,35-39,1438,1437,2875
33698,55031,40-44,1330,1396,2726
33699,55031,45-49,1216,1270,2486
33700,55031,50-54,1357,1436,2793
33701,55031,55-59,1653,1582,3235
33702,55031,60-64,1743,1736,3479
33703,55031,65+,4498,4349,8847
33704,55033,15-19,2164,2045,4209
33705,55033,20-24,2807,2933,5740
33706,55033,25-29,1286,1480,2766
33707,55033,30-34,1186,1317,2503
33708,55033,35-39,1311,1302,2613
33709,55033,40-44,1247,1319,2566
33710,55033,45-49,1136,1237,2373
33711,55033,50-54,1234,1355,2589
33712,55033,55-59,1286,1407,2693
33713,55033,60-64,1394,1497,2891
33714,55033,65+,3976,3483,7459
33715,55035,15-19,4188,3992,8180
33716,55035,20-24,6462,5903,12365
33717,55035,25-29,3543,3780,7323
33718,55035,30-34,3336,3639,6975
33719,55035,35-39,3356,3664,7020
33720,55035,40-44,2989,3232,6221
33721,55035,45-49,2552,2622,5174
33722,55035,50-54,2843,2881,5724
33723,55035,55-59,2982,3052,6034
33724,55035,60-64,3184,3101,6285
33725,55035,65+,9460,7968,17428
33726,55037,15-19,84,96,180
33727,55037,20-24,64,74,138
33728,55037,25-29,91,97,188
33729,55037,30-34,93,104,197
33730,55037,35-39,115,134,249
33731,55037,40-44,110,125,235
33732,55037,45-49,103,93,196
33733,55037,50-54,146,179,325
33734,55037,55-59,258,241,499
33735,55037,60-64,251,273,524
33736,55037,65+,662,673,1335
33737,55039,15-19,3370,3431,6801
33738,55039,20-24,3084,3145,6229
33739,55039,25-29,3078,3052,6130
33740,55039,30-34,3017,2992,6009
33741,55039,35-39,3280,3446,6726
33742,55039,40-44,3251,3309,6560
33743,55039,45-49,2879,2970,5849
33744,55039,50-54,3294,3433,6727
33745,55039,55-59,3785,3797,7582
33746,55039,60-64,3859,3864,7723
33747,55039,65+,10822,9284,20106
33748,55041,15-19,236,295,531
33749,55041,20-24,214,298,512
33750,55041,25-29,260,238,498
33751,55041,30-34,228,242,470
33752,55041,35-39,206,230,436
33753,55041,40-44,228,245,473
33754,55041,45-49,245,238,483
33755,55041,50-54,281,334,615
33756,55041,55-59,371,378,749
33757,55041,60-64,435,424,859
33758,55041,65+,1070,1096,2166
33759,55043,15-19,2183,2687,4870
33760,55043,20-24,2406,3474,5880
33761,55043,25-29,1363,1551,2914
33762,55043,30-34,1222,1501,2723
33763,55043,35-39,1305,1457,2762
33764,55043,40-44,1305,1455,2760
33765,55043,45-49,1197,1287,2484
33766,55043,50-54,1315,1392,2707
33767,55043,55-59,1583,1612,3195
33768,55043,60-64,1749,1791,3540
33769,55043,65+,5008,4295,9303
33770,55045,15-19,1172,1189,2361
33771,55045,20-24,872,853,1725
33772,55045,25-29,945,991,1936
33773,55045,30-34,1016,1012,2028
33774,55045,35-39,1100,1195,2295
33775,55045,40-44,1154,1174,2328
33776,55045,45-49,1060,1163,2223
33777,55045,50-54,1237,1275,2512
33778,55045,55-59,1358,1458,2816
33779,55045,60-64,1487,1512,2999
33780,55045,65+,3856,3490,7346
33781,55047,15-19,583,634,1217
33782,55047,20-24,444,538,982
33783,55047,25-29,435,467,902
33784,55047,30-34,478,475,953
33785,55047,35-39,510,539,1049
33786,55047,40-44,521,524,1045
33787,55047,45-49,465,552,1017
33788,55047,50-54,573,611,1184
33789,55047,55-59,696,780,1476
33790,55047,60-64,808,783,1591
33791,55047,65+,2309,2125,4434
33792,55049,15-19,707,741,1448
33793,55049,20-24,546,578,1124
33794,55049,25-29,542,622,1164
33795,55049,30-34,663,646,1309
33796,55049,35-39,732,763,1495
33797,55049,40-44,688,757,1445
33798,55049,45-49,692,700,1392
33799,55049,50-54,759,784,1543
33800,55049,55-59,946,948,1894
33801,55049,60-64,935,979,1914
33802,55049,65+,2481,2342,4823
33803,55051,15-19,141,161,302
33804,55051,20-24,99,100,199
33805,55051,25-29,110,120,230
33806,55051,30-34,144,130,274
33807,55051,35-39,138,134,272
33808,55051,40-44,148,143,291
33809,55051,45-49,155,184,339
33810,55051,50-54,183,195,378
33811,55051,55-59,240,243,483
33812,55051,60-64,321,355,676
33813,55051,65+,979,991,1970
33814,55053,15-19,567,628,1195
33815,55053,20-24,452,627,1079
33816,55053,25-29,496,781,1277
33817,55053,30-34,520,784,1304
33818,55053,35-39,525,733,1258
33819,55053,40-44,593,752,1345
33820,55053,45-49,528,657,1185
33821,55053,50-54,620,770,1390
33822,55053,55-59,759,806,1565
33823,55053,60-64,747,844,1591
33824,55053,65+,2072,2080,4152
33825,55055,15-19,3114,3282,6396
33826,55055,20-24,2375,2579,4954
33827,55055,25-29,2265,2359,4624
33828,55055,30-34,2427,2499,4926
33829,55055,35-39,2826,2736,5562
33830,55055,40-44,2668,2774,5442
33831,55055,45-49,2557,2767,5324
33832,55055,50-54,2838,2931,5769
33833,55055,55-59,3171,3225,6396
33834,55055,60-64,3152,3123,6275
33835,55055,65+,8168,7377,15545
33836,55057,15-19,694,788,1482
33837,55057,20-24,561,666,1227
33838,55057,25-29,684,888,1572
33839,55057,30-34,590,858,1448
33840,55057,35-39,694,955,1649
33841,55057,40-44,671,960,1631
33842,55057,45-49,703,957,1660
33843,55057,50-54,817,996,1813
33844,55057,55-59,970,1130,2100
33845,55057,60-64,1011,1175,2186
33846,55057,65+,2899,2808,5707
33847,55059,15-19,5821,5972,11793
33848,55059,20-24,5634,5692,11326
33849,55059,25-29,5405,5613,11018
33850,55059,30-34,5363,5522,10885
33851,55059,35-39,5423,5344,10767
33852,55059,40-44,5383,5245,10628
33853,55059,45-49,5193,5046,10239
33854,55059,50-54,5698,5902,11600
33855,55059,55-59,6438,6459,12897
33856,55059,60-64,5962,5819,11781
33857,55059,65+,13907,11678,25585
33858,55061,15-19,584,645,1229
33859,55061,20-24,498,519,1017
33860,55061,25-29,513,579,1092
33861,55061,30-34,499,526,1025
33862,55061,35-39,604,654,1258
33863,55061,40-44,590,666,1256
33864,55061,45-49,567,619,1186
33865,55061,50-54,644,704,1348
33866,55061,55-59,804,800,1604
33867,55061,60-64,749,851,1600
33868,55061,65+,2282,2154,4436
33869,55063,15-19,5092,4500,9592
33870,55063,20-24,7211,6351,13562
33871,55063,25-29,3935,4084,8019
33872,55063,30-34,3443,3748,7191
33873,55063,35-39,3562,3841,7403
33874,55063,40-44,3361,3527,6888
33875,55063,45-49,2985,3064,6049
33876,55063,50-54,3279,3464,6743
33877,55063,55-59,3663,3562,7225
33878,55063,60-64,3954,3662,7616
33879,55063,65+,11344,9601,20945
33880,55065,15-19,557,551,1108
33881,55065,20-24,415,458,873
33882,55065,25-29,439,455,894
33883,55065,30-34,427,454,881
33884,55065,35-39,469,528,997
33885,55065,40-44,452,445,897
33886,55065,45-49,407,430,837
33887,55065,50-54,498,519,1017
33888,55065,55-59,596,627,1223
33889,55065,60-64,652,675,1327
33890,55065,65+,1677,1669,3346
33891,55067,15-19,528,564,1092
33892,55067,20-24,440,477,917
33893,55067,25-29,451,488,939
33894,55067,30-34,410,471,881
33895,55067,35-39,525,516,1041
33896,55067,40-44,497,523,1020
33897,55067,45-49,493,504,997
33898,55067,50-54,564,630,1194
33899,55067,55-59,809,867,1676
33900,55067,60-64,896,914,1810
33901,55067,65+,2534,2348,4882
33902,55069,15-19,696,893,1589
33903,55069,20-24,601,715,1316
33904,55069,25-29,711,756,1467
33905,55069,30-34,668,713,1381
33906,55069,35-39,766,829,1595
33907,55069,40-44,808,875,1683
33908,55069,45-49,814,849,1663
33909,55069,50-54,1012,1056,2068
33910,55069,55-59,1220,1293,2513
33911,55069,60-64,1305,1427,2732
33912,55069,65+,3348,3100,6448
33913,55071,15-19,2299,2530,4829
33914,55071,20-24,2045,2124,4169
33915,55071,25-29,2190,2183,4373
33916,55071,30-34,2000,2146,4146
33917,55071,35-39,2302,2435,4737
33918,55071,40-44,2266,2522,4788
33919,55071,45-49,2201,2296,4497
33920,55071,50-54,2651,2833,5484
33921,55071,55-59,3185,3276,6461
33922,55071,60-64,3272,3406,6678
33923,55071,65+,9379,8368,17747
33924,55073,15-19,4077,4414,8491
33925,55073,20-24,3511,3814,7325
33926,55073,25-29,4047,4275,8322
33927,55073,30-34,3960,4125,8085
33928,55073,35-39,4359,4507,8866
33929,55073,40-44,4161,4354,8515
33930,55073,45-49,3856,4149,8005
33931,55073,50-54,4394,4581,8975
33932,55073,55-59,4866,5037,9903
33933,55073,60-64,4908,5082,9990
33934,55073,65+,13488,12134,25622
33935,55075,15-19,1097,1184,2281
33936,55075,20-24,879,965,1844
33937,55075,25-29,1014,1017,2031
33938,55075,30-34,956,1052,2008
33939,55075,35-39,1134,1160,2294
33940,55075,40-44,1133,1207,2340
33941,55075,45-49,1028,1109,2137
33942,55075,50-54,1262,1353,2615
33943,55075,55-59,1714,1782,3496
33944,55075,60-64,1925,2035,3960
33945,55075,65+,5337,5077,10414
33946,55077,15-19,417,419,836
33947,55077,20-24,296,361,657
33948,55077,25-29,327,336,663
33949,55077,30-34,348,373,721
33950,55077,35-39,414,415,829
33951,55077,40-44,406,429,835
33952,55077,45-49,396,440,836
33953,55077,50-54,463,519,982
33954,55077,55-59,645,699,1344
33955,55077,60-64,742,827,1569
33956,55077,65+,2063,1964,4027
33957,55078,15-19,184,180,364
33958,55078,20-24,132,130,262
33959,55078,25-29,121,125,246
33960,55078,30-34,132,122,254
33961,55078,35-39,106,99,205
33962,55078,40-44,115,82,197
33963,55078,45-49,101,77,178
33964,55078,50-54,122,97,219
33965,55078,55-59,152,118,270
33966,55078,60-64,143,150,293
33967,55078,65+,312,259,571
33968,55079,15-19,30458,31599,62057
33969,55079,20-24,31368,30389,61757
33970,55079,25-29,38553,37010,75563
33971,55079,30-34,37754,35791,73545
33972,55079,35-39,33491,31638,65129
33973,55079,40-44,30239,28431,58670
33974,55079,45-49,26260,24916,51176
33975,55079,50-54,26724,26229,52953
33976,55079,55-59,27782,26150,53932
33977,55079,60-64,28582,26273,54855
33978,55079,65+,74723,57920,132643
33979,55081,15-19,1431,1576,3007
33980,55081,20-24,1077,1235,2312
33981,55081,25-29,1185,1229,2414
33982,55081,30-34,1267,1323,2590
33983,55081,35-39,1495,1611,3106
33984,55081,40-44,1374,1599,2973
33985,55081,45-49,1223,1395,2618
33986,55081,50-54,1301,1481,2782
33987,55081,55-59,1533,1730,3263
33988,55081,60-64,1592,1700,3292
33989,55081,65+,4282,3942,8224
33990,55083,15-19,1055,1159,2214
33991,55083,20-24,799,869,1668
33992,55083,25-29,852,910,1762
33993,55083,30-34,1028,1057,2085
33994,55083,35-39,1078,1147,2225
33995,55083,40-44,1152,1287,2439
33996,55083,45-49,1093,1189,2282
33997,55083,50-54,1343,1362,2705
33998,55083,55-59,1646,1784,3430
33999,55083,60-64,1749,1916,3665
34000,55083,65+,4118,4319,8437
34001,55085,15-19,866,930,1796
34002,55085,20-24,746,818,1564
34003,55085,25-29,868,938,1806
34004,55085,30-34,865,986,1851
34005,55085,35-39,957,1016,1973
34006,55085,40-44,928,990,1918
34007,55085,45-49,909,1001,1910
34008,55085,50-54,1187,1240,2427
34009,55085,55-59,1723,1641,3364
34010,55085,60-64,1908,1975,3883
34011,55085,65+,5308,5141,10449
34012,55087,15-19,6110,6400,12510
34013,55087,20-24,5594,5917,11511
34014,55087,25-29,5856,6403,12259
34015,55087,30-34,6163,6447,12610
34016,55087,35-39,6550,6801,13351
34017,55087,40-44,6134,6488,12622
34018,55087,45-49,5393,5698,11091
34019,55087,50-54,6126,6159,12285
34020,55087,55-59,6767,6774,13541
34021,55087,60-64,6583,6396,12979
34022,55087,65+,16324,13905,30229
34023,55089,15-19,3026,3239,6265
34024,55089,20-24,2671,2681,5352
34025,55089,25-29,2098,2214,4312
34026,55089,30-34,2306,2380,4686
34027,55089,35-39,2892,2916,5808
34028,55089,40-44,2747,2863,5610
34029,55089,45-49,2656,2597,5253
34030,55089,50-54,3056,3153,6209
34031,55089,55-59,3496,3379,6875
34032,55089,60-64,3618,3462,7080
34033,55089,65+,10358,8829,19187
34034,55091,15-19,184,207,391
34035,55091,20-24,164,185,349
34036,55091,25-29,181,194,375
34037,55091,30-34,171,188,359
34038,55091,35-39,193,193,386
34039,55091,40-44,224,220,444
34040,55091,45-49,172,189,361
34041,55091,50-54,224,219,443
34042,55091,55-59,246,302,548
34043,55091,60-64,319,299,618
34044,55091,65+,860,868,1728
34045,55093,15-19,2106,1776,3882
34046,55093,20-24,2481,2016,4497
34047,55093,25-29,1110,1223,2333
34048,55093,30-34,1043,1138,2181
34049,55093,35-39,1293,1335,2628
34050,55093,40-44,1221,1264,2485
34051,55093,45-49,1148,1227,2375
34052,55093,50-54,1270,1317,2587
34053,55093,55-59,1418,1528,2946
34054,55093,60-64,1480,1527,3007
34055,55093,65+,3419,3312,6731
34056,55095,15-19,1280,1421,2701
34057,55095,20-24,1043,1141,2184
34058,55095,25-29,1130,1178,2308
34059,55095,30-34,1108,1087,2195
34060,55095,35-39,1280,1385,2665
34061,55095,40-44,1299,1353,2652
34062,55095,45-49,1281,1315,2596
34063,55095,50-54,1459,1601,3060
34064,55095,55-59,1913,1968,3881
34065,55095,60-64,1918,2008,3926
34066,55095,65+,5031,4897,9928
34067,55097,15-19,2747,2795,5542
34068,55097,20-24,3785,4109,7894
34069,55097,25-29,2145,2290,4435
34070,55097,30-34,1849,2110,3959
34071,55097,35-39,1959,2104,4063
34072,55097,40-44,1969,2080,4049
34073,55097,45-49,1738,1846,3584
34074,55097,50-54,1913,2028,3941
34075,55097,55-59,2299,2369,4668
34076,55097,60-64,2361,2390,4751
34077,55097,65+,6635,6030,12665
34078,55099,15-19,358,406,764
34079,55099,20-24,272,310,582
34080,55099,25-29,264,282,546
34081,55099,30-34,252,284,536
34082,55099,35-39,287,321,608
34083,55099,40-44,369,389,758
34084,55099,45-49,403,411,814
34085,55099,50-54,444,480,924
34086,55099,55-59,584,638,1222
34087,55099,60-64,670,767,1437
34088,55099,65+,1940,1985,3925
34089,55101,15-19,6020,6386,12406
34090,55101,20-24,5532,6316,11848
34091,55101,25-29,5666,6137,11803
34092,55101,30-34,5787,5954,11741
34093,55101,35-39,6205,6270,12475
34094,55101,40-44,6048,6135,12183
34095,55101,45-49,5543,5799,11342
34096,55101,50-54,6562,6428,12990
34097,55101,55-59,7294,7272,14566
34098,55101,60-64,7199,6975,14174
34099,55101,65+,18720,15670,34390
34100,55103,15-19,543,573,1116
34101,55103,20-24,410,454,864
34102,55103,25-29,398,429,827
34103,55103,30-34,400,434,834
34104,55103,35-39,446,449,895
34105,55103,40-44,434,495,929
34106,55103,45-49,441,523,964
34107,55103,50-54,529,534,1063
34108,55103,55-59,624,590,1214
34109,55103,60-64,677,705,1382
34110,55103,65+,2148,2062,4210
34111,55105,15-19,5305,5487,10792
34112,55105,20-24,4806,5011,9817
34113,55105,25-29,5065,5198,10263
34114,55105,30-34,4913,4974,9887
34115,55105,35-39,5359,5230,10589
34116,55105,40-44,5059,5253,10312
34117,55105,45-49,4843,4788,9631
34118,55105,50-54,5359,5424,10783
34119,55105,55-59,5897,5789,11686
34120,55105,60-64,5856,5727,11583
34121,55105,65+,15584,12923,28507
34122,55107,15-19,398,377,775
34123,55107,20-24,282,335,617
34124,55107,25-29,336,349,685
34125,55107,30-34,272,313,585
34126,55107,35-39,340,342,682
34127,55107,40-44,365,384,749
34128,55107,45-49,370,413,783
34129,55107,50-54,436,465,901
34130,55107,55-59,538,593,1131
34131,55107,60-64,587,643,1230
34132,55107,65+,1872,1754,3626
34133,55109,15-19,3062,3338,6400
34134,55109,20-24,2394,2567,4961
34135,55109,25-29,2548,2708,5256
34136,55109,30-34,2762,2828,5590
34137,55109,35-39,3269,3268,6537
34138,55109,40-44,3375,3406,6781
34139,55109,45-49,2967,3123,6090
34140,55109,50-54,3237,3463,6700
34141,55109,55-59,3423,3480,6903
34142,55109,60-64,3333,3347,6680
34143,55109,65+,7643,6940,14583
34144,55111,15-19,1977,2086,4063
34145,55111,20-24,1697,1745,3442
34146,55111,25-29,1769,1881,3650
34147,55111,30-34,1898,1954,3852
34148,55111,35-39,2092,2216,4308
34149,55111,40-44,1938,2134,4072
34150,55111,45-49,1824,1876,3700
34151,55111,50-54,2019,2167,4186
34152,55111,55-59,2376,2301,4677
34153,55111,60-64,2351,2413,4764
34154,55111,65+,6852,5962,12814
34155,55113,15-19,464,496,960
34156,55113,20-24,363,402,765
34157,55113,25-29,389,425,814
34158,55113,30-34,369,401,770
34159,55113,35-39,428,463,891
34160,55113,40-44,428,467,895
34161,55113,45-49,441,471,912
34162,55113,50-54,528,593,1121
34163,55113,55-59,724,776,1500
34164,55113,60-64,925,940,1865
34165,55113,65+,2458,2530,4988
34166,55115,15-19,1143,1342,2485
34167,55115,20-24,968,1019,1987
34168,55115,25-29,1012,1098,2110
34169,55115,30-34,1070,1054,2124
34170,55115,35-39,1132,1140,2272
34171,55115,40-44,1102,1152,2254
34172,55115,45-49,1161,1139,2300
34173,55115,50-54,1323,1450,2773
34174,55115,55-59,1628,1720,3348
34175,55115,60-64,1607,1688,3295
34176,55115,65+,4600,4240,8840
34177,55117,15-19,3540,3887,7427
34178,55117,20-24,3218,3698,6916
34179,55117,25-29,3393,3802,7195
34180,55117,30-34,3120,3473,6593
34181,55117,35-39,3525,3808,7333
34182,55117,40-44,3394,3757,7151
34183,55117,45-49,3298,3462,6760
34184,55117,50-54,3600,4061,7661
34185,55117,55-59,4250,4440,8690
34186,55117,60-64,4372,4402,8774
34187,55117,65+,12006,10389,22395
34188,55119,15-19,643,625,1268
34189,55119,20-24,430,494,924
34190,55119,25-29,452,507,959
34191,55119,30-34,469,479,948
34192,55119,35-39,536,555,1091
34193,55119,40-44,575,611,1186
34194,55119,45-49,564,584,1148
34195,55119,50-54,601,666,1267
34196,55119,55-59,786,787,1573
34197,55119,60-64,824,930,1754
34198,55119,65+,2085,1978,4063
34199,55121,15-19,911,1007,1918
34200,55121,20-24,700,764,1464
34201,55121,25-29,862,814,1676
34202,55121,30-34,751,804,1555
34203,55121,35-39,902,978,1880
34204,55121,40-44,884,927,1811
34205,55121,45-49,788,884,1672
34206,55121,50-54,986,1094,2080
34207,55121,55-59,1063,1182,2245
34208,55121,60-64,1013,1137,2150
34209,55121,65+,2956,2841,5797
34210,55123,15-19,1000,1160,2160
34211,55123,20-24,688,710,1398
34212,55123,25-29,680,721,1401
34213,55123,30-34,720,732,1452
34214,55123,35-39,886,847,1733
34215,55123,40-44,833,900,1733
34216,55123,45-49,778,840,1618
34217,55123,50-54,932,866,1798
34218,55123,55-59,1071,1113,2184
34219,55123,60-64,1203,1282,2485
34220,55123,65+,3191,3080,6271
34221,55125,15-19,531,551,1082
34222,55125,20-24,403,441,844
34223,55125,25-29,375,496,871
34224,55125,30-34,492,525,1017
34225,55125,35-39,474,538,1012
34226,55125,40-44,469,524,993
34227,55125,45-49,522,528,1050
34228,55125,50-54,684,748,1432
34229,55125,55-59,1036,1063,2099
34230,55125,60-64,1290,1302,2592
34231,55125,65+,3589,3682,7271
34232,55127,15-19,3831,4234,8065
34233,55127,20-24,4872,4969,9841
34234,55127,25-29,2789,3010,5799
34235,55127,30-34,2485,2804,5289
34236,55127,35-39,2931,3031,5962
34237,55127,40-44,2976,3000,5976
34238,55127,45-49,2947,2944,5891
34239,55127,50-54,3403,3426,6829
34240,55127,55-59,3919,3862,7781
34241,55127,60-64,3995,4079,8074
34242,55127,65+,10724,9665,20389
34243,55129,15-19,438,452,890
34244,55129,20-24,316,350,666
34245,55129,25-29,362,342,704
34246,55129,30-34,350,322,672
34247,55129,35-39,433,415,848
34248,55129,40-44,415,442,857
34249,55129,45-49,414,413,827
34250,55129,50-54,542,566,1108
34251,55129,55-59,698,722,1420
34252,55129,60-64,855,814,1669
34253,55129,65+,2328,2283,4611
34254,55131,15-19,4150,4387,8537
34255,55131,20-24,3417,3569,6986
34256,55131,25-29,3323,3586,6909
34257,55131,30-34,3653,3828,7481
34258,55131,35-39,4291,4352,8643
34259,55131,40-44,4242,4551,8793
34260,55131,45-49,3929,4224,8153
34261,55131,50-54,4937,5013,9950
34262,55131,55-59,5593,5700,11293
34263,55131,60-64,5267,5409,10676
34264,55131,65+,14056,12261,26317
34265,55133,15-19,12648,13662,26310
34266,55133,20-24,10881,10920,21801
34267,55133,25-29,10063,10433,20496
34268,55133,30-34,10959,11214,22173
34269,55133,35-39,13091,13339,26430
34270,55133,40-44,13218,13779,26997
34271,55133,45-49,12155,12413,24568
34272,55133,50-54,13727,13677,27404
34273,55133,55-59,15754,15254,31008
34274,55133,60-64,15970,15824,31794
34275,55133,65+,43589,36571,80160
34276,55135,15-19,1376,1583,2959
34277,55135,20-24,1198,1286,2484
34278,55135,25-29,1327,1364,2691
34279,55135,30-34,1316,1388,2704
34280,55135,35-39,1454,1554,3008
34281,55135,40-44,1504,1650,3154
34282,55135,45-49,1524,1542,3066
34283,55135,50-54,1715,1778,3493
34284,55135,55-59,2055,2201,4256
34285,55135,60-64,2141,2209,4350
34286,55135,65+,5588,5278,10866
34287,55137,15-19,638,659,1297
34288,55137,20-24,498,589,1087
34289,55137,25-29,477,668,1145
34290,55137,30-34,497,719,1216
34291,55137,35-39,598,807,1405
34292,55137,40-44,554,785,1339
34293,55137,45-49,569,743,1312
34294,55137,50-54,775,907,1682
34295,55137,55-59,1004,1119,2123
34296,55137,60-64,1114,1191,2305
34297,55137,65+,3096,3181,6277
34298,55139,15-19,5666,5708,11374
34299,55139,20-24,7254,7315,14569
34300,55139,25-29,5441,6306,11747
34301,55139,30-34,5111,5960,11071
34302,55139,35-39,5198,5908,11106
34303,55139,40-44,4900,5585,10485
34304,55139,45-49,4494,5180,9674
34305,55139,50-54,5105,5566,10671
34306,55139,55-59,5754,5896,11650
34307,55139,60-64,5764,5709,11473
34308,55139,65+,15893,13305,29198
34309,55141,15-19,2122,2204,4326
34310,55141,20-24,1855,1915,3770
34311,55141,25-29,2049,2065,4114
34312,55141,30-34,1948,2129,4077
34313,55141,35-39,2171,2238,4409
34314,55141,40-44,2034,2193,4227
34315,55141,45-49,1930,2030,3960
34316,55141,50-54,2361,2321,4682
34317,55141,55-59,2780,2772,5552
34318,55141,60-64,2954,2934,5888
34319,55141,65+,8551,7316,15867
34320,56001,15-19,1623,1658,3281
34321,56001,20-24,3703,4103,7806
34322,56001,25-29,1468,1921,3389
34323,56001,30-34,1073,1364,2437
34324,56001,35-39,1063,1150,2213
34325,56001,40-44,897,1090,1987
34326,56001,45-49,784,874,1658
34327,56001,50-54,750,804,1554
34328,56001,55-59,794,777,1571
34329,56001,60-64,917,929,1846
34330,56001,65+,2512,2372,4884
34331,56003,15-19,404,417,821
34332,56003,20-24,274,290,564
34333,56003,25-29,272,289,561
34334,56003,30-34,315,310,625
34335,56003,35-39,331,376,707
34336,56003,40-44,351,364,715
34337,56003,45-49,272,305,577
34338,56003,50-54,321,321,642
34339,56003,55-59,379,393,772
34340,56003,60-64,414,434,848
34341,56003,65+,1297,1235,2532
34342,56005,15-19,1595,1719,3314
34343,56005,20-24,1245,1358,2603
34344,56005,25-29,1420,1481,2901
34345,56005,30-34,1701,1662,3363
34346,56005,35-39,1719,2017,3736
34347,56005,40-44,1531,1700,3231
34348,56005,45-49,1323,1371,2694
34349,56005,50-54,1188,1315,2503
34350,56005,55-59,1392,1382,2774
34351,56005,60-64,1561,1731,3292
34352,56005,65+,2878,2791,5669
34353,56007,15-19,401,470,871
34354,56007,20-24,320,496,816
34355,56007,25-29,396,512,908
34356,56007,30-34,452,621,1073
34357,56007,35-39,465,597,1062
34358,56007,40-44,423,538,961
34359,56007,45-49,382,481,863
34360,56007,50-54,343,424,767
34361,56007,55-59,453,457,910
34362,56007,60-64,483,575,1058
34363,56007,65+,1281,1325,2606
34364,56009,15-19,413,426,839
34365,56009,20-24,336,334,670
34366,56009,25-29,398,406,804
34367,56009,30-34,446,439,885
34368,56009,35-39,420,468,888
34369,56009,40-44,388,427,815
34370,56009,45-49,373,388,761
34371,56009,50-54,383,440,823
34372,56009,55-59,437,476,913
34373,56009,60-64,502,527,1029
34374,56009,65+,1240,1242,2482
34375,56011,15-19,218,223,441
34376,56011,20-24,137,151,288
34377,56011,25-29,143,170,313
34378,56011,30-34,205,218,423
34379,56011,35-39,185,194,379
34380,56011,40-44,175,230,405
34381,56011,45-49,171,164,335
34382,56011,50-54,222,223,445
34383,56011,55-59,264,262,526
34384,56011,60-64,317,323,640
34385,56011,65+,801,790,1591
34386,56013,15-19,1264,1413,2677
34387,56013,20-24,978,1142,2120
34388,56013,25-29,1017,1042,2059
34389,56013,30-34,1144,1161,2305
34390,56013,35-39,1271,1247,2518
34391,56013,40-44,1130,1206,2336
34392,56013,45-49,972,1020,1992
34393,56013,50-54,1073,1128,2201
34394,56013,55-59,1167,1220,2387
34395,56013,60-64,1427,1398,2825
34396,56013,65+,4031,3663,7694
34397,56015,15-19,398,400,798
34398,56015,20-24,368,450,818
34399,56015,25-29,287,383,670
34400,56015,30-34,315,432,747
34401,56015,35-39,327,417,744
34402,56015,40-44,311,426,737
34403,56015,45-49,281,405,686
34404,56015,50-54,300,429,729
34405,56015,55-59,350,428,778
34406,56015,60-64,468,472,940
34407,56015,65+,1498,1381,2879
34408,56017,15-19,129,133,262
34409,56017,20-24,92,91,183
34410,56017,25-29,100,104,204
34411,56017,30-34,109,110,219
34412,56017,35-39,111,115,226
34413,56017,40-44,119,123,242
34414,56017,45-49,118,120,238
34415,56017,50-54,117,120,237
34416,56017,55-59,147,168,315
34417,56017,60-64,194,188,382
34418,56017,65+,668,624,1292
34419,56019,15-19,245,270,515
34420,56019,20-24,173,174,347
34421,56019,25-29,184,190,374
34422,56019,30-34,200,203,403
34423,56019,35-39,276,244,520
34424,56019,40-44,248,254,502
34425,56019,45-49,225,248,473
34426,56019,50-54,263,234,497
34427,56019,55-59,292,270,562
34428,56019,60-64,340,325,665
34429,56019,65+,1117,1180,2297
34430,56021,15-19,3030,3265,6295
34431,56021,20-24,3027,3722,6749
34432,56021,25-29,3347,3627,6974
34433,56021,30-34,3509,3784,7293
34434,56021,35-39,3485,3702,7187
34435,56021,40-44,2951,3232,6183
34436,56021,45-49,2651,2811,5462
34437,56021,50-54,2786,2940,5726
34438,56021,55-59,3111,3226,6337
34439,56021,60-64,3317,3236,6553
34440,56021,65+,9146,8037,17183
34441,56023,15-19,671,746,1417
34442,56023,20-24,428,490,918
34443,56023,25-29,455,470,925
34444,56023,30-34,502,509,1011
34445,56023,35-39,591,607,1198
34446,56023,40-44,704,729,1433
34447,56023,45-49,554,643,1197
34448,56023,50-54,569,585,1154
34449,56023,55-59,627,672,1299
34450,56023,60-64,777,754,1531
34451,56023,65+,1899,2002,3901
34452,56025,15-19,2504,2670,5174
34453,56025,20-24,2095,2241,4336
34454,56025,25-29,2520,2609,5129
34455,56025,30-34,2796,2948,5744
34456,56025,35-39,2809,3061,5870
34457,56025,40-44,2643,2749,5392
34458,56025,45-49,2149,2279,4428
34459,56025,50-54,2145,2281,4426
34460,56025,55-59,2380,2355,4735
34461,56025,60-64,2685,2748,5433
34462,56025,65+,6942,6193,13135
34463,56027,15-19,42,56,98
34464,56027,20-24,97,48,145
34465,56027,25-29,106,51,157
34466,56027,30-34,113,56,169
34467,56027,35-39,91,53,144
34468,56027,40-44,79,75,154
34469,56027,45-49,102,53,155
34470,56027,50-54,67,58,125
34471,56027,55-59,78,56,134
34472,56027,60-64,97,97,194
34473,56027,65+,293,316,609
34474,56029,15-19,832,950,1782
34475,56029,20-24,704,759,1463
34476,56029,25-29,779,707,1486
34477,56029,30-34,818,868,1686
34478,56029,35-39,893,912,1805
34479,56029,40-44,842,863,1705
34480,56029,45-49,764,787,1551
34481,56029,50-54,821,820,1641
34482,56029,55-59,1021,942,1963
34483,56029,60-64,1258,1215,2473
34484,56029,65+,3806,3684,7490
34485,56031,15-19,228,232,460
34486,56031,20-24,172,202,374
34487,56031,25-29,203,218,421
34488,56031,30-34,195,238,433
34489,56031,35-39,259,243,502
34490,56031,40-44,199,234,433
34491,56031,45-49,224,224,448
34492,56031,50-54,257,253,510
34493,56031,55-59,302,315,617
34494,56031,60-64,355,353,708
34495,56031,65+,1164,1145,2309
34496,56033,15-19,973,1022,1995
34497,56033,20-24,815,837,1652
34498,56033,25-29,817,888,1705
34499,56033,30-34,919,957,1876
34500,56033,35-39,1025,1008,2033
34501,56033,40-44,971,1017,1988
34502,56033,45-49,854,943,1797
34503,56033,50-54,909,980,1889
34504,56033,55-59,1005,989,1994
34505,56033,60-64,1216,1147,2363
34506,56033,65+,3566,3376,6942
34507,56035,15-19,226,285,511
34508,56035,20-24,177,201,378
34509,56035,25-29,187,218,405
34510,56035,30-34,243,254,497
34511,56035,35-39,256,316,572
34512,56035,40-44,298,302,600
34513,56035,45-49,252,333,585
34514,56035,50-54,235,287,522
34515,56035,55-59,263,293,556
34516,56035,60-64,301,360,661
34517,56035,65+,878,1045,1923
34518,56037,15-19,1513,1572,3085
34519,56037,20-24,1200,1307,2507
34520,56037,25-29,1236,1249,2485
34521,56037,30-34,1362,1523,2885
34522,56037,35-39,1536,1593,3129
34523,56037,40-44,1489,1604,3093
34524,56037,45-49,1176,1332,2508
34525,56037,50-54,1093,1245,2338
34526,56037,55-59,1162,1267,2429
34527,56037,60-64,1292,1431,2723
34528,56037,65+,2916,2970,5886
34529,56039,15-19,488,580,1068
34530,56039,20-24,588,614,1202
34531,56039,25-29,890,915,1805
34532,56039,30-34,922,1088,2010
34533,56039,35-39,933,1110,2043
34534,56039,40-44,880,961,1841
34535,56039,45-49,737,945,1682
34536,56039,50-54,737,853,1590
34537,56039,55-59,678,700,1378
34538,56039,60-64,774,778,1552
34539,56039,65+,1926,2058,3984
34540,56041,15-19,767,820,1587
34541,56041,20-24,501,563,1064
34542,56041,25-29,588,546,1134
34543,56041,30-34,632,612,1244
34544,56041,35-39,674,717,1391
34545,56041,40-44,709,688,1397
34546,56041,45-49,567,667,1234
34547,56041,50-54,523,551,1074
34548,56041,55-59,583,558,1141
34549,56041,60-64,689,754,1443
34550,56041,65+,1636,1644,3280
34551,56043,15-19,246,307,553
34552,56043,20-24,169,190,359
34553,56043,25-29,166,180,346
34554,56043,30-34,196,217,413
34555,56043,35-39,222,239,461
34556,56043,40-44,233,270,503
34557,56043,45-49,222,223,445
34558,56043,50-54,209,257,466
34559,56043,55-59,257,269,526
34560,56043,60-64,306,284,590
34561,56043,65+,916,870,1786
34562,56045,15-19,185,202,387
34563,56045,20-24,111,172,283
34564,56045,25-29,124,182,306
34565,56045,30-34,159,205,364
34566,56045,35-39,235,253,488
34567,56045,40-44,198,265,463
34568,56045,45-49,155,192,347
34569,56045,50-54,170,210,380
34570,56045,55-59,234,290,524
34571,56045,60-64,273,305,578
34572,56045,65+,767,756,1523
