,CBSA,AGE,FEMALE,MALE,TOTAL,NAME,INTPTLAT,INTPTLONG,POPESTIMATE
0,10100,15-19,1457,1360,2817,"Aberdeen, SD",45.519435,-98.7007,42134
1,10100,20-24,1527,1273,2800,"Aberdeen, SD",45.519435,-98.7007,42134
2,10100,25-29,1226,1350,2576,"Aberdeen, SD",45.519435,-98.7007,42134
3,10100,30-34,1290,1334,2624,"Aberdeen, SD",45.519435,-98.7007,42134
4,10100,35-39,1261,1492,2753,"Aberdeen, SD",45.519435,-98.7007,42134
5,10100,40-44,1239,1256,2495,"Aberdeen, SD",45.519435,-98.7007,42134
6,10100,45-49,1032,1072,2104,"Aberdeen, SD",45.519435,-98.7007,42134
7,10100,50-54,1117,1216,2333,"Aberdeen, SD",45.519435,-98.7007,42134
8,10100,55-59,1316,1411,2727,"Aberdeen, SD",45.519435,-98.7007,42134
9,10100,60-64,1464,1402,2866,"Aberdeen, SD",45.519435,-98.7007,42134
10,10100,65+,4250,3490,7740,"Aberdeen, SD",45.519435,-98.7007,42134
11,10140,15-19,1995,2135,4130,"Aberdeen, WA",47.113732,-123.826735,76841
12,10140,20-24,1696,2082,3778,"Aberdeen, WA",47.113732,-123.826735,76841
13,10140,25-29,1880,2290,4170,"Aberdeen, WA",47.113732,-123.826735,76841
14,10140,30-34,2196,2561,4757,"Aberdeen, WA",47.113732,-123.826735,76841
15,10140,35-39,2130,2494,4624,"Aberdeen, WA",47.113732,-123.826735,76841
16,10140,40-44,2182,2388,4570,"Aberdeen, WA",47.113732,-123.826735,76841
17,10140,45-49,1890,2288,4178,"Aberdeen, WA",47.113732,-123.826735,76841
18,10140,50-54,2226,2454,4680,"Aberdeen, WA",47.113732,-123.826735,76841
19,10140,55-59,2635,2695,5330,"Aberdeen, WA",47.113732,-123.826735,76841
20,10140,60-64,3151,3038,6189,"Aberdeen, WA",47.113732,-123.826735,76841
21,10140,65+,9115,8519,17634,"Aberdeen, WA",47.113732,-123.826735,76841
22,10180,15-19,6452,6594,13046,"Abilene, TX",32.452022,-99.718743,177314
23,10180,20-24,7943,8709,16652,"Abilene, TX",32.452022,-99.718743,177314
24,10180,25-29,6006,6983,12989,"Abilene, TX",32.452022,-99.718743,177314
25,10180,30-34,5744,6581,12325,"Abilene, TX",32.452022,-99.718743,177314
26,10180,35-39,5764,6574,12338,"Abilene, TX",32.452022,-99.718743,177314
27,10180,40-44,4778,5443,10221,"Abilene, TX",32.452022,-99.718743,177314
28,10180,45-49,4234,4692,8926,"Abilene, TX",32.452022,-99.718743,177314
29,10180,50-54,4389,4526,8915,"Abilene, TX",32.452022,-99.718743,177314
30,10180,55-59,4820,4782,9602,"Abilene, TX",32.452022,-99.718743,177314
31,10180,60-64,5111,4739,9850,"Abilene, TX",32.452022,-99.718743,177314
32,10180,65+,15107,12100,27207,"Abilene, TX",32.452022,-99.718743,177314
33,10220,15-19,1422,1365,2787,"Ada, OK",34.721415,-96.69178,38163
34,10220,20-24,1446,1437,2883,"Ada, OK",34.721415,-96.69178,38163
35,10220,25-29,1321,1172,2493,"Ada, OK",34.721415,-96.69178,38163
36,10220,30-34,1335,1266,2601,"Ada, OK",34.721415,-96.69178,38163
37,10220,35-39,1174,1266,2440,"Ada, OK",34.721415,-96.69178,38163
38,10220,40-44,1133,1131,2264,"Ada, OK",34.721415,-96.69178,38163
39,10220,45-49,1029,951,1980,"Ada, OK",34.721415,-96.69178,38163
40,10220,50-54,1021,1010,2031,"Ada, OK",34.721415,-96.69178,38163
41,10220,55-59,1172,1068,2240,"Ada, OK",34.721415,-96.69178,38163
42,10220,60-64,1172,1104,2276,"Ada, OK",34.721415,-96.69178,38163
43,10220,65+,3551,2756,6307,"Ada, OK",34.721415,-96.69178,38163
44,10300,15-19,3156,3532,6688,"Adrian, MI",41.896022,-84.074356,98956
45,10300,20-24,2822,3320,6142,"Adrian, MI",41.896022,-84.074356,98956
46,10300,25-29,2658,3057,5715,"Adrian, MI",41.896022,-84.074356,98956
47,10300,30-34,2772,3053,5825,"Adrian, MI",41.896022,-84.074356,98956
48,10300,35-39,2776,3114,5890,"Adrian, MI",41.896022,-84.074356,98956
49,10300,40-44,2804,3151,5955,"Adrian, MI",41.896022,-84.074356,98956
50,10300,45-49,2784,3102,5886,"Adrian, MI",41.896022,-84.074356,98956
51,10300,50-54,3220,3437,6657,"Adrian, MI",41.896022,-84.074356,98956
52,10300,55-59,3438,3415,6853,"Adrian, MI",41.896022,-84.074356,98956
53,10300,60-64,3616,3556,7172,"Adrian, MI",41.896022,-84.074356,98956
54,10300,65+,10543,8973,19516,"Adrian, MI",41.896022,-84.074356,98956
55,10420,15-19,22274,22232,44506,"Akron, OH",41.146639,-81.35011,700015
56,10420,20-24,25181,24416,49597,"Akron, OH",41.146639,-81.35011,700015
57,10420,25-29,22966,23117,46083,"Akron, OH",41.146639,-81.35011,700015
58,10420,30-34,22585,22270,44855,"Akron, OH",41.146639,-81.35011,700015
59,10420,35-39,21353,21217,42570,"Akron, OH",41.146639,-81.35011,700015
60,10420,40-44,20670,20415,41085,"Akron, OH",41.146639,-81.35011,700015
61,10420,45-49,19908,19636,39544,"Akron, OH",41.146639,-81.35011,700015
62,10420,50-54,23264,22710,45974,"Akron, OH",41.146639,-81.35011,700015
63,10420,55-59,24987,23838,48825,"Akron, OH",41.146639,-81.35011,700015
64,10420,60-64,25988,24476,50464,"Akron, OH",41.146639,-81.35011,700015
65,10420,65+,71940,58419,130359,"Akron, OH",41.146639,-81.35011,700015
66,10460,15-19,1989,2151,4140,"Alamogordo, NM",32.615599,-105.751308,68537
67,10460,20-24,2138,3232,5370,"Alamogordo, NM",32.615599,-105.751308,68537
68,10460,25-29,2207,3036,5243,"Alamogordo, NM",32.615599,-105.751308,68537
69,10460,30-34,2262,2827,5089,"Alamogordo, NM",32.615599,-105.751308,68537
70,10460,35-39,2163,2467,4630,"Alamogordo, NM",32.615599,-105.751308,68537
71,10460,40-44,1836,1982,3818,"Alamogordo, NM",32.615599,-105.751308,68537
72,10460,45-49,1641,1687,3328,"Alamogordo, NM",32.615599,-105.751308,68537
73,10460,50-54,1759,1708,3467,"Alamogordo, NM",32.615599,-105.751308,68537
74,10460,55-59,2034,1916,3950,"Alamogordo, NM",32.615599,-105.751308,68537
75,10460,60-64,2205,2165,4370,"Alamogordo, NM",32.615599,-105.751308,68537
76,10460,65+,6362,5770,12132,"Alamogordo, NM",32.615599,-105.751308,68537
77,10500,15-19,5489,5437,10926,"Albany, GA",31.644686,-84.110718,147773
78,10500,20-24,5250,4924,10174,"Albany, GA",31.644686,-84.110718,147773
79,10500,25-29,4876,4389,9265,"Albany, GA",31.644686,-84.110718,147773
80,10500,30-34,5233,4647,9880,"Albany, GA",31.644686,-84.110718,147773
81,10500,35-39,4770,4225,8995,"Albany, GA",31.644686,-84.110718,147773
82,10500,40-44,4735,4191,8926,"Albany, GA",31.644686,-84.110718,147773
83,10500,45-49,4484,4059,8543,"Albany, GA",31.644686,-84.110718,147773
84,10500,50-54,4587,4140,8727,"Albany, GA",31.644686,-84.110718,147773
85,10500,55-59,4995,4238,9233,"Albany, GA",31.644686,-84.110718,147773
86,10500,60-64,4984,4248,9232,"Albany, GA",31.644686,-84.110718,147773
87,10500,65+,14046,10735,24781,"Albany, GA",31.644686,-84.110718,147773
88,10540,15-19,3648,3999,7647,"Albany-Lebanon, OR",44.488898,-122.537208,129839
89,10540,20-24,3634,3619,7253,"Albany-Lebanon, OR",44.488898,-122.537208,129839
90,10540,25-29,4281,4392,8673,"Albany-Lebanon, OR",44.488898,-122.537208,129839
91,10540,30-34,4551,4515,9066,"Albany-Lebanon, OR",44.488898,-122.537208,129839
92,10540,35-39,4305,4362,8667,"Albany-Lebanon, OR",44.488898,-122.537208,129839
93,10540,40-44,3915,3938,7853,"Albany-Lebanon, OR",44.488898,-122.537208,129839
94,10540,45-49,3566,3659,7225,"Albany-Lebanon, OR",44.488898,-122.537208,129839
95,10540,50-54,3796,3909,7705,"Albany-Lebanon, OR",44.488898,-122.537208,129839
96,10540,55-59,4204,4051,8255,"Albany-Lebanon, OR",44.488898,-122.537208,129839
97,10540,60-64,4470,4225,8695,"Albany-Lebanon, OR",44.488898,-122.537208,129839
98,10540,65+,13211,11658,24869,"Albany-Lebanon, OR",44.488898,-122.537208,129839
99,10580,15-19,28898,29529,58427,"Albany-Schenectady-Troy, NY",42.78792,-73.942348,899286
100,10580,20-24,33629,33744,67373,"Albany-Schenectady-Troy, NY",42.78792,-73.942348,899286
101,10580,25-29,28880,29416,58296,"Albany-Schenectady-Troy, NY",42.78792,-73.942348,899286
102,10580,30-34,29317,29451,58768,"Albany-Schenectady-Troy, NY",42.78792,-73.942348,899286
103,10580,35-39,28999,29114,58113,"Albany-Schenectady-Troy, NY",42.78792,-73.942348,899286
104,10580,40-44,27242,27213,54455,"Albany-Schenectady-Troy, NY",42.78792,-73.942348,899286
105,10580,45-49,25706,25208,50914,"Albany-Schenectady-Troy, NY",42.78792,-73.942348,899286
106,10580,50-54,29339,29336,58675,"Albany-Schenectady-Troy, NY",42.78792,-73.942348,899286
107,10580,55-59,32700,30951,63651,"Albany-Schenectady-Troy, NY",42.78792,-73.942348,899286
108,10580,60-64,31991,30447,62438,"Albany-Schenectady-Troy, NY",42.78792,-73.942348,899286
109,10580,65+,91177,74812,165989,"Albany-Schenectady-Troy, NY",42.78792,-73.942348,899286
110,10620,15-19,1920,1945,3865,"Albemarle, NC",35.310449,-80.254374,63425
111,10620,20-24,1710,1926,3636,"Albemarle, NC",35.310449,-80.254374,63425
112,10620,25-29,1937,2043,3980,"Albemarle, NC",35.310449,-80.254374,63425
113,10620,30-34,2018,2210,4228,"Albemarle, NC",35.310449,-80.254374,63425
114,10620,35-39,1873,1928,3801,"Albemarle, NC",35.310449,-80.254374,63425
115,10620,40-44,1762,1824,3586,"Albemarle, NC",35.310449,-80.254374,63425
116,10620,45-49,1774,1894,3668,"Albemarle, NC",35.310449,-80.254374,63425
117,10620,50-54,2140,2162,4302,"Albemarle, NC",35.310449,-80.254374,63425
118,10620,55-59,2229,2376,4605,"Albemarle, NC",35.310449,-80.254374,63425
119,10620,60-64,2166,2103,4269,"Albemarle, NC",35.310449,-80.254374,63425
120,10620,65+,6647,5560,12207,"Albemarle, NC",35.310449,-80.254374,63425
121,10660,15-19,913,989,1902,"Albert Lea, MN",43.674202,-93.350289,30749
122,10660,20-24,747,767,1514,"Albert Lea, MN",43.674202,-93.350289,30749
123,10660,25-29,847,816,1663,"Albert Lea, MN",43.674202,-93.350289,30749
124,10660,30-34,846,847,1693,"Albert Lea, MN",43.674202,-93.350289,30749
125,10660,35-39,902,946,1848,"Albert Lea, MN",43.674202,-93.350289,30749
126,10660,40-44,801,910,1711,"Albert Lea, MN",43.674202,-93.350289,30749
127,10660,45-49,779,830,1609,"Albert Lea, MN",43.674202,-93.350289,30749
128,10660,50-54,821,875,1696,"Albert Lea, MN",43.674202,-93.350289,30749
129,10660,55-59,1073,1088,2161,"Albert Lea, MN",43.674202,-93.350289,30749
130,10660,60-64,1181,1260,2441,"Albert Lea, MN",43.674202,-93.350289,30749
131,10660,65+,3770,3240,7010,"Albert Lea, MN",43.674202,-93.350289,30749
132,10700,15-19,3247,3391,6638,"Albertville, AL",34.309564,-86.321668,98228
133,10700,20-24,2658,2879,5537,"Albertville, AL",34.309564,-86.321668,98228
134,10700,25-29,2872,3000,5872,"Albertville, AL",34.309564,-86.321668,98228
135,10700,30-34,3010,3026,6036,"Albertville, AL",34.309564,-86.321668,98228
136,10700,35-39,2892,2979,5871,"Albertville, AL",34.309564,-86.321668,98228
137,10700,40-44,2817,2883,5700,"Albertville, AL",34.309564,-86.321668,98228
138,10700,45-49,2897,2823,5720,"Albertville, AL",34.309564,-86.321668,98228
139,10700,50-54,3089,3282,6371,"Albertville, AL",34.309564,-86.321668,98228
140,10700,55-59,3257,3168,6425,"Albertville, AL",34.309564,-86.321668,98228
141,10700,60-64,3252,3169,6421,"Albertville, AL",34.309564,-86.321668,98228
142,10700,65+,9465,7429,16894,"Albertville, AL",34.309564,-86.321668,98228
143,10740,15-19,28983,30144,59127,"Albuquerque, NM",35.123496,-106.458392,918259
144,10740,20-24,28018,29125,57143,"Albuquerque, NM",35.123496,-106.458392,918259
145,10740,25-29,30499,31806,62305,"Albuquerque, NM",35.123496,-106.458392,918259
146,10740,30-34,32231,33281,65512,"Albuquerque, NM",35.123496,-106.458392,918259
147,10740,35-39,32070,32983,65053,"Albuquerque, NM",35.123496,-106.458392,918259
148,10740,40-44,29210,29785,58995,"Albuquerque, NM",35.123496,-106.458392,918259
149,10740,45-49,26675,26770,53445,"Albuquerque, NM",35.123496,-106.458392,918259
150,10740,50-54,27503,27010,54513,"Albuquerque, NM",35.123496,-106.458392,918259
151,10740,55-59,29911,28499,58410,"Albuquerque, NM",35.123496,-106.458392,918259
152,10740,60-64,31450,28851,60301,"Albuquerque, NM",35.123496,-106.458392,918259
153,10740,65+,89719,73943,163662,"Albuquerque, NM",35.123496,-106.458392,918259
154,10760,15-19,1307,1374,2681,"Alexander City, AL",32.900486,-86.002932,51473
155,10760,20-24,1312,1345,2657,"Alexander City, AL",32.900486,-86.002932,51473
156,10760,25-29,1423,1487,2910,"Alexander City, AL",32.900486,-86.002932,51473
157,10760,30-34,1473,1439,2912,"Alexander City, AL",32.900486,-86.002932,51473
158,10760,35-39,1354,1231,2585,"Alexander City, AL",32.900486,-86.002932,51473
159,10760,40-44,1384,1312,2696,"Alexander City, AL",32.900486,-86.002932,51473
160,10760,45-49,1572,1383,2955,"Alexander City, AL",32.900486,-86.002932,51473
161,10760,50-54,1888,1760,3648,"Alexander City, AL",32.900486,-86.002932,51473
162,10760,55-59,1989,1995,3984,"Alexander City, AL",32.900486,-86.002932,51473
163,10760,60-64,2177,2068,4245,"Alexander City, AL",32.900486,-86.002932,51473
164,10760,65+,6272,5649,11921,"Alexander City, AL",32.900486,-86.002932,51473
165,10780,15-19,4700,5093,9793,"Alexandria, LA",31.325348,-92.546803,150890
166,10780,20-24,4448,4700,9148,"Alexandria, LA",31.325348,-92.546803,150890
167,10780,25-29,4590,5389,9979,"Alexandria, LA",31.325348,-92.546803,150890
168,10780,30-34,4796,5423,10219,"Alexandria, LA",31.325348,-92.546803,150890
169,10780,35-39,4798,5262,10060,"Alexandria, LA",31.325348,-92.546803,150890
170,10780,40-44,4690,4793,9483,"Alexandria, LA",31.325348,-92.546803,150890
171,10780,45-49,4243,4190,8433,"Alexandria, LA",31.325348,-92.546803,150890
172,10780,50-54,4542,4338,8880,"Alexandria, LA",31.325348,-92.546803,150890
173,10780,55-59,5106,4658,9764,"Alexandria, LA",31.325348,-92.546803,150890
174,10780,60-64,4985,4726,9711,"Alexandria, LA",31.325348,-92.546803,150890
175,10780,65+,14142,11138,25280,"Alexandria, LA",31.325348,-92.546803,150890
176,10820,15-19,1080,1200,2280,"Alexandria, MN",45.936835,-95.462155,39238
177,10820,20-24,898,1010,1908,"Alexandria, MN",45.936835,-95.462155,39238
178,10820,25-29,987,1075,2062,"Alexandria, MN",45.936835,-95.462155,39238
179,10820,30-34,1049,1132,2181,"Alexandria, MN",45.936835,-95.462155,39238
180,10820,35-39,1168,1281,2449,"Alexandria, MN",45.936835,-95.462155,39238
181,10820,40-44,1087,1177,2264,"Alexandria, MN",45.936835,-95.462155,39238
182,10820,45-49,972,989,1961,"Alexandria, MN",45.936835,-95.462155,39238
183,10820,50-54,1100,1121,2221,"Alexandria, MN",45.936835,-95.462155,39238
184,10820,55-59,1324,1332,2656,"Alexandria, MN",45.936835,-95.462155,39238
185,10820,60-64,1587,1530,3117,"Alexandria, MN",45.936835,-95.462155,39238
186,10820,65+,4779,4376,9155,"Alexandria, MN",45.936835,-95.462155,39238
187,10860,15-19,1656,1904,3560,"Alice, TX",27.697743,-98.390881,48603
188,10860,20-24,1494,1684,3178,"Alice, TX",27.697743,-98.390881,48603
189,10860,25-29,1455,1573,3028,"Alice, TX",27.697743,-98.390881,48603
190,10860,30-34,1518,1591,3109,"Alice, TX",27.697743,-98.390881,48603
191,10860,35-39,1528,1626,3154,"Alice, TX",27.697743,-98.390881,48603
192,10860,40-44,1434,1521,2955,"Alice, TX",27.697743,-98.390881,48603
193,10860,45-49,1328,1362,2690,"Alice, TX",27.697743,-98.390881,48603
194,10860,50-54,1374,1228,2602,"Alice, TX",27.697743,-98.390881,48603
195,10860,55-59,1446,1349,2795,"Alice, TX",27.697743,-98.390881,48603
196,10860,60-64,1414,1354,2768,"Alice, TX",27.697743,-98.390881,48603
197,10860,65+,4244,3592,7836,"Alice, TX",27.697743,-98.390881,48603
198,10900,15-19,27836,29359,57195,"Allentown-Bethlehem-Easton, PA-NJ",40.789339,-75.398158,865310
199,10900,20-24,26443,27416,53859,"Allentown-Bethlehem-Easton, PA-NJ",40.789339,-75.398158,865310
200,10900,25-29,25517,26436,51953,"Allentown-Bethlehem-Easton, PA-NJ",40.789339,-75.398158,865310
201,10900,30-34,27206,28017,55223,"Allentown-Bethlehem-Easton, PA-NJ",40.789339,-75.398158,865310
202,10900,35-39,26809,27692,54501,"Allentown-Bethlehem-Easton, PA-NJ",40.789339,-75.398158,865310
203,10900,40-44,26377,26581,52958,"Allentown-Bethlehem-Easton, PA-NJ",40.789339,-75.398158,865310
204,10900,45-49,25702,25473,51175,"Allentown-Bethlehem-Easton, PA-NJ",40.789339,-75.398158,865310
205,10900,50-54,28725,28736,57461,"Allentown-Bethlehem-Easton, PA-NJ",40.789339,-75.398158,865310
206,10900,55-59,30737,30456,61193,"Allentown-Bethlehem-Easton, PA-NJ",40.789339,-75.398158,865310
207,10900,60-64,30961,29929,60890,"Allentown-Bethlehem-Easton, PA-NJ",40.789339,-75.398158,865310
208,10900,65+,89220,72709,161929,"Allentown-Bethlehem-Easton, PA-NJ",40.789339,-75.398158,865310
209,10940,15-19,1404,1476,2880,"Alma, MI",43.292326,-84.60469,41544
210,10940,20-24,1350,1881,3231,"Alma, MI",43.292326,-84.60469,41544
211,10940,25-29,1078,1721,2799,"Alma, MI",43.292326,-84.60469,41544
212,10940,30-34,1059,1662,2721,"Alma, MI",43.292326,-84.60469,41544
213,10940,35-39,1105,1608,2713,"Alma, MI",43.292326,-84.60469,41544
214,10940,40-44,1109,1633,2742,"Alma, MI",43.292326,-84.60469,41544
215,10940,45-49,985,1454,2439,"Alma, MI",43.292326,-84.60469,41544
216,10940,50-54,1167,1462,2629,"Alma, MI",43.292326,-84.60469,41544
217,10940,55-59,1320,1481,2801,"Alma, MI",43.292326,-84.60469,41544
218,10940,60-64,1275,1393,2668,"Alma, MI",43.292326,-84.60469,41544
219,10940,65+,3953,3335,7288,"Alma, MI",43.292326,-84.60469,41544
220,10980,15-19,743,812,1555,"Alpena, MI",44.894954,-83.426574,28893
221,10980,20-24,666,727,1393,"Alpena, MI",44.894954,-83.426574,28893
222,10980,25-29,725,822,1547,"Alpena, MI",44.894954,-83.426574,28893
223,10980,30-34,760,796,1556,"Alpena, MI",44.894954,-83.426574,28893
224,10980,35-39,753,857,1610,"Alpena, MI",44.894954,-83.426574,28893
225,10980,40-44,780,867,1647,"Alpena, MI",44.894954,-83.426574,28893
226,10980,45-49,773,788,1561,"Alpena, MI",44.894954,-83.426574,28893
227,10980,50-54,880,810,1690,"Alpena, MI",44.894954,-83.426574,28893
228,10980,55-59,1150,1083,2233,"Alpena, MI",44.894954,-83.426574,28893
229,10980,60-64,1308,1299,2607,"Alpena, MI",44.894954,-83.426574,28893
230,10980,65+,3814,3285,7099,"Alpena, MI",44.894954,-83.426574,28893
231,11020,15-19,3604,3914,7518,"Altoona, PA",40.498683,-78.309597,121767
232,11020,20-24,3028,3257,6285,"Altoona, PA",40.498683,-78.309597,121767
233,11020,25-29,3408,3515,6923,"Altoona, PA",40.498683,-78.309597,121767
234,11020,30-34,3851,3971,7822,"Altoona, PA",40.498683,-78.309597,121767
235,11020,35-39,3537,3615,7152,"Altoona, PA",40.498683,-78.309597,121767
236,11020,40-44,3626,3607,7233,"Altoona, PA",40.498683,-78.309597,121767
237,11020,45-49,3399,3598,6997,"Altoona, PA",40.498683,-78.309597,121767
238,11020,50-54,3939,3993,7932,"Altoona, PA",40.498683,-78.309597,121767
239,11020,55-59,4231,4170,8401,"Altoona, PA",40.498683,-78.309597,121767
240,11020,60-64,4601,4499,9100,"Altoona, PA",40.498683,-78.309597,121767
241,11020,65+,14644,11448,26092,"Altoona, PA",40.498683,-78.309597,121767
242,11060,15-19,752,773,1525,"Altus, OK",34.594006,-99.412235,24777
243,11060,20-24,834,1031,1865,"Altus, OK",34.594006,-99.412235,24777
244,11060,25-29,866,938,1804,"Altus, OK",34.594006,-99.412235,24777
245,11060,30-34,900,953,1853,"Altus, OK",34.594006,-99.412235,24777
246,11060,35-39,817,885,1702,"Altus, OK",34.594006,-99.412235,24777
247,11060,40-44,705,709,1414,"Altus, OK",34.594006,-99.412235,24777
248,11060,45-49,666,645,1311,"Altus, OK",34.594006,-99.412235,24777
249,11060,50-54,648,621,1269,"Altus, OK",34.594006,-99.412235,24777
250,11060,55-59,743,691,1434,"Altus, OK",34.594006,-99.412235,24777
251,11060,60-64,709,766,1475,"Altus, OK",34.594006,-99.412235,24777
252,11060,65+,2068,1728,3796,"Altus, OK",34.594006,-99.412235,24777
253,11100,15-19,9505,9871,19376,"Amarillo, TX",35.247999,-101.90867,269703
254,11100,20-24,8713,8965,17678,"Amarillo, TX",35.247999,-101.90867,269703
255,11100,25-29,8992,9478,18470,"Amarillo, TX",35.247999,-101.90867,269703
256,11100,30-34,9325,10125,19450,"Amarillo, TX",35.247999,-101.90867,269703
257,11100,35-39,9273,10158,19431,"Amarillo, TX",35.247999,-101.90867,269703
258,11100,40-44,8500,9471,17971,"Amarillo, TX",35.247999,-101.90867,269703
259,11100,45-49,7375,8199,15574,"Amarillo, TX",35.247999,-101.90867,269703
260,11100,50-54,7313,7847,15160,"Amarillo, TX",35.247999,-101.90867,269703
261,11100,55-59,7613,7584,15197,"Amarillo, TX",35.247999,-101.90867,269703
262,11100,60-64,7918,7518,15436,"Amarillo, TX",35.247999,-101.90867,269703
263,11100,65+,21627,18132,39759,"Amarillo, TX",35.247999,-101.90867,269703
264,11140,15-19,1328,1290,2618,"Americus, GA",32.098355,-84.224304,33761
265,11140,20-24,1655,1438,3093,"Americus, GA",32.098355,-84.224304,33761
266,11140,25-29,1028,1073,2101,"Americus, GA",32.098355,-84.224304,33761
267,11140,30-34,947,966,1913,"Americus, GA",32.098355,-84.224304,33761
268,11140,35-39,954,859,1813,"Americus, GA",32.098355,-84.224304,33761
269,11140,40-44,984,847,1831,"Americus, GA",32.098355,-84.224304,33761
270,11140,45-49,1025,849,1874,"Americus, GA",32.098355,-84.224304,33761
271,11140,50-54,1108,981,2089,"Americus, GA",32.098355,-84.224304,33761
272,11140,55-59,1129,994,2123,"Americus, GA",32.098355,-84.224304,33761
273,11140,60-64,1103,950,2053,"Americus, GA",32.098355,-84.224304,33761
274,11140,65+,3342,2577,5919,"Americus, GA",32.098355,-84.224304,33761
275,11180,15-19,6041,6817,12858,"Ames, IA",42.036128,-93.698008,126195
276,11180,20-24,9678,12511,22189,"Ames, IA",42.036128,-93.698008,126195
277,11180,25-29,4020,5204,9224,"Ames, IA",42.036128,-93.698008,126195
278,11180,30-34,3484,3795,7279,"Ames, IA",42.036128,-93.698008,126195
279,11180,35-39,3294,3616,6910,"Ames, IA",42.036128,-93.698008,126195
280,11180,40-44,3317,3545,6862,"Ames, IA",42.036128,-93.698008,126195
281,11180,45-49,2793,3018,5811,"Ames, IA",42.036128,-93.698008,126195
282,11180,50-54,2773,3016,5789,"Ames, IA",42.036128,-93.698008,126195
283,11180,55-59,3199,3166,6365,"Ames, IA",42.036128,-93.698008,126195
284,11180,60-64,3474,3450,6924,"Ames, IA",42.036128,-93.698008,126195
285,11180,65+,9704,8344,18048,"Ames, IA",42.036128,-93.698008,126195
286,11220,15-19,1431,1643,3074,"Amsterdam, NY",42.900891,-74.435357,49558
287,11220,20-24,1339,1374,2713,"Amsterdam, NY",42.900891,-74.435357,49558
288,11220,25-29,1458,1487,2945,"Amsterdam, NY",42.900891,-74.435357,49558
289,11220,30-34,1549,1606,3155,"Amsterdam, NY",42.900891,-74.435357,49558
290,11220,35-39,1649,1565,3214,"Amsterdam, NY",42.900891,-74.435357,49558
291,11220,40-44,1437,1427,2864,"Amsterdam, NY",42.900891,-74.435357,49558
292,11220,45-49,1358,1355,2713,"Amsterdam, NY",42.900891,-74.435357,49558
293,11220,50-54,1568,1557,3125,"Amsterdam, NY",42.900891,-74.435357,49558
294,11220,55-59,1709,1642,3351,"Amsterdam, NY",42.900891,-74.435357,49558
295,11220,60-64,1770,1658,3428,"Amsterdam, NY",42.900891,-74.435357,49558
296,11220,65+,5008,4464,9472,"Amsterdam, NY",42.900891,-74.435357,49558
297,11260,15-19,11893,13241,25134,"Anchorage, AK",62.212784,-149.678222,398807
298,11260,20-24,11862,15115,26977,"Anchorage, AK",62.212784,-149.678222,398807
299,11260,25-29,14428,16134,30562,"Anchorage, AK",62.212784,-149.678222,398807
300,11260,30-34,15900,16703,32603,"Anchorage, AK",62.212784,-149.678222,398807
301,11260,35-39,15148,16092,31240,"Anchorage, AK",62.212784,-149.678222,398807
302,11260,40-44,12632,13242,25874,"Anchorage, AK",62.212784,-149.678222,398807
303,11260,45-49,10927,11781,22708,"Anchorage, AK",62.212784,-149.678222,398807
304,11260,50-54,11412,12054,23466,"Anchorage, AK",62.212784,-149.678222,398807
305,11260,55-59,11900,12312,24212,"Anchorage, AK",62.212784,-149.678222,398807
306,11260,60-64,11705,12139,23844,"Anchorage, AK",62.212784,-149.678222,398807
307,11260,65+,26091,24499,50590,"Anchorage, AK",62.212784,-149.678222,398807
308,11380,15-19,701,747,1448,"Andrews, TX",32.312258,-102.640206,18440
309,11380,20-24,554,579,1133,"Andrews, TX",32.312258,-102.640206,18440
310,11380,25-29,584,653,1237,"Andrews, TX",32.312258,-102.640206,18440
311,11380,30-34,672,746,1418,"Andrews, TX",32.312258,-102.640206,18440
312,11380,35-39,660,735,1395,"Andrews, TX",32.312258,-102.640206,18440
313,11380,40-44,532,625,1157,"Andrews, TX",32.312258,-102.640206,18440
314,11380,45-49,513,547,1060,"Andrews, TX",32.312258,-102.640206,18440
315,11380,50-54,536,490,1026,"Andrews, TX",32.312258,-102.640206,18440
316,11380,55-59,454,516,970,"Andrews, TX",32.312258,-102.640206,18440
317,11380,60-64,424,500,924,"Andrews, TX",32.312258,-102.640206,18440
318,11380,65+,984,835,1819,"Andrews, TX",32.312258,-102.640206,18440
319,11420,15-19,1081,1311,2392,"Angola, IN",41.643467,-85.002405,34632
320,11420,20-24,995,1306,2301,"Angola, IN",41.643467,-85.002405,34632
321,11420,25-29,875,932,1807,"Angola, IN",41.643467,-85.002405,34632
322,11420,30-34,941,969,1910,"Angola, IN",41.643467,-85.002405,34632
323,11420,35-39,852,894,1746,"Angola, IN",41.643467,-85.002405,34632
324,11420,40-44,874,904,1778,"Angola, IN",41.643467,-85.002405,34632
325,11420,45-49,961,965,1926,"Angola, IN",41.643467,-85.002405,34632
326,11420,50-54,1103,1163,2266,"Angola, IN",41.643467,-85.002405,34632
327,11420,55-59,1266,1330,2596,"Angola, IN",41.643467,-85.002405,34632
328,11420,60-64,1365,1369,2734,"Angola, IN",41.643467,-85.002405,34632
329,11420,65+,3884,3586,7470,"Angola, IN",41.643467,-85.002405,34632
330,11460,15-19,16458,16401,32859,"Ann Arbor, MI",42.252217,-83.843423,369390
331,11460,20-24,22795,23004,45799,"Ann Arbor, MI",42.252217,-83.843423,369390
332,11460,25-29,13450,14379,27829,"Ann Arbor, MI",42.252217,-83.843423,369390
333,11460,30-34,11609,12543,24152,"Ann Arbor, MI",42.252217,-83.843423,369390
334,11460,35-39,10961,11493,22454,"Ann Arbor, MI",42.252217,-83.843423,369390
335,11460,40-44,10593,10640,21233,"Ann Arbor, MI",42.252217,-83.843423,369390
336,11460,45-49,10067,9871,19938,"Ann Arbor, MI",42.252217,-83.843423,369390
337,11460,50-54,10847,10796,21643,"Ann Arbor, MI",42.252217,-83.843423,369390
338,11460,55-59,10876,10669,21545,"Ann Arbor, MI",42.252217,-83.843423,369390
339,11460,60-64,10610,10055,20665,"Ann Arbor, MI",42.252217,-83.843423,369390
340,11460,65+,30486,25439,55925,"Ann Arbor, MI",42.252217,-83.843423,369390
341,11500,15-19,3793,3968,7761,"Anniston-Oxford, AL",33.770516,-85.827909,115972
342,11500,20-24,3836,3799,7635,"Anniston-Oxford, AL",33.770516,-85.827909,115972
343,11500,25-29,3666,3543,7209,"Anniston-Oxford, AL",33.770516,-85.827909,115972
344,11500,30-34,3894,3692,7586,"Anniston-Oxford, AL",33.770516,-85.827909,115972
345,11500,35-39,3539,3384,6923,"Anniston-Oxford, AL",33.770516,-85.827909,115972
346,11500,40-44,3661,3418,7079,"Anniston-Oxford, AL",33.770516,-85.827909,115972
347,11500,45-49,3450,3287,6737,"Anniston-Oxford, AL",33.770516,-85.827909,115972
348,11500,50-54,3776,3541,7317,"Anniston-Oxford, AL",33.770516,-85.827909,115972
349,11500,55-59,3911,3818,7729,"Anniston-Oxford, AL",33.770516,-85.827909,115972
350,11500,60-64,4194,3728,7922,"Anniston-Oxford, AL",33.770516,-85.827909,115972
351,11500,65+,12092,9319,21411,"Anniston-Oxford, AL",33.770516,-85.827909,115972
352,11540,15-19,7810,8244,16054,"Appleton, WI",44.290603,-88.372326,244084
353,11540,20-24,6956,7350,14306,"Appleton, WI",44.290603,-88.372326,244084
354,11540,25-29,7200,7814,15014,"Appleton, WI",44.290603,-88.372326,244084
355,11540,30-34,7680,8027,15707,"Appleton, WI",44.290603,-88.372326,244084
356,11540,35-39,8210,8512,16722,"Appleton, WI",44.290603,-88.372326,244084
357,11540,40-44,7932,8354,16286,"Appleton, WI",44.290603,-88.372326,244084
358,11540,45-49,7016,7385,14401,"Appleton, WI",44.290603,-88.372326,244084
359,11540,50-54,8020,8149,16169,"Appleton, WI",44.290603,-88.372326,244084
360,11540,55-59,8730,8866,17596,"Appleton, WI",44.290603,-88.372326,244084
361,11540,60-64,8410,8340,16750,"Appleton, WI",44.290603,-88.372326,244084
362,11540,65+,20917,18068,38985,"Appleton, WI",44.290603,-88.372326,244084
363,11580,15-19,834,1118,1952,"Arcadia, FL",27.190581,-81.806253,34408
364,11580,20-24,773,1430,2203,"Arcadia, FL",27.190581,-81.806253,34408
365,11580,25-29,828,1399,2227,"Arcadia, FL",27.190581,-81.806253,34408
366,11580,30-34,876,1449,2325,"Arcadia, FL",27.190581,-81.806253,34408
367,11580,35-39,854,1487,2341,"Arcadia, FL",27.190581,-81.806253,34408
368,11580,40-44,813,1370,2183,"Arcadia, FL",27.190581,-81.806253,34408
369,11580,45-49,772,1155,1927,"Arcadia, FL",27.190581,-81.806253,34408
370,11580,50-54,848,1205,2053,"Arcadia, FL",27.190581,-81.806253,34408
371,11580,55-59,964,1152,2116,"Arcadia, FL",27.190581,-81.806253,34408
372,11580,60-64,1034,1097,2131,"Arcadia, FL",27.190581,-81.806253,34408
373,11580,65+,3960,3819,7779,"Arcadia, FL",27.190581,-81.806253,34408
374,11620,15-19,1907,1959,3866,"Ardmore, OK",34.125836,-97.263905,58507
375,11620,20-24,1773,1715,3488,"Ardmore, OK",34.125836,-97.263905,58507
376,11620,25-29,1862,1873,3735,"Ardmore, OK",34.125836,-97.263905,58507
377,11620,30-34,1820,1912,3732,"Ardmore, OK",34.125836,-97.263905,58507
378,11620,35-39,1809,1880,3689,"Ardmore, OK",34.125836,-97.263905,58507
379,11620,40-44,1760,1761,3521,"Ardmore, OK",34.125836,-97.263905,58507
380,11620,45-49,1702,1701,3403,"Ardmore, OK",34.125836,-97.263905,58507
381,11620,50-54,1661,1721,3382,"Ardmore, OK",34.125836,-97.263905,58507
382,11620,55-59,1866,1767,3633,"Ardmore, OK",34.125836,-97.263905,58507
383,11620,60-64,1920,1799,3719,"Ardmore, OK",34.125836,-97.263905,58507
384,11620,65+,5662,4507,10169,"Ardmore, OK",34.125836,-97.263905,58507
385,11660,15-19,1208,1082,2290,"Arkadelphia, AR",34.053316,-93.176208,21321
386,11660,20-24,1613,1472,3085,"Arkadelphia, AR",34.053316,-93.176208,21321
387,11660,25-29,597,611,1208,"Arkadelphia, AR",34.053316,-93.176208,21321
388,11660,30-34,561,533,1094,"Arkadelphia, AR",34.053316,-93.176208,21321
389,11660,35-39,509,507,1016,"Arkadelphia, AR",34.053316,-93.176208,21321
390,11660,40-44,541,503,1044,"Arkadelphia, AR",34.053316,-93.176208,21321
391,11660,45-49,553,530,1083,"Arkadelphia, AR",34.053316,-93.176208,21321
392,11660,50-54,532,492,1024,"Arkadelphia, AR",34.053316,-93.176208,21321
393,11660,55-59,635,575,1210,"Arkadelphia, AR",34.053316,-93.176208,21321
394,11660,60-64,651,580,1231,"Arkadelphia, AR",34.053316,-93.176208,21321
395,11660,65+,1978,1589,3567,"Arkadelphia, AR",34.053316,-93.176208,21321
396,11700,15-19,12307,12905,25212,"Asheville, NC",35.595669,-82.681615,472341
397,11700,20-24,12123,11921,24044,"Asheville, NC",35.595669,-82.681615,472341
398,11700,25-29,14281,13760,28041,"Asheville, NC",35.595669,-82.681615,472341
399,11700,30-34,15829,15135,30964,"Asheville, NC",35.595669,-82.681615,472341
400,11700,35-39,15408,14793,30201,"Asheville, NC",35.595669,-82.681615,472341
401,11700,40-44,15214,14779,29993,"Asheville, NC",35.595669,-82.681615,472341
402,11700,45-49,14259,14494,28753,"Asheville, NC",35.595669,-82.681615,472341
403,11700,50-54,15398,15207,30605,"Asheville, NC",35.595669,-82.681615,472341
404,11700,55-59,16658,15281,31939,"Asheville, NC",35.595669,-82.681615,472341
405,11700,60-64,18505,15817,34322,"Asheville, NC",35.595669,-82.681615,472341
406,11700,65+,60134,48592,108726,"Asheville, NC",35.595669,-82.681615,472341
407,11740,15-19,1905,1859,3764,"Ashland, OH",40.843273,-82.270127,52316
408,11740,20-24,1899,1815,3714,"Ashland, OH",40.843273,-82.270127,52316
409,11740,25-29,1466,1546,3012,"Ashland, OH",40.843273,-82.270127,52316
410,11740,30-34,1400,1448,2848,"Ashland, OH",40.843273,-82.270127,52316
411,11740,35-39,1511,1549,3060,"Ashland, OH",40.843273,-82.270127,52316
412,11740,40-44,1421,1496,2917,"Ashland, OH",40.843273,-82.270127,52316
413,11740,45-49,1423,1447,2870,"Ashland, OH",40.843273,-82.270127,52316
414,11740,50-54,1637,1614,3251,"Ashland, OH",40.843273,-82.270127,52316
415,11740,55-59,1704,1701,3405,"Ashland, OH",40.843273,-82.270127,52316
416,11740,60-64,1937,1791,3728,"Ashland, OH",40.843273,-82.270127,52316
417,11740,65+,5520,4698,10218,"Ashland, OH",40.843273,-82.270127,52316
418,11780,15-19,2843,3103,5946,"Ashtabula, OH",41.906637,-80.745592,97337
419,11780,20-24,2450,2899,5349,"Ashtabula, OH",41.906637,-80.745592,97337
420,11780,25-29,2635,3115,5750,"Ashtabula, OH",41.906637,-80.745592,97337
421,11780,30-34,2693,3009,5702,"Ashtabula, OH",41.906637,-80.745592,97337
422,11780,35-39,2625,2852,5477,"Ashtabula, OH",41.906637,-80.745592,97337
423,11780,40-44,2693,2772,5465,"Ashtabula, OH",41.906637,-80.745592,97337
424,11780,45-49,2776,2954,5730,"Ashtabula, OH",41.906637,-80.745592,97337
425,11780,50-54,3212,3379,6591,"Ashtabula, OH",41.906637,-80.745592,97337
426,11780,55-59,3486,3578,7064,"Ashtabula, OH",41.906637,-80.745592,97337
427,11780,60-64,3643,3618,7261,"Ashtabula, OH",41.906637,-80.745592,97337
428,11780,65+,10404,9083,19487,"Ashtabula, OH",41.906637,-80.745592,97337
429,11820,15-19,1072,1081,2153,"Astoria, OR",46.024509,-123.705037,41810
430,11820,20-24,1087,1151,2238,"Astoria, OR",46.024509,-123.705037,41810
431,11820,25-29,1098,1164,2262,"Astoria, OR",46.024509,-123.705037,41810
432,11820,30-34,1287,1301,2588,"Astoria, OR",46.024509,-123.705037,41810
433,11820,35-39,1391,1342,2733,"Astoria, OR",46.024509,-123.705037,41810
434,11820,40-44,1387,1353,2740,"Astoria, OR",46.024509,-123.705037,41810
435,11820,45-49,1119,1153,2272,"Astoria, OR",46.024509,-123.705037,41810
436,11820,50-54,1149,1177,2326,"Astoria, OR",46.024509,-123.705037,41810
437,11820,55-59,1435,1380,2815,"Astoria, OR",46.024509,-123.705037,41810
438,11820,60-64,1670,1599,3269,"Astoria, OR",46.024509,-123.705037,41810
439,11820,65+,5261,4841,10102,"Astoria, OR",46.024509,-123.705037,41810
440,11860,15-19,757,765,1522,"Atchison, KS",39.532544,-95.313397,16239
441,11860,20-24,748,648,1396,"Atchison, KS",39.532544,-95.313397,16239
442,11860,25-29,442,475,917,"Atchison, KS",39.532544,-95.313397,16239
443,11860,30-34,419,416,835,"Atchison, KS",39.532544,-95.313397,16239
444,11860,35-39,456,478,934,"Atchison, KS",39.532544,-95.313397,16239
445,11860,40-44,425,438,863,"Atchison, KS",39.532544,-95.313397,16239
446,11860,45-49,377,415,792,"Atchison, KS",39.532544,-95.313397,16239
447,11860,50-54,472,450,922,"Atchison, KS",39.532544,-95.313397,16239
448,11860,55-59,541,535,1076,"Atchison, KS",39.532544,-95.313397,16239
449,11860,60-64,555,516,1071,"Atchison, KS",39.532544,-95.313397,16239
450,11860,65+,1624,1308,2932,"Atchison, KS",39.532544,-95.313397,16239
451,11900,15-19,4250,3798,8048,"Athens, OH",39.332755,-82.045885,62056
452,11900,20-24,5474,5578,11052,"Athens, OH",39.332755,-82.045885,62056
453,11900,25-29,1652,1949,3601,"Athens, OH",39.332755,-82.045885,62056
454,11900,30-34,1657,1830,3487,"Athens, OH",39.332755,-82.045885,62056
455,11900,35-39,1562,1678,3240,"Athens, OH",39.332755,-82.045885,62056
456,11900,40-44,1640,1688,3328,"Athens, OH",39.332755,-82.045885,62056
457,11900,45-49,1414,1523,2937,"Athens, OH",39.332755,-82.045885,62056
458,11900,50-54,1640,1605,3245,"Athens, OH",39.332755,-82.045885,62056
459,11900,55-59,1745,1716,3461,"Athens, OH",39.332755,-82.045885,62056
460,11900,60-64,1755,1767,3522,"Athens, OH",39.332755,-82.045885,62056
461,11900,65+,4802,4048,8850,"Athens, OH",39.332755,-82.045885,62056
462,11940,15-19,1663,1706,3369,"Athens, TN",35.424472,-84.619949,54059
463,11940,20-24,1510,1532,3042,"Athens, TN",35.424472,-84.619949,54059
464,11940,25-29,1661,1655,3316,"Athens, TN",35.424472,-84.619949,54059
465,11940,30-34,1583,1567,3150,"Athens, TN",35.424472,-84.619949,54059
466,11940,35-39,1583,1485,3068,"Athens, TN",35.424472,-84.619949,54059
467,11940,40-44,1628,1509,3137,"Athens, TN",35.424472,-84.619949,54059
468,11940,45-49,1675,1569,3244,"Athens, TN",35.424472,-84.619949,54059
469,11940,50-54,1819,1946,3765,"Athens, TN",35.424472,-84.619949,54059
470,11940,55-59,1936,1845,3781,"Athens, TN",35.424472,-84.619949,54059
471,11940,60-64,1993,1922,3915,"Athens, TN",35.424472,-84.619949,54059
472,11940,65+,5909,4981,10890,"Athens, TN",35.424472,-84.619949,54059
473,11980,15-19,2375,2753,5128,"Athens, TX",32.211633,-95.853418,83667
474,11980,20-24,2199,2350,4549,"Athens, TX",32.211633,-95.853418,83667
475,11980,25-29,2302,2288,4590,"Athens, TX",32.211633,-95.853418,83667
476,11980,30-34,2378,2199,4577,"Athens, TX",32.211633,-95.853418,83667
477,11980,35-39,2355,2305,4660,"Athens, TX",32.211633,-95.853418,83667
478,11980,40-44,2382,2212,4594,"Athens, TX",32.211633,-95.853418,83667
479,11980,45-49,2327,2168,4495,"Athens, TX",32.211633,-95.853418,83667
480,11980,50-54,2723,2565,5288,"Athens, TX",32.211633,-95.853418,83667
481,11980,55-59,2920,2797,5717,"Athens, TX",32.211633,-95.853418,83667
482,11980,60-64,3468,3128,6596,"Athens, TX",32.211633,-95.853418,83667
483,11980,65+,9974,8720,18694,"Athens, TX",32.211633,-95.853418,83667
484,12020,15-19,10122,8994,19116,"Athens-Clarke County, GA",33.943984,-83.213897,217759
485,12020,20-24,14358,13875,28233,"Athens-Clarke County, GA",33.943984,-83.213897,217759
486,12020,25-29,7971,7601,15572,"Athens-Clarke County, GA",33.943984,-83.213897,217759
487,12020,30-34,7448,6896,14344,"Athens-Clarke County, GA",33.943984,-83.213897,217759
488,12020,35-39,6920,6438,13358,"Athens-Clarke County, GA",33.943984,-83.213897,217759
489,12020,40-44,6670,6430,13100,"Athens-Clarke County, GA",33.943984,-83.213897,217759
490,12020,45-49,6190,5781,11971,"Athens-Clarke County, GA",33.943984,-83.213897,217759
491,12020,50-54,6141,5870,12011,"Athens-Clarke County, GA",33.943984,-83.213897,217759
492,12020,55-59,5964,5688,11652,"Athens-Clarke County, GA",33.943984,-83.213897,217759
493,12020,60-64,6099,5567,11666,"Athens-Clarke County, GA",33.943984,-83.213897,217759
494,12020,65+,17171,13762,30933,"Athens-Clarke County, GA",33.943984,-83.213897,217759
495,12060,15-19,212408,217908,430316,"Atlanta-Sandy Springs-Alpharetta, GA",33.693728,-84.399911,6144050
496,12060,20-24,197888,196085,393973,"Atlanta-Sandy Springs-Alpharetta, GA",33.693728,-84.399911,6144050
497,12060,25-29,219188,209385,428573,"Atlanta-Sandy Springs-Alpharetta, GA",33.693728,-84.399911,6144050
498,12060,30-34,227989,213426,441415,"Atlanta-Sandy Springs-Alpharetta, GA",33.693728,-84.399911,6144050
499,12060,35-39,221651,206767,428418,"Atlanta-Sandy Springs-Alpharetta, GA",33.693728,-84.399911,6144050
500,12060,40-44,221422,202078,423500,"Atlanta-Sandy Springs-Alpharetta, GA",33.693728,-84.399911,6144050
501,12060,45-49,216914,199825,416739,"Atlanta-Sandy Springs-Alpharetta, GA",33.693728,-84.399911,6144050
502,12060,50-54,219075,210412,429487,"Atlanta-Sandy Springs-Alpharetta, GA",33.693728,-84.399911,6144050
503,12060,55-59,206779,196201,402980,"Atlanta-Sandy Springs-Alpharetta, GA",33.693728,-84.399911,6144050
504,12060,60-64,183595,169066,352661,"Atlanta-Sandy Springs-Alpharetta, GA",33.693728,-84.399911,6144050
505,12060,65+,453448,353134,806582,"Atlanta-Sandy Springs-Alpharetta, GA",33.693728,-84.399911,6144050
506,12100,15-19,8377,8783,17160,"Atlantic City-Hammonton, NJ",39.469355,-74.633759,274966
507,12100,20-24,8540,8692,17232,"Atlantic City-Hammonton, NJ",39.469355,-74.633759,274966
508,12100,25-29,8487,8536,17023,"Atlantic City-Hammonton, NJ",39.469355,-74.633759,274966
509,12100,30-34,8088,8054,16142,"Atlantic City-Hammonton, NJ",39.469355,-74.633759,274966
510,12100,35-39,7924,7756,15680,"Atlantic City-Hammonton, NJ",39.469355,-74.633759,274966
511,12100,40-44,7782,7432,15214,"Atlantic City-Hammonton, NJ",39.469355,-74.633759,274966
512,12100,45-49,8331,7575,15906,"Atlantic City-Hammonton, NJ",39.469355,-74.633759,274966
513,12100,50-54,9713,8976,18689,"Atlantic City-Hammonton, NJ",39.469355,-74.633759,274966
514,12100,55-59,10800,9994,20794,"Atlantic City-Hammonton, NJ",39.469355,-74.633759,274966
515,12100,60-64,10865,10128,20993,"Atlantic City-Hammonton, NJ",39.469355,-74.633759,274966
516,12100,65+,29030,23979,53009,"Atlantic City-Hammonton, NJ",39.469355,-74.633759,274966
517,12120,15-19,1092,1094,2186,"Atmore, AL",31.122287,-87.16841,36699
518,12120,20-24,991,1029,2020,"Atmore, AL",31.122287,-87.16841,36699
519,12120,25-29,1058,1351,2409,"Atmore, AL",31.122287,-87.16841,36699
520,12120,30-34,1091,1418,2509,"Atmore, AL",31.122287,-87.16841,36699
521,12120,35-39,1056,1214,2270,"Atmore, AL",31.122287,-87.16841,36699
522,12120,40-44,1008,1269,2277,"Atmore, AL",31.122287,-87.16841,36699
523,12120,45-49,1054,1267,2321,"Atmore, AL",31.122287,-87.16841,36699
524,12120,50-54,1121,1214,2335,"Atmore, AL",31.122287,-87.16841,36699
525,12120,55-59,1175,1202,2377,"Atmore, AL",31.122287,-87.16841,36699
526,12120,60-64,1204,1156,2360,"Atmore, AL",31.122287,-87.16841,36699
527,12120,65+,3892,2861,6753,"Atmore, AL",31.122287,-87.16841,36699
528,12140,15-19,1373,1467,2840,"Auburn, IN",41.39676,-85.002697,43333
529,12140,20-24,1187,1276,2463,"Auburn, IN",41.39676,-85.002697,43333
530,12140,25-29,1315,1413,2728,"Auburn, IN",41.39676,-85.002697,43333
531,12140,30-34,1374,1378,2752,"Auburn, IN",41.39676,-85.002697,43333
532,12140,35-39,1306,1311,2617,"Auburn, IN",41.39676,-85.002697,43333
533,12140,40-44,1340,1373,2713,"Auburn, IN",41.39676,-85.002697,43333
534,12140,45-49,1289,1292,2581,"Auburn, IN",41.39676,-85.002697,43333
535,12140,50-54,1341,1419,2760,"Auburn, IN",41.39676,-85.002697,43333
536,12140,55-59,1469,1565,3034,"Auburn, IN",41.39676,-85.002697,43333
537,12140,60-64,1452,1459,2911,"Auburn, IN",41.39676,-85.002697,43333
538,12140,65+,3978,3334,7312,"Auburn, IN",41.39676,-85.002697,43333
539,12180,15-19,2078,2227,4305,"Auburn, NY",43.008546,-76.574587,75880
540,12180,20-24,2029,2310,4339,"Auburn, NY",43.008546,-76.574587,75880
541,12180,25-29,2012,2585,4597,"Auburn, NY",43.008546,-76.574587,75880
542,12180,30-34,2107,2593,4700,"Auburn, NY",43.008546,-76.574587,75880
543,12180,35-39,2231,2583,4814,"Auburn, NY",43.008546,-76.574587,75880
544,12180,40-44,2038,2444,4482,"Auburn, NY",43.008546,-76.574587,75880
545,12180,45-49,1920,2263,4183,"Auburn, NY",43.008546,-76.574587,75880
546,12180,50-54,2460,2651,5111,"Auburn, NY",43.008546,-76.574587,75880
547,12180,55-59,2786,2982,5768,"Auburn, NY",43.008546,-76.574587,75880
548,12180,60-64,3020,2931,5951,"Auburn, NY",43.008546,-76.574587,75880
549,12180,65+,8185,7436,15621,"Auburn, NY",43.008546,-76.574587,75880
550,12220,15-19,7230,7246,14476,"Auburn-Opelika, AL",32.604064,-85.353048,177218
551,12220,20-24,10523,11456,21979,"Auburn-Opelika, AL",32.604064,-85.353048,177218
552,12220,25-29,6294,6311,12605,"Auburn-Opelika, AL",32.604064,-85.353048,177218
553,12220,30-34,5997,5657,11654,"Auburn-Opelika, AL",32.604064,-85.353048,177218
554,12220,35-39,5761,5406,11167,"Auburn-Opelika, AL",32.604064,-85.353048,177218
555,12220,40-44,5591,5220,10811,"Auburn-Opelika, AL",32.604064,-85.353048,177218
556,12220,45-49,5239,4837,10076,"Auburn-Opelika, AL",32.604064,-85.353048,177218
557,12220,50-54,5419,5190,10609,"Auburn-Opelika, AL",32.604064,-85.353048,177218
558,12220,55-59,5159,5033,10192,"Auburn-Opelika, AL",32.604064,-85.353048,177218
559,12220,60-64,4981,4726,9707,"Auburn-Opelika, AL",32.604064,-85.353048,177218
560,12220,65+,12742,10450,23192,"Auburn-Opelika, AL",32.604064,-85.353048,177218
561,12260,15-19,19226,21058,40284,"Augusta-Richmond County, GA-SC",33.460371,-81.982833,615933
562,12260,20-24,18875,20286,39161,"Augusta-Richmond County, GA-SC",33.460371,-81.982833,615933
563,12260,25-29,20885,21501,42386,"Augusta-Richmond County, GA-SC",33.460371,-81.982833,615933
564,12260,30-34,22209,21334,43543,"Augusta-Richmond County, GA-SC",33.460371,-81.982833,615933
565,12260,35-39,20867,19960,40827,"Augusta-Richmond County, GA-SC",33.460371,-81.982833,615933
566,12260,40-44,19410,18354,37764,"Augusta-Richmond County, GA-SC",33.460371,-81.982833,615933
567,12260,45-49,17967,16863,34830,"Augusta-Richmond County, GA-SC",33.460371,-81.982833,615933
568,12260,50-54,19163,17788,36951,"Augusta-Richmond County, GA-SC",33.460371,-81.982833,615933
569,12260,55-59,20861,19126,39987,"Augusta-Richmond County, GA-SC",33.460371,-81.982833,615933
570,12260,60-64,21093,18948,40041,"Augusta-Richmond County, GA-SC",33.460371,-81.982833,615933
571,12260,65+,57833,46217,104050,"Augusta-Richmond County, GA-SC",33.460371,-81.982833,615933
572,12300,15-19,3544,3627,7171,"Augusta-Waterville, ME",44.417012,-69.765764,124486
573,12300,20-24,3625,3737,7362,"Augusta-Waterville, ME",44.417012,-69.765764,124486
574,12300,25-29,3591,3654,7245,"Augusta-Waterville, ME",44.417012,-69.765764,124486
575,12300,30-34,3815,3869,7684,"Augusta-Waterville, ME",44.417012,-69.765764,124486
576,12300,35-39,3829,3733,7562,"Augusta-Waterville, ME",44.417012,-69.765764,124486
577,12300,40-44,3700,3625,7325,"Augusta-Waterville, ME",44.417012,-69.765764,124486
578,12300,45-49,3665,3483,7148,"Augusta-Waterville, ME",44.417012,-69.765764,124486
579,12300,50-54,4292,4179,8471,"Augusta-Waterville, ME",44.417012,-69.765764,124486
580,12300,55-59,4835,4574,9409,"Augusta-Waterville, ME",44.417012,-69.765764,124486
581,12300,60-64,5136,4843,9979,"Augusta-Waterville, ME",44.417012,-69.765764,124486
582,12300,65+,13942,11832,25774,"Augusta-Waterville, ME",44.417012,-69.765764,124486
583,12380,15-19,1229,1469,2698,"Austin, MN",43.666249,-92.759514,40158
584,12380,20-24,1097,1232,2329,"Austin, MN",43.666249,-92.759514,40158
585,12380,25-29,1087,1178,2265,"Austin, MN",43.666249,-92.759514,40158
586,12380,30-34,1177,1282,2459,"Austin, MN",43.666249,-92.759514,40158
587,12380,35-39,1221,1315,2536,"Austin, MN",43.666249,-92.759514,40158
588,12380,40-44,1177,1277,2454,"Austin, MN",43.666249,-92.759514,40158
589,12380,45-49,1081,1132,2213,"Austin, MN",43.666249,-92.759514,40158
590,12380,50-54,1092,1180,2272,"Austin, MN",43.666249,-92.759514,40158
591,12380,55-59,1233,1295,2528,"Austin, MN",43.666249,-92.759514,40158
592,12380,60-64,1273,1313,2586,"Austin, MN",43.666249,-92.759514,40158
593,12380,65+,3970,3378,7348,"Austin, MN",43.666249,-92.759514,40158
594,12420,15-19,74953,77097,152050,"Austin-Round Rock-Georgetown, TX",30.249744,-97.649842,2352426
595,12420,20-24,78254,77806,156060,"Austin-Round Rock-Georgetown, TX",30.249744,-97.649842,2352426
596,12420,25-29,92884,96798,189682,"Austin-Round Rock-Georgetown, TX",30.249744,-97.649842,2352426
597,12420,30-34,101874,108864,210738,"Austin-Round Rock-Georgetown, TX",30.249744,-97.649842,2352426
598,12420,35-39,97930,105059,202989,"Austin-Round Rock-Georgetown, TX",30.249744,-97.649842,2352426
599,12420,40-44,87721,93469,181190,"Austin-Round Rock-Georgetown, TX",30.249744,-97.649842,2352426
600,12420,45-49,77378,82278,159656,"Austin-Round Rock-Georgetown, TX",30.249744,-97.649842,2352426
601,12420,50-54,70907,75157,146064,"Austin-Round Rock-Georgetown, TX",30.249744,-97.649842,2352426
602,12420,55-59,64463,64595,129058,"Austin-Round Rock-Georgetown, TX",30.249744,-97.649842,2352426
603,12420,60-64,60830,58476,119306,"Austin-Round Rock-Georgetown, TX",30.249744,-97.649842,2352426
604,12420,65+,148543,124516,273059,"Austin-Round Rock-Georgetown, TX",30.249744,-97.649842,2352426
605,12460,15-19,937,1014,1951,"Bainbridge, GA",30.880643,-84.58389,29038
606,12460,20-24,824,1030,1854,"Bainbridge, GA",30.880643,-84.58389,29038
607,12460,25-29,922,934,1856,"Bainbridge, GA",30.880643,-84.58389,29038
608,12460,30-34,960,871,1831,"Bainbridge, GA",30.880643,-84.58389,29038
609,12460,35-39,876,813,1689,"Bainbridge, GA",30.880643,-84.58389,29038
610,12460,40-44,870,882,1752,"Bainbridge, GA",30.880643,-84.58389,29038
611,12460,45-49,916,847,1763,"Bainbridge, GA",30.880643,-84.58389,29038
612,12460,50-54,922,903,1825,"Bainbridge, GA",30.880643,-84.58389,29038
613,12460,55-59,1005,930,1935,"Bainbridge, GA",30.880643,-84.58389,29038
614,12460,60-64,917,925,1842,"Bainbridge, GA",30.880643,-84.58389,29038
615,12460,65+,2827,2072,4899,"Bainbridge, GA",30.880643,-84.58389,29038
616,12540,15-19,34500,36420,70920,"Bakersfield, CA",35.346629,-118.729506,917673
617,12540,20-24,30037,34648,64685,"Bakersfield, CA",35.346629,-118.729506,917673
618,12540,25-29,32872,37535,70407,"Bakersfield, CA",35.346629,-118.729506,917673
619,12540,30-34,33001,37757,70758,"Bakersfield, CA",35.346629,-118.729506,917673
620,12540,35-39,30180,34750,64930,"Bakersfield, CA",35.346629,-118.729506,917673
621,12540,40-44,27144,30814,57958,"Bakersfield, CA",35.346629,-118.729506,917673
622,12540,45-49,24497,26652,51149,"Bakersfield, CA",35.346629,-118.729506,917673
623,12540,50-54,24168,25108,49276,"Bakersfield, CA",35.346629,-118.729506,917673
624,12540,55-59,24098,24348,48446,"Bakersfield, CA",35.346629,-118.729506,917673
625,12540,60-64,23078,23282,46360,"Bakersfield, CA",35.346629,-118.729506,917673
626,12540,65+,55806,48832,104638,"Bakersfield, CA",35.346629,-118.729506,917673
627,12580,15-19,87557,90357,177914,"Baltimore-Columbia-Towson, MD",39.304361,-76.549501,2838327
628,12580,20-24,84528,86656,171184,"Baltimore-Columbia-Towson, MD",39.304361,-76.549501,2838327
629,12580,25-29,95134,93596,188730,"Baltimore-Columbia-Towson, MD",39.304361,-76.549501,2838327
630,12580,30-34,106613,101083,207696,"Baltimore-Columbia-Towson, MD",39.304361,-76.549501,2838327
631,12580,35-39,103448,97729,201177,"Baltimore-Columbia-Towson, MD",39.304361,-76.549501,2838327
632,12580,40-44,93879,88210,182089,"Baltimore-Columbia-Towson, MD",39.304361,-76.549501,2838327
633,12580,45-49,85209,79677,164886,"Baltimore-Columbia-Towson, MD",39.304361,-76.549501,2838327
634,12580,50-54,94530,88434,182964,"Baltimore-Columbia-Towson, MD",39.304361,-76.549501,2838327
635,12580,55-59,101360,94703,196063,"Baltimore-Columbia-Towson, MD",39.304361,-76.549501,2838327
636,12580,60-64,98328,89296,187624,"Baltimore-Columbia-Towson, MD",39.304361,-76.549501,2838327
637,12580,65+,261475,201884,463359,"Baltimore-Columbia-Towson, MD",39.304361,-76.549501,2838327
638,12620,15-19,4917,5726,10643,"Bangor, ME",45.409284,-68.666616,152765
639,12620,20-24,4833,5662,10495,"Bangor, ME",45.409284,-68.666616,152765
640,12620,25-29,4635,4753,9388,"Bangor, ME",45.409284,-68.666616,152765
641,12620,30-34,5138,5287,10425,"Bangor, ME",45.409284,-68.666616,152765
642,12620,35-39,4703,4693,9396,"Bangor, ME",45.409284,-68.666616,152765
643,12620,40-44,4526,4376,8902,"Bangor, ME",45.409284,-68.666616,152765
644,12620,45-49,4537,4360,8897,"Bangor, ME",45.409284,-68.666616,152765
645,12620,50-54,5056,5004,10060,"Bangor, ME",45.409284,-68.666616,152765
646,12620,55-59,5783,5600,11383,"Bangor, ME",45.409284,-68.666616,152765
647,12620,60-64,5988,5767,11755,"Bangor, ME",45.409284,-68.666616,152765
648,12620,65+,15923,13695,29618,"Bangor, ME",45.409284,-68.666616,152765
649,12660,15-19,1977,2086,4063,"Baraboo, WI",43.428001,-89.943318,65697
650,12660,20-24,1697,1745,3442,"Baraboo, WI",43.428001,-89.943318,65697
651,12660,25-29,1769,1881,3650,"Baraboo, WI",43.428001,-89.943318,65697
652,12660,30-34,1898,1954,3852,"Baraboo, WI",43.428001,-89.943318,65697
653,12660,35-39,2092,2216,4308,"Baraboo, WI",43.428001,-89.943318,65697
654,12660,40-44,1938,2134,4072,"Baraboo, WI",43.428001,-89.943318,65697
655,12660,45-49,1824,1876,3700,"Baraboo, WI",43.428001,-89.943318,65697
656,12660,50-54,2019,2167,4186,"Baraboo, WI",43.428001,-89.943318,65697
657,12660,55-59,2376,2301,4677,"Baraboo, WI",43.428001,-89.943318,65697
658,12660,60-64,2351,2413,4764,"Baraboo, WI",43.428001,-89.943318,65697
659,12660,65+,6852,5962,12814,"Baraboo, WI",43.428001,-89.943318,65697
660,12680,15-19,1362,1512,2874,"Bardstown, KY",37.80312,-85.465931,47098
661,12680,20-24,1267,1304,2571,"Bardstown, KY",37.80312,-85.465931,47098
662,12680,25-29,1587,1560,3147,"Bardstown, KY",37.80312,-85.465931,47098
663,12680,30-34,1546,1487,3033,"Bardstown, KY",37.80312,-85.465931,47098
664,12680,35-39,1408,1385,2793,"Bardstown, KY",37.80312,-85.465931,47098
665,12680,40-44,1488,1571,3059,"Bardstown, KY",37.80312,-85.465931,47098
666,12680,45-49,1379,1374,2753,"Bardstown, KY",37.80312,-85.465931,47098
667,12680,50-54,1669,1573,3242,"Bardstown, KY",37.80312,-85.465931,47098
668,12680,55-59,1715,1692,3407,"Bardstown, KY",37.80312,-85.465931,47098
669,12680,60-64,1631,1654,3285,"Bardstown, KY",37.80312,-85.465931,47098
670,12680,65+,4355,3531,7886,"Bardstown, KY",37.80312,-85.465931,47098
671,12700,15-19,5094,5806,10900,"Barnstable Town, MA",41.706123,-70.164823,232411
672,12700,20-24,5187,6368,11555,"Barnstable Town, MA",41.706123,-70.164823,232411
673,12700,25-29,5159,5657,10816,"Barnstable Town, MA",41.706123,-70.164823,232411
674,12700,30-34,5313,5401,10714,"Barnstable Town, MA",41.706123,-70.164823,232411
675,12700,35-39,5342,5396,10738,"Barnstable Town, MA",41.706123,-70.164823,232411
676,12700,40-44,5292,5257,10549,"Barnstable Town, MA",41.706123,-70.164823,232411
677,12700,45-49,5381,4968,10349,"Barnstable Town, MA",41.706123,-70.164823,232411
678,12700,50-54,7667,6738,14405,"Barnstable Town, MA",41.706123,-70.164823,232411
679,12700,55-59,10075,9079,19154,"Barnstable Town, MA",41.706123,-70.164823,232411
680,12700,60-64,12032,10543,22575,"Barnstable Town, MA",41.706123,-70.164823,232411
681,12700,65+,40650,33214,73864,"Barnstable Town, MA",41.706123,-70.164823,232411
682,12740,15-19,1768,2339,4107,"Barre, VT",44.274969,-72.609444,59969
683,12740,20-24,1673,2231,3904,"Barre, VT",44.274969,-72.609444,59969
684,12740,25-29,1579,1593,3172,"Barre, VT",44.274969,-72.609444,59969
685,12740,30-34,1854,1827,3681,"Barre, VT",44.274969,-72.609444,59969
686,12740,35-39,1891,1849,3740,"Barre, VT",44.274969,-72.609444,59969
687,12740,40-44,1943,1815,3758,"Barre, VT",44.274969,-72.609444,59969
688,12740,45-49,1787,1820,3607,"Barre, VT",44.274969,-72.609444,59969
689,12740,50-54,2066,1986,4052,"Barre, VT",44.274969,-72.609444,59969
690,12740,55-59,2209,2160,4369,"Barre, VT",44.274969,-72.609444,59969
691,12740,60-64,2291,2121,4412,"Barre, VT",44.274969,-72.609444,59969
692,12740,65+,6698,5762,12460,"Barre, VT",44.274969,-72.609444,59969
693,12780,15-19,1648,1782,3430,"Bartlesville, OK",36.704403,-95.906253,52772
694,12780,20-24,1458,1477,2935,"Bartlesville, OK",36.704403,-95.906253,52772
695,12780,25-29,1546,1521,3067,"Bartlesville, OK",36.704403,-95.906253,52772
696,12780,30-34,1672,1677,3349,"Bartlesville, OK",36.704403,-95.906253,52772
697,12780,35-39,1709,1802,3511,"Bartlesville, OK",36.704403,-95.906253,52772
698,12780,40-44,1523,1535,3058,"Bartlesville, OK",36.704403,-95.906253,52772
699,12780,45-49,1501,1388,2889,"Bartlesville, OK",36.704403,-95.906253,52772
700,12780,50-54,1496,1447,2943,"Bartlesville, OK",36.704403,-95.906253,52772
701,12780,55-59,1658,1462,3120,"Bartlesville, OK",36.704403,-95.906253,52772
702,12780,60-64,1876,1653,3529,"Bartlesville, OK",36.704403,-95.906253,52772
703,12780,65+,5775,4593,10368,"Bartlesville, OK",36.704403,-95.906253,52772
704,12860,15-19,1707,1840,3547,"Batavia, NY",43.00091,-78.192778,57853
705,12860,20-24,1457,1655,3112,"Batavia, NY",43.00091,-78.192778,57853
706,12860,25-29,1636,1921,3557,"Batavia, NY",43.00091,-78.192778,57853
707,12860,30-34,1709,1882,3591,"Batavia, NY",43.00091,-78.192778,57853
708,12860,35-39,1697,1873,3570,"Batavia, NY",43.00091,-78.192778,57853
709,12860,40-44,1600,1685,3285,"Batavia, NY",43.00091,-78.192778,57853
710,12860,45-49,1554,1608,3162,"Batavia, NY",43.00091,-78.192778,57853
711,12860,50-54,2009,2037,4046,"Batavia, NY",43.00091,-78.192778,57853
712,12860,55-59,2197,2242,4439,"Batavia, NY",43.00091,-78.192778,57853
713,12860,60-64,2303,2317,4620,"Batavia, NY",43.00091,-78.192778,57853
714,12860,65+,6105,5241,11346,"Batavia, NY",43.00091,-78.192778,57853
715,12900,15-19,1779,1941,3720,"Batesville, AR",35.927671,-91.515359,55345
716,12900,20-24,1513,1541,3054,"Batesville, AR",35.927671,-91.515359,55345
717,12900,25-29,1495,1569,3064,"Batesville, AR",35.927671,-91.515359,55345
718,12900,30-34,1606,1575,3181,"Batesville, AR",35.927671,-91.515359,55345
719,12900,35-39,1601,1588,3189,"Batesville, AR",35.927671,-91.515359,55345
720,12900,40-44,1571,1573,3144,"Batesville, AR",35.927671,-91.515359,55345
721,12900,45-49,1608,1662,3270,"Batesville, AR",35.927671,-91.515359,55345
722,12900,50-54,1745,1701,3446,"Batesville, AR",35.927671,-91.515359,55345
723,12900,55-59,1864,1739,3603,"Batesville, AR",35.927671,-91.515359,55345
724,12900,60-64,1993,1909,3902,"Batesville, AR",35.927671,-91.515359,55345
725,12900,65+,6112,5212,11324,"Batesville, AR",35.927671,-91.515359,55345
726,12940,15-19,29141,29536,58677,"Baton Rouge, LA",30.515242,-91.126926,871905
727,12940,20-24,35296,34514,69810,"Baton Rouge, LA",30.515242,-91.126926,871905
728,12940,25-29,30070,30031,60101,"Baton Rouge, LA",30.515242,-91.126926,871905
729,12940,30-34,29728,29599,59327,"Baton Rouge, LA",30.515242,-91.126926,871905
730,12940,35-39,30434,30106,60540,"Baton Rouge, LA",30.515242,-91.126926,871905
731,12940,40-44,28359,27687,56046,"Baton Rouge, LA",30.515242,-91.126926,871905
732,12940,45-49,24692,24561,49253,"Baton Rouge, LA",30.515242,-91.126926,871905
733,12940,50-54,26029,25476,51505,"Baton Rouge, LA",30.515242,-91.126926,871905
734,12940,55-59,27339,26013,53352,"Baton Rouge, LA",30.515242,-91.126926,871905
735,12940,60-64,27246,24944,52190,"Baton Rouge, LA",30.515242,-91.126926,871905
736,12940,65+,73557,58564,132121,"Baton Rouge, LA",30.515242,-91.126926,871905
737,12980,15-19,4179,4661,8840,"Battle Creek, MI",42.24299,-85.012385,133819
738,12980,20-24,4085,4181,8266,"Battle Creek, MI",42.24299,-85.012385,133819
739,12980,25-29,4242,4109,8351,"Battle Creek, MI",42.24299,-85.012385,133819
740,12980,30-34,4204,4059,8263,"Battle Creek, MI",42.24299,-85.012385,133819
741,12980,35-39,4096,3997,8093,"Battle Creek, MI",42.24299,-85.012385,133819
742,12980,40-44,4131,4037,8168,"Battle Creek, MI",42.24299,-85.012385,133819
743,12980,45-49,3881,3809,7690,"Battle Creek, MI",42.24299,-85.012385,133819
744,12980,50-54,4237,4254,8491,"Battle Creek, MI",42.24299,-85.012385,133819
745,12980,55-59,4412,4453,8865,"Battle Creek, MI",42.24299,-85.012385,133819
746,12980,60-64,4717,4525,9242,"Battle Creek, MI",42.24299,-85.012385,133819
747,12980,65+,13531,11026,24557,"Battle Creek, MI",42.24299,-85.012385,133819
748,13020,15-19,2898,3127,6025,"Bay City, MI",43.699711,-83.978701,102985
749,13020,20-24,2832,2942,5774,"Bay City, MI",43.699711,-83.978701,102985
750,13020,25-29,3066,3209,6275,"Bay City, MI",43.699711,-83.978701,102985
751,13020,30-34,3144,3226,6370,"Bay City, MI",43.699711,-83.978701,102985
752,13020,35-39,2977,3098,6075,"Bay City, MI",43.699711,-83.978701,102985
753,13020,40-44,3034,3047,6081,"Bay City, MI",43.699711,-83.978701,102985
754,13020,45-49,2903,2927,5830,"Bay City, MI",43.699711,-83.978701,102985
755,13020,50-54,3263,3367,6630,"Bay City, MI",43.699711,-83.978701,102985
756,13020,55-59,3802,3680,7482,"Bay City, MI",43.699711,-83.978701,102985
757,13020,60-64,4151,3906,8057,"Bay City, MI",43.699711,-83.978701,102985
758,13020,65+,12086,10008,22094,"Bay City, MI",43.699711,-83.978701,102985
759,13060,15-19,1158,1237,2395,"Bay City, TX",28.77476,-96.001532,36344
760,13060,20-24,999,1118,2117,"Bay City, TX",28.77476,-96.001532,36344
761,13060,25-29,1133,1123,2256,"Bay City, TX",28.77476,-96.001532,36344
762,13060,30-34,1167,1159,2326,"Bay City, TX",28.77476,-96.001532,36344
763,13060,35-39,1050,1147,2197,"Bay City, TX",28.77476,-96.001532,36344
764,13060,40-44,1026,1080,2106,"Bay City, TX",28.77476,-96.001532,36344
765,13060,45-49,932,872,1804,"Bay City, TX",28.77476,-96.001532,36344
766,13060,50-54,1067,978,2045,"Bay City, TX",28.77476,-96.001532,36344
767,13060,55-59,1195,1156,2351,"Bay City, TX",28.77476,-96.001532,36344
768,13060,60-64,1200,1249,2449,"Bay City, TX",28.77476,-96.001532,36344
769,13060,65+,3276,3043,6319,"Bay City, TX",28.77476,-96.001532,36344
770,13100,15-19,627,689,1316,"Beatrice, NE",40.255234,-96.683453,21616
771,13100,20-24,495,571,1066,"Beatrice, NE",40.255234,-96.683453,21616
772,13100,25-29,525,544,1069,"Beatrice, NE",40.255234,-96.683453,21616
773,13100,30-34,605,594,1199,"Beatrice, NE",40.255234,-96.683453,21616
774,13100,35-39,617,655,1272,"Beatrice, NE",40.255234,-96.683453,21616
775,13100,40-44,625,677,1302,"Beatrice, NE",40.255234,-96.683453,21616
776,13100,45-49,580,609,1189,"Beatrice, NE",40.255234,-96.683453,21616
777,13100,50-54,618,660,1278,"Beatrice, NE",40.255234,-96.683453,21616
778,13100,55-59,785,748,1533,"Beatrice, NE",40.255234,-96.683453,21616
779,13100,60-64,850,846,1696,"Beatrice, NE",40.255234,-96.683453,21616
780,13100,65+,2466,2204,4670,"Beatrice, NE",40.255234,-96.683453,21616
781,13140,15-19,12629,13350,25979,"Beaumont-Port Arthur, TX",30.075928,-94.202705,395419
782,13140,20-24,11654,12766,24420,"Beaumont-Port Arthur, TX",30.075928,-94.202705,395419
783,13140,25-29,12378,14234,26612,"Beaumont-Port Arthur, TX",30.075928,-94.202705,395419
784,13140,30-34,12823,14469,27292,"Beaumont-Port Arthur, TX",30.075928,-94.202705,395419
785,13140,35-39,12605,14397,27002,"Beaumont-Port Arthur, TX",30.075928,-94.202705,395419
786,13140,40-44,12026,13516,25542,"Beaumont-Port Arthur, TX",30.075928,-94.202705,395419
787,13140,45-49,11014,11981,22995,"Beaumont-Port Arthur, TX",30.075928,-94.202705,395419
788,13140,50-54,11047,12339,23386,"Beaumont-Port Arthur, TX",30.075928,-94.202705,395419
789,13140,55-59,12274,12335,24609,"Beaumont-Port Arthur, TX",30.075928,-94.202705,395419
790,13140,60-64,12635,12428,25063,"Beaumont-Port Arthur, TX",30.075928,-94.202705,395419
791,13140,65+,33785,27654,61439,"Beaumont-Port Arthur, TX",30.075928,-94.202705,395419
792,13180,15-19,2489,2815,5304,"Beaver Dam, WI",43.429628,-88.701939,89313
793,13180,20-24,2189,2842,5031,"Beaver Dam, WI",43.429628,-88.701939,89313
794,13180,25-29,2290,3461,5751,"Beaver Dam, WI",43.429628,-88.701939,89313
795,13180,30-34,2245,3269,5514,"Beaver Dam, WI",43.429628,-88.701939,89313
796,13180,35-39,2602,3419,6021,"Beaver Dam, WI",43.429628,-88.701939,89313
797,13180,40-44,2505,3368,5873,"Beaver Dam, WI",43.429628,-88.701939,89313
798,13180,45-49,2443,2991,5434,"Beaver Dam, WI",43.429628,-88.701939,89313
799,13180,50-54,2933,3310,6243,"Beaver Dam, WI",43.429628,-88.701939,89313
800,13180,55-59,3279,3586,6865,"Beaver Dam, WI",43.429628,-88.701939,89313
801,13180,60-64,3386,3631,7017,"Beaver Dam, WI",43.429628,-88.701939,89313
802,13180,65+,8683,7709,16392,"Beaver Dam, WI",43.429628,-88.701939,89313
803,13220,15-19,3158,3396,6554,"Beckley, WV",37.905325,-81.164436,113698
804,13220,20-24,2736,3314,6050,"Beckley, WV",37.905325,-81.164436,113698
805,13220,25-29,2961,3552,6513,"Beckley, WV",37.905325,-81.164436,113698
806,13220,30-34,3205,3721,6926,"Beckley, WV",37.905325,-81.164436,113698
807,13220,35-39,3016,3404,6420,"Beckley, WV",37.905325,-81.164436,113698
808,13220,40-44,3594,3807,7401,"Beckley, WV",37.905325,-81.164436,113698
809,13220,45-49,3524,3890,7414,"Beckley, WV",37.905325,-81.164436,113698
810,13220,50-54,3363,3706,7069,"Beckley, WV",37.905325,-81.164436,113698
811,13220,55-59,3487,3535,7022,"Beckley, WV",37.905325,-81.164436,113698
812,13220,60-64,4150,3771,7921,"Beckley, WV",37.905325,-81.164436,113698
813,13220,65+,13444,11339,24783,"Beckley, WV",37.905325,-81.164436,113698
814,13260,15-19,1342,1430,2772,"Bedford, IN",38.839815,-86.48782,45070
815,13260,20-24,1153,1329,2482,"Bedford, IN",38.839815,-86.48782,45070
816,13260,25-29,1259,1356,2615,"Bedford, IN",38.839815,-86.48782,45070
817,13260,30-34,1223,1301,2524,"Bedford, IN",38.839815,-86.48782,45070
818,13260,35-39,1319,1302,2621,"Bedford, IN",38.839815,-86.48782,45070
819,13260,40-44,1378,1327,2705,"Bedford, IN",38.839815,-86.48782,45070
820,13260,45-49,1336,1444,2780,"Bedford, IN",38.839815,-86.48782,45070
821,13260,50-54,1441,1614,3055,"Bedford, IN",38.839815,-86.48782,45070
822,13260,55-59,1704,1567,3271,"Bedford, IN",38.839815,-86.48782,45070
823,13260,60-64,1616,1631,3247,"Bedford, IN",38.839815,-86.48782,45070
824,13260,65+,4986,4208,9194,"Bedford, IN",38.839815,-86.48782,45070
825,13300,15-19,916,1119,2035,"Beeville, TX",28.416077,-97.742586,30924
826,13300,20-24,742,1784,2526,"Beeville, TX",28.416077,-97.742586,30924
827,13300,25-29,732,1860,2592,"Beeville, TX",28.416077,-97.742586,30924
828,13300,30-34,767,1943,2710,"Beeville, TX",28.416077,-97.742586,30924
829,13300,35-39,765,1876,2641,"Beeville, TX",28.416077,-97.742586,30924
830,13300,40-44,674,1634,2308,"Beeville, TX",28.416077,-97.742586,30924
831,13300,45-49,636,1434,2070,"Beeville, TX",28.416077,-97.742586,30924
832,13300,50-54,635,1119,1754,"Beeville, TX",28.416077,-97.742586,30924
833,13300,55-59,712,862,1574,"Beeville, TX",28.416077,-97.742586,30924
834,13300,60-64,695,805,1500,"Beeville, TX",28.416077,-97.742586,30924
835,13300,65+,2122,1879,4001,"Beeville, TX",28.416077,-97.742586,30924
836,13340,15-19,1440,1478,2918,"Bellefontaine, OH",40.387553,-83.766343,46035
837,13340,20-24,1184,1313,2497,"Bellefontaine, OH",40.387553,-83.766343,46035
838,13340,25-29,1292,1377,2669,"Bellefontaine, OH",40.387553,-83.766343,46035
839,13340,30-34,1286,1293,2579,"Bellefontaine, OH",40.387553,-83.766343,46035
840,13340,35-39,1350,1239,2589,"Bellefontaine, OH",40.387553,-83.766343,46035
841,13340,40-44,1407,1374,2781,"Bellefontaine, OH",40.387553,-83.766343,46035
842,13340,45-49,1382,1392,2774,"Bellefontaine, OH",40.387553,-83.766343,46035
843,13340,50-54,1484,1578,3062,"Bellefontaine, OH",40.387553,-83.766343,46035
844,13340,55-59,1688,1685,3373,"Bellefontaine, OH",40.387553,-83.766343,46035
845,13340,60-64,1685,1747,3432,"Bellefontaine, OH",40.387553,-83.766343,46035
846,13340,65+,4714,4058,8772,"Bellefontaine, OH",40.387553,-83.766343,46035
847,13380,15-19,7538,7503,15041,"Bellingham, WA",48.842653,-121.836432,228831
848,13380,20-24,11599,11178,22777,"Bellingham, WA",48.842653,-121.836432,228831
849,13380,25-29,7840,8334,16174,"Bellingham, WA",48.842653,-121.836432,228831
850,13380,30-34,7354,7957,15311,"Bellingham, WA",48.842653,-121.836432,228831
851,13380,35-39,7437,7601,15038,"Bellingham, WA",48.842653,-121.836432,228831
852,13380,40-44,7088,7178,14266,"Bellingham, WA",48.842653,-121.836432,228831
853,13380,45-49,6089,6258,12347,"Bellingham, WA",48.842653,-121.836432,228831
854,13380,50-54,6531,6546,13077,"Bellingham, WA",48.842653,-121.836432,228831
855,13380,55-59,6744,6393,13137,"Bellingham, WA",48.842653,-121.836432,228831
856,13380,60-64,7314,6848,14162,"Bellingham, WA",48.842653,-121.836432,228831
857,13380,65+,22516,19422,41938,"Bellingham, WA",48.842653,-121.836432,228831
858,13420,15-19,1761,1895,3656,"Bemidji, MN",47.879508,-95.00505,46380
859,13420,20-24,2026,2148,4174,"Bemidji, MN",47.879508,-95.00505,46380
860,13420,25-29,1400,1442,2842,"Bemidji, MN",47.879508,-95.00505,46380
861,13420,30-34,1330,1402,2732,"Bemidji, MN",47.879508,-95.00505,46380
862,13420,35-39,1401,1413,2814,"Bemidji, MN",47.879508,-95.00505,46380
863,13420,40-44,1291,1300,2591,"Bemidji, MN",47.879508,-95.00505,46380
864,13420,45-49,1063,1085,2148,"Bemidji, MN",47.879508,-95.00505,46380
865,13420,50-54,1169,1103,2272,"Bemidji, MN",47.879508,-95.00505,46380
866,13420,55-59,1346,1293,2639,"Bemidji, MN",47.879508,-95.00505,46380
867,13420,60-64,1491,1413,2904,"Bemidji, MN",47.879508,-95.00505,46380
868,13420,65+,4099,3674,7773,"Bemidji, MN",47.879508,-95.00505,46380
869,13460,15-19,5230,5806,11036,"Bend, OR",43.915118,-121.225575,204801
870,13460,20-24,4758,4922,9680,"Bend, OR",43.915118,-121.225575,204801
871,13460,25-29,6290,6597,12887,"Bend, OR",43.915118,-121.225575,204801
872,13460,30-34,7130,7280,14410,"Bend, OR",43.915118,-121.225575,204801
873,13460,35-39,7366,7507,14873,"Bend, OR",43.915118,-121.225575,204801
874,13460,40-44,6910,7052,13962,"Bend, OR",43.915118,-121.225575,204801
875,13460,45-49,6271,6576,12847,"Bend, OR",43.915118,-121.225575,204801
876,13460,50-54,6549,6545,13094,"Bend, OR",43.915118,-121.225575,204801
877,13460,55-59,6575,6145,12720,"Bend, OR",43.915118,-121.225575,204801
878,13460,60-64,7781,6989,14770,"Bend, OR",43.915118,-121.225575,204801
879,13460,65+,22008,20098,42106,"Bend, OR",43.915118,-121.225575,204801
880,13500,15-19,683,699,1382,"Bennettsville, SC",34.60167,-79.679435,26382
881,13500,20-24,687,875,1562,"Bennettsville, SC",34.60167,-79.679435,26382
882,13500,25-29,712,1157,1869,"Bennettsville, SC",34.60167,-79.679435,26382
883,13500,30-34,694,1183,1877,"Bennettsville, SC",34.60167,-79.679435,26382
884,13500,35-39,657,1021,1678,"Bennettsville, SC",34.60167,-79.679435,26382
885,13500,40-44,739,907,1646,"Bennettsville, SC",34.60167,-79.679435,26382
886,13500,45-49,761,841,1602,"Bennettsville, SC",34.60167,-79.679435,26382
887,13500,50-54,803,865,1668,"Bennettsville, SC",34.60167,-79.679435,26382
888,13500,55-59,952,911,1863,"Bennettsville, SC",34.60167,-79.679435,26382
889,13500,60-64,919,917,1836,"Bennettsville, SC",34.60167,-79.679435,26382
890,13500,65+,2847,2143,4990,"Bennettsville, SC",34.60167,-79.679435,26382
891,13540,15-19,1205,1287,2492,"Bennington, VT",43.035325,-73.11146,37312
892,13540,20-24,1225,1083,2308,"Bennington, VT",43.035325,-73.11146,37312
893,13540,25-29,865,928,1793,"Bennington, VT",43.035325,-73.11146,37312
894,13540,30-34,888,919,1807,"Bennington, VT",43.035325,-73.11146,37312
895,13540,35-39,1031,973,2004,"Bennington, VT",43.035325,-73.11146,37312
896,13540,40-44,1002,978,1980,"Bennington, VT",43.035325,-73.11146,37312
897,13540,45-49,949,976,1925,"Bennington, VT",43.035325,-73.11146,37312
898,13540,50-54,1350,1212,2562,"Bennington, VT",43.035325,-73.11146,37312
899,13540,55-59,1455,1414,2869,"Bennington, VT",43.035325,-73.11146,37312
900,13540,60-64,1587,1567,3154,"Bennington, VT",43.035325,-73.11146,37312
901,13540,65+,4759,4083,8842,"Bennington, VT",43.035325,-73.11146,37312
902,13620,15-19,707,773,1480,"Berlin, NH",44.652548,-71.289431,31289
903,13620,20-24,642,911,1553,"Berlin, NH",44.652548,-71.289431,31289
904,13620,25-29,697,1048,1745,"Berlin, NH",44.652548,-71.289431,31289
905,13620,30-34,715,972,1687,"Berlin, NH",44.652548,-71.289431,31289
906,13620,35-39,772,956,1728,"Berlin, NH",44.652548,-71.289431,31289
907,13620,40-44,818,949,1767,"Berlin, NH",44.652548,-71.289431,31289
908,13620,45-49,855,1018,1873,"Berlin, NH",44.652548,-71.289431,31289
909,13620,50-54,987,1242,2229,"Berlin, NH",44.652548,-71.289431,31289
910,13620,55-59,1282,1306,2588,"Berlin, NH",44.652548,-71.289431,31289
911,13620,60-64,1328,1438,2766,"Berlin, NH",44.652548,-71.289431,31289
912,13620,65+,3984,3780,7764,"Berlin, NH",44.652548,-71.289431,31289
913,13660,15-19,1910,1924,3834,"Big Rapids, MI",43.635295,-85.332751,40031
914,13660,20-24,2185,2622,4807,"Big Rapids, MI",43.635295,-85.332751,40031
915,13660,25-29,1010,1175,2185,"Big Rapids, MI",43.635295,-85.332751,40031
916,13660,30-34,1021,1080,2101,"Big Rapids, MI",43.635295,-85.332751,40031
917,13660,35-39,942,955,1897,"Big Rapids, MI",43.635295,-85.332751,40031
918,13660,40-44,946,1018,1964,"Big Rapids, MI",43.635295,-85.332751,40031
919,13660,45-49,945,899,1844,"Big Rapids, MI",43.635295,-85.332751,40031
920,13660,50-54,1089,1100,2189,"Big Rapids, MI",43.635295,-85.332751,40031
921,13660,55-59,1276,1290,2566,"Big Rapids, MI",43.635295,-85.332751,40031
922,13660,60-64,1483,1504,2987,"Big Rapids, MI",43.635295,-85.332751,40031
923,13660,65+,4019,3596,7615,"Big Rapids, MI",43.635295,-85.332751,40031
924,13700,15-19,931,1320,2251,"Big Spring, TX",32.30343,-101.438721,34128
925,13700,20-24,865,1438,2303,"Big Spring, TX",32.30343,-101.438721,34128
926,13700,25-29,975,1543,2518,"Big Spring, TX",32.30343,-101.438721,34128
927,13700,30-34,1121,1695,2816,"Big Spring, TX",32.30343,-101.438721,34128
928,13700,35-39,1058,1371,2429,"Big Spring, TX",32.30343,-101.438721,34128
929,13700,40-44,862,1492,2354,"Big Spring, TX",32.30343,-101.438721,34128
930,13700,45-49,828,1715,2543,"Big Spring, TX",32.30343,-101.438721,34128
931,13700,50-54,850,1790,2640,"Big Spring, TX",32.30343,-101.438721,34128
932,13700,55-59,836,1159,1995,"Big Spring, TX",32.30343,-101.438721,34128
933,13700,60-64,857,975,1832,"Big Spring, TX",32.30343,-101.438721,34128
934,13700,65+,2287,2144,4431,"Big Spring, TX",32.30343,-101.438721,34128
935,13720,15-19,1138,1224,2362,"Big Stone Gap, VA",36.974561,-82.62156,39313
936,13720,20-24,1021,1494,2515,"Big Stone Gap, VA",36.974561,-82.62156,39313
937,13720,25-29,1049,1576,2625,"Big Stone Gap, VA",36.974561,-82.62156,39313
938,13720,30-34,1151,1570,2721,"Big Stone Gap, VA",36.974561,-82.62156,39313
939,13720,35-39,1067,1321,2388,"Big Stone Gap, VA",36.974561,-82.62156,39313
940,13720,40-44,1083,1318,2401,"Big Stone Gap, VA",36.974561,-82.62156,39313
941,13720,45-49,1212,1347,2559,"Big Stone Gap, VA",36.974561,-82.62156,39313
942,13720,50-54,1257,1386,2643,"Big Stone Gap, VA",36.974561,-82.62156,39313
943,13720,55-59,1187,1266,2453,"Big Stone Gap, VA",36.974561,-82.62156,39313
944,13720,60-64,1432,1262,2694,"Big Stone Gap, VA",36.974561,-82.62156,39313
945,13720,65+,4110,3454,7564,"Big Stone Gap, VA",36.974561,-82.62156,39313
946,13740,15-19,5732,5857,11589,"Billings, MT",45.63714,-108.832361,187037
947,13740,20-24,5132,5282,10414,"Billings, MT",45.63714,-108.832361,187037
948,13740,25-29,6114,6211,12325,"Billings, MT",45.63714,-108.832361,187037
949,13740,30-34,6311,6310,12621,"Billings, MT",45.63714,-108.832361,187037
950,13740,35-39,6316,6475,12791,"Billings, MT",45.63714,-108.832361,187037
951,13740,40-44,5913,6056,11969,"Billings, MT",45.63714,-108.832361,187037
952,13740,45-49,5180,5247,10427,"Billings, MT",45.63714,-108.832361,187037
953,13740,50-54,5307,5534,10841,"Billings, MT",45.63714,-108.832361,187037
954,13740,55-59,5934,5791,11725,"Billings, MT",45.63714,-108.832361,187037
955,13740,60-64,6574,6313,12887,"Billings, MT",45.63714,-108.832361,187037
956,13740,65+,18508,15960,34468,"Billings, MT",45.63714,-108.832361,187037
957,13780,15-19,8513,9350,17863,"Binghamton, NY",42.163928,-76.022943,245220
958,13780,20-24,10749,11326,22075,"Binghamton, NY",42.163928,-76.022943,245220
959,13780,25-29,7025,7292,14317,"Binghamton, NY",42.163928,-76.022943,245220
960,13780,30-34,6561,6700,13261,"Binghamton, NY",42.163928,-76.022943,245220
961,13780,35-39,6924,6917,13841,"Binghamton, NY",42.163928,-76.022943,245220
962,13780,40-44,6525,6691,13216,"Binghamton, NY",42.163928,-76.022943,245220
963,13780,45-49,6100,6041,12141,"Binghamton, NY",42.163928,-76.022943,245220
964,13780,50-54,7309,7309,14618,"Binghamton, NY",42.163928,-76.022943,245220
965,13780,55-59,8680,8349,17029,"Binghamton, NY",42.163928,-76.022943,245220
966,13780,60-64,9252,9133,18385,"Binghamton, NY",42.163928,-76.022943,245220
967,13780,65+,26775,22344,49119,"Binghamton, NY",42.163928,-76.022943,245220
968,13820,15-19,35108,35642,70750,"Birmingham-Hoover, AL",33.402599,-86.729515,1114262
969,13820,20-24,34124,32756,66880,"Birmingham-Hoover, AL",33.402599,-86.729515,1114262
970,13820,25-29,37629,35994,73623,"Birmingham-Hoover, AL",33.402599,-86.729515,1114262
971,13820,30-34,39577,37334,76911,"Birmingham-Hoover, AL",33.402599,-86.729515,1114262
972,13820,35-39,38082,35350,73432,"Birmingham-Hoover, AL",33.402599,-86.729515,1114262
973,13820,40-44,37376,34955,72331,"Birmingham-Hoover, AL",33.402599,-86.729515,1114262
974,13820,45-49,35131,33599,68730,"Birmingham-Hoover, AL",33.402599,-86.729515,1114262
975,13820,50-54,36145,34686,70831,"Birmingham-Hoover, AL",33.402599,-86.729515,1114262
976,13820,55-59,36999,34342,71341,"Birmingham-Hoover, AL",33.402599,-86.729515,1114262
977,13820,60-64,37822,33812,71634,"Birmingham-Hoover, AL",33.402599,-86.729515,1114262
978,13820,65+,106135,81525,187660,"Birmingham-Hoover, AL",33.402599,-86.729515,1114262
979,13900,15-19,4345,4350,8695,"Bismarck, ND",46.887031,-100.979592,134417
980,13900,20-24,3809,4057,7866,"Bismarck, ND",46.887031,-100.979592,134417
981,13900,25-29,4199,4554,8753,"Bismarck, ND",46.887031,-100.979592,134417
982,13900,30-34,4540,4946,9486,"Bismarck, ND",46.887031,-100.979592,134417
983,13900,35-39,4602,5193,9795,"Bismarck, ND",46.887031,-100.979592,134417
984,13900,40-44,4034,4648,8682,"Bismarck, ND",46.887031,-100.979592,134417
985,13900,45-49,3561,3800,7361,"Bismarck, ND",46.887031,-100.979592,134417
986,13900,50-54,3455,3760,7215,"Bismarck, ND",46.887031,-100.979592,134417
987,13900,55-59,3981,4060,8041,"Bismarck, ND",46.887031,-100.979592,134417
988,13900,60-64,4486,4273,8759,"Bismarck, ND",46.887031,-100.979592,134417
989,13900,65+,12617,10551,23168,"Bismarck, ND",46.887031,-100.979592,134417
990,13940,15-19,1999,2054,4053,"Blackfoot, ID",43.216357,-112.399206,48876
991,13940,20-24,1403,1555,2958,"Blackfoot, ID",43.216357,-112.399206,48876
992,13940,25-29,1407,1400,2807,"Blackfoot, ID",43.216357,-112.399206,48876
993,13940,30-34,1498,1443,2941,"Blackfoot, ID",43.216357,-112.399206,48876
994,13940,35-39,1640,1567,3207,"Blackfoot, ID",43.216357,-112.399206,48876
995,13940,40-44,1535,1603,3138,"Blackfoot, ID",43.216357,-112.399206,48876
996,13940,45-49,1281,1378,2659,"Blackfoot, ID",43.216357,-112.399206,48876
997,13940,50-54,1246,1222,2468,"Blackfoot, ID",43.216357,-112.399206,48876
998,13940,55-59,1322,1352,2674,"Blackfoot, ID",43.216357,-112.399206,48876
999,13940,60-64,1440,1438,2878,"Blackfoot, ID",43.216357,-112.399206,48876
1000,13940,65+,3685,3520,7205,"Blackfoot, ID",43.216357,-112.399206,48876
1001,13980,15-19,7817,8384,16201,"Blacksburg-Christiansburg, VA",37.120119,-80.559147,165293
1002,13980,20-24,11139,13515,24654,"Blacksburg-Christiansburg, VA",37.120119,-80.559147,165293
1003,13980,25-29,5021,5769,10790,"Blacksburg-Christiansburg, VA",37.120119,-80.559147,165293
1004,13980,30-34,4776,5157,9933,"Blacksburg-Christiansburg, VA",37.120119,-80.559147,165293
1005,13980,35-39,4315,4601,8916,"Blacksburg-Christiansburg, VA",37.120119,-80.559147,165293
1006,13980,40-44,4079,4351,8430,"Blacksburg-Christiansburg, VA",37.120119,-80.559147,165293
1007,13980,45-49,4396,4590,8986,"Blacksburg-Christiansburg, VA",37.120119,-80.559147,165293
1008,13980,50-54,4743,4963,9706,"Blacksburg-Christiansburg, VA",37.120119,-80.559147,165293
1009,13980,55-59,4864,4899,9763,"Blacksburg-Christiansburg, VA",37.120119,-80.559147,165293
1010,13980,60-64,4766,4480,9246,"Blacksburg-Christiansburg, VA",37.120119,-80.559147,165293
1011,13980,65+,14652,12164,26816,"Blacksburg-Christiansburg, VA",37.120119,-80.559147,165293
1012,14010,15-19,7887,6992,14879,"Bloomington, IL",40.494559,-88.844539,170889
1013,14010,20-24,11015,10308,21323,"Bloomington, IL",40.494559,-88.844539,170889
1014,14010,25-29,5520,5630,11150,"Bloomington, IL",40.494559,-88.844539,170889
1015,14010,30-34,5202,5145,10347,"Bloomington, IL",40.494559,-88.844539,170889
1016,14010,35-39,5296,5344,10640,"Bloomington, IL",40.494559,-88.844539,170889
1017,14010,40-44,5163,5203,10366,"Bloomington, IL",40.494559,-88.844539,170889
1018,14010,45-49,4536,4590,9126,"Bloomington, IL",40.494559,-88.844539,170889
1019,14010,50-54,4812,4716,9528,"Bloomington, IL",40.494559,-88.844539,170889
1020,14010,55-59,5081,4860,9941,"Bloomington, IL",40.494559,-88.844539,170889
1021,14010,60-64,4892,4676,9568,"Bloomington, IL",40.494559,-88.844539,170889
1022,14010,65+,13390,10870,24260,"Bloomington, IL",40.494559,-88.844539,170889
1023,14020,15-19,7960,7700,15660,"Bloomington, IN",39.241736,-86.671754,161321
1024,14020,20-24,13443,13442,26885,"Bloomington, IN",39.241736,-86.671754,161321
1025,14020,25-29,5523,6214,11737,"Bloomington, IN",39.241736,-86.671754,161321
1026,14020,30-34,4791,5243,10034,"Bloomington, IN",39.241736,-86.671754,161321
1027,14020,35-39,4398,4641,9039,"Bloomington, IN",39.241736,-86.671754,161321
1028,14020,40-44,4371,4484,8855,"Bloomington, IN",39.241736,-86.671754,161321
1029,14020,45-49,3903,3862,7765,"Bloomington, IN",39.241736,-86.671754,161321
1030,14020,50-54,4096,4094,8190,"Bloomington, IN",39.241736,-86.671754,161321
1031,14020,55-59,4331,4293,8624,"Bloomington, IN",39.241736,-86.671754,161321
1032,14020,60-64,4614,4369,8983,"Bloomington, IN",39.241736,-86.671754,161321
1033,14020,65+,13071,10860,23931,"Bloomington, IN",39.241736,-86.671754,161321
1034,14100,15-19,3275,2988,6263,"Bloomsburg-Berwick, PA",41.040404,-76.461654,82959
1035,14100,20-24,3968,3362,7330,"Bloomsburg-Berwick, PA",41.040404,-76.461654,82959
1036,14100,25-29,2272,2413,4685,"Bloomsburg-Berwick, PA",41.040404,-76.461654,82959
1037,14100,30-34,2342,2580,4922,"Bloomsburg-Berwick, PA",41.040404,-76.461654,82959
1038,14100,35-39,2315,2306,4621,"Bloomsburg-Berwick, PA",41.040404,-76.461654,82959
1039,14100,40-44,2163,2284,4447,"Bloomsburg-Berwick, PA",41.040404,-76.461654,82959
1040,14100,45-49,2252,2313,4565,"Bloomsburg-Berwick, PA",41.040404,-76.461654,82959
1041,14100,50-54,2539,2600,5139,"Bloomsburg-Berwick, PA",41.040404,-76.461654,82959
1042,14100,55-59,2867,2784,5651,"Bloomsburg-Berwick, PA",41.040404,-76.461654,82959
1043,14100,60-64,3049,2912,5961,"Bloomsburg-Berwick, PA",41.040404,-76.461654,82959
1044,14100,65+,9485,7511,16996,"Bloomsburg-Berwick, PA",41.040404,-76.461654,82959
1045,14140,15-19,2901,3069,5970,"Bluefield, WV-VA",37.208488,-81.33484,105195
1046,14140,20-24,2771,2966,5737,"Bluefield, WV-VA",37.208488,-81.33484,105195
1047,14140,25-29,2827,3236,6063,"Bluefield, WV-VA",37.208488,-81.33484,105195
1048,14140,30-34,2903,3213,6116,"Bluefield, WV-VA",37.208488,-81.33484,105195
1049,14140,35-39,2704,2961,5665,"Bluefield, WV-VA",37.208488,-81.33484,105195
1050,14140,40-44,3153,3257,6410,"Bluefield, WV-VA",37.208488,-81.33484,105195
1051,14140,45-49,3193,3351,6544,"Bluefield, WV-VA",37.208488,-81.33484,105195
1052,14140,50-54,3320,3421,6741,"Bluefield, WV-VA",37.208488,-81.33484,105195
1053,14140,55-59,3553,3314,6867,"Bluefield, WV-VA",37.208488,-81.33484,105195
1054,14140,60-64,3926,3530,7456,"Bluefield, WV-VA",37.208488,-81.33484,105195
1055,14140,65+,13410,10817,24227,"Bluefield, WV-VA",37.208488,-81.33484,105195
1056,14160,15-19,870,972,1842,"Bluffton, IN",40.735273,-85.212974,28197
1057,14160,20-24,683,791,1474,"Bluffton, IN",40.735273,-85.212974,28197
1058,14160,25-29,840,848,1688,"Bluffton, IN",40.735273,-85.212974,28197
1059,14160,30-34,804,814,1618,"Bluffton, IN",40.735273,-85.212974,28197
1060,14160,35-39,844,855,1699,"Bluffton, IN",40.735273,-85.212974,28197
1061,14160,40-44,819,871,1690,"Bluffton, IN",40.735273,-85.212974,28197
1062,14160,45-49,728,783,1511,"Bluffton, IN",40.735273,-85.212974,28197
1063,14160,50-54,833,858,1691,"Bluffton, IN",40.735273,-85.212974,28197
1064,14160,55-59,951,941,1892,"Bluffton, IN",40.735273,-85.212974,28197
1065,14160,60-64,1023,1014,2037,"Bluffton, IN",40.735273,-85.212974,28197
1066,14160,65+,2906,2357,5263,"Bluffton, IN",40.735273,-85.212974,28197
1067,14180,15-19,1332,1449,2781,"Blytheville, AR",35.766944,-90.052207,39661
1068,14180,20-24,1231,1299,2530,"Blytheville, AR",35.766944,-90.052207,39661
1069,14180,25-29,1248,1261,2509,"Blytheville, AR",35.766944,-90.052207,39661
1070,14180,30-34,1284,1245,2529,"Blytheville, AR",35.766944,-90.052207,39661
1071,14180,35-39,1225,1152,2377,"Blytheville, AR",35.766944,-90.052207,39661
1072,14180,40-44,1276,1179,2455,"Blytheville, AR",35.766944,-90.052207,39661
1073,14180,45-49,1201,1070,2271,"Blytheville, AR",35.766944,-90.052207,39661
1074,14180,50-54,1176,1117,2293,"Blytheville, AR",35.766944,-90.052207,39661
1075,14180,55-59,1348,1276,2624,"Blytheville, AR",35.766944,-90.052207,39661
1076,14180,60-64,1304,1299,2603,"Blytheville, AR",35.766944,-90.052207,39661
1077,14180,65+,3424,2703,6127,"Blytheville, AR",35.766944,-90.052207,39661
1078,14220,15-19,1359,1527,2886,"Bogalusa, LA",30.852144,-90.046253,45133
1079,14220,20-24,1270,1365,2635,"Bogalusa, LA",30.852144,-90.046253,45133
1080,14220,25-29,1312,1333,2645,"Bogalusa, LA",30.852144,-90.046253,45133
1081,14220,30-34,1359,1397,2756,"Bogalusa, LA",30.852144,-90.046253,45133
1082,14220,35-39,1334,1434,2768,"Bogalusa, LA",30.852144,-90.046253,45133
1083,14220,40-44,1394,1412,2806,"Bogalusa, LA",30.852144,-90.046253,45133
1084,14220,45-49,1262,1352,2614,"Bogalusa, LA",30.852144,-90.046253,45133
1085,14220,50-54,1315,1317,2632,"Bogalusa, LA",30.852144,-90.046253,45133
1086,14220,55-59,1451,1396,2847,"Bogalusa, LA",30.852144,-90.046253,45133
1087,14220,60-64,1633,1492,3125,"Bogalusa, LA",30.852144,-90.046253,45133
1088,14220,65+,4718,3870,8588,"Bogalusa, LA",30.852144,-90.046253,45133
1089,14260,15-19,26899,28600,55499,"Boise City, ID",43.006648,-116.141909,795268
1090,14260,20-24,23632,25139,48771,"Boise City, ID",43.006648,-116.141909,795268
1091,14260,25-29,25930,27833,53763,"Boise City, ID",43.006648,-116.141909,795268
1092,14260,30-34,27779,27914,55693,"Boise City, ID",43.006648,-116.141909,795268
1093,14260,35-39,27843,28631,56474,"Boise City, ID",43.006648,-116.141909,795268
1094,14260,40-44,27004,27844,54848,"Boise City, ID",43.006648,-116.141909,795268
1095,14260,45-49,23789,25156,48945,"Boise City, ID",43.006648,-116.141909,795268
1096,14260,50-54,23639,25092,48731,"Boise City, ID",43.006648,-116.141909,795268
1097,14260,55-59,23901,23444,47345,"Boise City, ID",43.006648,-116.141909,795268
1098,14260,60-64,24241,23065,47306,"Boise City, ID",43.006648,-116.141909,795268
1099,14260,65+,65449,57635,123084,"Boise City, ID",43.006648,-116.141909,795268
1100,14300,15-19,1037,1235,2272,"Bonham, TX",33.591161,-96.104988,36569
1101,14300,20-24,816,1323,2139,"Bonham, TX",33.591161,-96.104988,36569
1102,14300,25-29,885,1395,2280,"Bonham, TX",33.591161,-96.104988,36569
1103,14300,30-34,1027,1331,2358,"Bonham, TX",33.591161,-96.104988,36569
1104,14300,35-39,1059,1368,2427,"Bonham, TX",33.591161,-96.104988,36569
1105,14300,40-44,1033,1310,2343,"Bonham, TX",33.591161,-96.104988,36569
1106,14300,45-49,1022,1231,2253,"Bonham, TX",33.591161,-96.104988,36569
1107,14300,50-54,1140,1291,2431,"Bonham, TX",33.591161,-96.104988,36569
1108,14300,55-59,1211,1347,2558,"Bonham, TX",33.591161,-96.104988,36569
1109,14300,60-64,1273,1275,2548,"Bonham, TX",33.591161,-96.104988,36569
1110,14300,65+,3436,3191,6627,"Bonham, TX",33.591161,-96.104988,36569
1111,14380,15-19,3060,2711,5771,"Boone, NC",36.235368,-81.709888,54234
1112,14380,20-24,5047,5241,10288,"Boone, NC",36.235368,-81.709888,54234
1113,14380,25-29,1518,1660,3178,"Boone, NC",36.235368,-81.709888,54234
1114,14380,30-34,1251,1307,2558,"Boone, NC",36.235368,-81.709888,54234
1115,14380,35-39,1241,1361,2602,"Boone, NC",36.235368,-81.709888,54234
1116,14380,40-44,1285,1391,2676,"Boone, NC",36.235368,-81.709888,54234
1117,14380,45-49,1318,1368,2686,"Boone, NC",36.235368,-81.709888,54234
1118,14380,50-54,1410,1498,2908,"Boone, NC",36.235368,-81.709888,54234
1119,14380,55-59,1631,1538,3169,"Boone, NC",36.235368,-81.709888,54234
1120,14380,60-64,1817,1636,3453,"Boone, NC",36.235368,-81.709888,54234
1121,14380,65+,4976,4485,9461,"Boone, NC",36.235368,-81.709888,54234
1122,14420,15-19,724,721,1445,"Borger, TX",35.837047,-101.362746,20495
1123,14420,20-24,607,606,1213,"Borger, TX",35.837047,-101.362746,20495
1124,14420,25-29,560,623,1183,"Borger, TX",35.837047,-101.362746,20495
1125,14420,30-34,578,596,1174,"Borger, TX",35.837047,-101.362746,20495
1126,14420,35-39,665,713,1378,"Borger, TX",35.837047,-101.362746,20495
1127,14420,40-44,639,684,1323,"Borger, TX",35.837047,-101.362746,20495
1128,14420,45-49,597,636,1233,"Borger, TX",35.837047,-101.362746,20495
1129,14420,50-54,536,579,1115,"Borger, TX",35.837047,-101.362746,20495
1130,14420,55-59,584,608,1192,"Borger, TX",35.837047,-101.362746,20495
1131,14420,60-64,686,720,1406,"Borger, TX",35.837047,-101.362746,20495
1132,14420,65+,1878,1770,3648,"Borger, TX",35.837047,-101.362746,20495
1133,14460,15-19,158360,158191,316551,"Boston-Cambridge-Newton, MA-NH",42.517606,-71.021993,4899932
1134,14460,20-24,171195,165808,337003,"Boston-Cambridge-Newton, MA-NH",42.517606,-71.021993,4899932
1135,14460,25-29,179225,181861,361086,"Boston-Cambridge-Newton, MA-NH",42.517606,-71.021993,4899932
1136,14460,30-34,182057,183457,365514,"Boston-Cambridge-Newton, MA-NH",42.517606,-71.021993,4899932
1137,14460,35-39,170311,169811,340122,"Boston-Cambridge-Newton, MA-NH",42.517606,-71.021993,4899932
1138,14460,40-44,153769,151671,305440,"Boston-Cambridge-Newton, MA-NH",42.517606,-71.021993,4899932
1139,14460,45-49,147392,143517,290909,"Boston-Cambridge-Newton, MA-NH",42.517606,-71.021993,4899932
1140,14460,50-54,166307,160112,326419,"Boston-Cambridge-Newton, MA-NH",42.517606,-71.021993,4899932
1141,14460,55-59,174405,167930,342335,"Boston-Cambridge-Newton, MA-NH",42.517606,-71.021993,4899932
1142,14460,60-64,165910,157201,323111,"Boston-Cambridge-Newton, MA-NH",42.517606,-71.021993,4899932
1143,14460,65+,453087,357605,810692,"Boston-Cambridge-Newton, MA-NH",42.517606,-71.021993,4899932
1144,14500,15-19,13130,13398,26528,"Boulder, CO",40.094962,-105.397704,329543
1145,14500,20-24,15503,17117,32620,"Boulder, CO",40.094962,-105.397704,329543
1146,14500,25-29,10649,12418,23067,"Boulder, CO",40.094962,-105.397704,329543
1147,14500,30-34,10425,11849,22274,"Boulder, CO",40.094962,-105.397704,329543
1148,14500,35-39,10025,11172,21197,"Boulder, CO",40.094962,-105.397704,329543
1149,14500,40-44,10488,10577,21065,"Boulder, CO",40.094962,-105.397704,329543
1150,14500,45-49,10205,10242,20447,"Boulder, CO",40.094962,-105.397704,329543
1151,14500,50-54,10520,10934,21454,"Boulder, CO",40.094962,-105.397704,329543
1152,14500,55-59,10220,10000,20220,"Boulder, CO",40.094962,-105.397704,329543
1153,14500,60-64,10372,10169,20541,"Boulder, CO",40.094962,-105.397704,329543
1154,14500,65+,28202,24286,52488,"Boulder, CO",40.094962,-105.397704,329543
1155,14540,15-19,7159,7064,14223,"Bowling Green, KY",37.046804,-86.397398,182594
1156,14540,20-24,8643,8832,17475,"Bowling Green, KY",37.046804,-86.397398,182594
1157,14540,25-29,6058,6510,12568,"Bowling Green, KY",37.046804,-86.397398,182594
1158,14540,30-34,5820,5834,11654,"Bowling Green, KY",37.046804,-86.397398,182594
1159,14540,35-39,5513,5531,11044,"Bowling Green, KY",37.046804,-86.397398,182594
1160,14540,40-44,5727,5607,11334,"Bowling Green, KY",37.046804,-86.397398,182594
1161,14540,45-49,5325,5476,10801,"Bowling Green, KY",37.046804,-86.397398,182594
1162,14540,50-54,5315,5327,10642,"Bowling Green, KY",37.046804,-86.397398,182594
1163,14540,55-59,5608,5555,11163,"Bowling Green, KY",37.046804,-86.397398,182594
1164,14540,60-64,5319,4998,10317,"Bowling Green, KY",37.046804,-86.397398,182594
1165,14540,65+,14655,12316,26971,"Bowling Green, KY",37.046804,-86.397398,182594
1166,14580,15-19,4030,4382,8412,"Bozeman, MT",45.518054,-111.163921,122713
1167,14580,20-24,6551,8059,14610,"Bozeman, MT",45.518054,-111.163921,122713
1168,14580,25-29,4828,6161,10989,"Bozeman, MT",45.518054,-111.163921,122713
1169,14580,30-34,4433,4969,9402,"Bozeman, MT",45.518054,-111.163921,122713
1170,14580,35-39,4349,4774,9123,"Bozeman, MT",45.518054,-111.163921,122713
1171,14580,40-44,3932,4484,8416,"Bozeman, MT",45.518054,-111.163921,122713
1172,14580,45-49,3242,3598,6840,"Bozeman, MT",45.518054,-111.163921,122713
1173,14580,50-54,2906,3244,6150,"Bozeman, MT",45.518054,-111.163921,122713
1174,14580,55-59,3035,3131,6166,"Bozeman, MT",45.518054,-111.163921,122713
1175,14580,60-64,3316,3344,6660,"Bozeman, MT",45.518054,-111.163921,122713
1176,14580,65+,8344,7974,16318,"Bozeman, MT",45.518054,-111.163921,122713
1177,14620,15-19,1269,1420,2689,"Bradford, PA",41.81459,-78.572463,39941
1178,14620,20-24,1135,1256,2391,"Bradford, PA",41.81459,-78.572463,39941
1179,14620,25-29,1014,1331,2345,"Bradford, PA",41.81459,-78.572463,39941
1180,14620,30-34,1034,1407,2441,"Bradford, PA",41.81459,-78.572463,39941
1181,14620,35-39,1041,1356,2397,"Bradford, PA",41.81459,-78.572463,39941
1182,14620,40-44,1061,1191,2252,"Bradford, PA",41.81459,-78.572463,39941
1183,14620,45-49,1154,1273,2427,"Bradford, PA",41.81459,-78.572463,39941
1184,14620,50-54,1271,1420,2691,"Bradford, PA",41.81459,-78.572463,39941
1185,14620,55-59,1363,1442,2805,"Bradford, PA",41.81459,-78.572463,39941
1186,14620,60-64,1571,1545,3116,"Bradford, PA",41.81459,-78.572463,39941
1187,14620,65+,4309,3730,8039,"Bradford, PA",41.81459,-78.572463,39941
1188,14660,15-19,2660,2936,5596,"Brainerd, MN",46.767291,-94.223862,97909
1189,14660,20-24,2133,2256,4389,"Brainerd, MN",46.767291,-94.223862,97909
1190,14660,25-29,2455,2458,4913,"Brainerd, MN",46.767291,-94.223862,97909
1191,14660,30-34,2492,2558,5050,"Brainerd, MN",46.767291,-94.223862,97909
1192,14660,35-39,2804,2891,5695,"Brainerd, MN",46.767291,-94.223862,97909
1193,14660,40-44,2655,2882,5537,"Brainerd, MN",46.767291,-94.223862,97909
1194,14660,45-49,2306,2464,4770,"Brainerd, MN",46.767291,-94.223862,97909
1195,14660,50-54,2790,2870,5660,"Brainerd, MN",46.767291,-94.223862,97909
1196,14660,55-59,3557,3654,7211,"Brainerd, MN",46.767291,-94.223862,97909
1197,14660,60-64,4299,4188,8487,"Brainerd, MN",46.767291,-94.223862,97909
1198,14660,65+,12116,11768,23884,"Brainerd, MN",46.767291,-94.223862,97909
1199,14700,15-19,1813,1869,3682,"Branson, MO",36.649827,-93.042819,56387
1200,14700,20-24,1830,1806,3636,"Branson, MO",36.649827,-93.042819,56387
1201,14700,25-29,1577,1583,3160,"Branson, MO",36.649827,-93.042819,56387
1202,14700,30-34,1494,1420,2914,"Branson, MO",36.649827,-93.042819,56387
1203,14700,35-39,1605,1431,3036,"Branson, MO",36.649827,-93.042819,56387
1204,14700,40-44,1678,1550,3228,"Branson, MO",36.649827,-93.042819,56387
1205,14700,45-49,1582,1527,3109,"Branson, MO",36.649827,-93.042819,56387
1206,14700,50-54,1697,1586,3283,"Branson, MO",36.649827,-93.042819,56387
1207,14700,55-59,1930,1826,3756,"Branson, MO",36.649827,-93.042819,56387
1208,14700,60-64,2126,1930,4056,"Branson, MO",36.649827,-93.042819,56387
1209,14700,65+,6880,5960,12840,"Branson, MO",36.649827,-93.042819,56387
1210,14720,15-19,558,711,1269,"Breckenridge, CO",39.621023,-106.137555,30941
1211,14720,20-24,604,752,1356,"Breckenridge, CO",39.621023,-106.137555,30941
1212,14720,25-29,1252,1631,2883,"Breckenridge, CO",39.621023,-106.137555,30941
1213,14720,30-34,1287,1738,3025,"Breckenridge, CO",39.621023,-106.137555,30941
1214,14720,35-39,1143,1462,2605,"Breckenridge, CO",39.621023,-106.137555,30941
1215,14720,40-44,1009,1229,2238,"Breckenridge, CO",39.621023,-106.137555,30941
1216,14720,45-49,946,1215,2161,"Breckenridge, CO",39.621023,-106.137555,30941
1217,14720,50-54,1005,1256,2261,"Breckenridge, CO",39.621023,-106.137555,30941
1218,14720,55-59,986,1165,2151,"Breckenridge, CO",39.621023,-106.137555,30941
1219,14720,60-64,1035,1175,2210,"Breckenridge, CO",39.621023,-106.137555,30941
1220,14720,65+,2213,2518,4731,"Breckenridge, CO",39.621023,-106.137555,30941
1221,14740,15-19,7066,7715,14781,"Bremerton-Silverdale-Port Orchard, WA",47.639595,-122.649634,274314
1222,14740,20-24,7293,11598,18891,"Bremerton-Silverdale-Port Orchard, WA",47.639595,-122.649634,274314
1223,14740,25-29,8757,11064,19821,"Bremerton-Silverdale-Port Orchard, WA",47.639595,-122.649634,274314
1224,14740,30-34,9360,10488,19848,"Bremerton-Silverdale-Port Orchard, WA",47.639595,-122.649634,274314
1225,14740,35-39,8997,10146,19143,"Bremerton-Silverdale-Port Orchard, WA",47.639595,-122.649634,274314
1226,14740,40-44,8184,8593,16777,"Bremerton-Silverdale-Port Orchard, WA",47.639595,-122.649634,274314
1227,14740,45-49,7025,7350,14375,"Bremerton-Silverdale-Port Orchard, WA",47.639595,-122.649634,274314
1228,14740,50-54,8064,8096,16160,"Bremerton-Silverdale-Port Orchard, WA",47.639595,-122.649634,274314
1229,14740,55-59,9006,8866,17872,"Bremerton-Silverdale-Port Orchard, WA",47.639595,-122.649634,274314
1230,14740,60-64,9649,9162,18811,"Bremerton-Silverdale-Port Orchard, WA",47.639595,-122.649634,274314
1231,14740,65+,28144,24379,52523,"Bremerton-Silverdale-Port Orchard, WA",47.639595,-122.649634,274314
1232,14780,15-19,1473,1633,3106,"Brenham, TX",30.215075,-96.410272,35891
1233,14780,20-24,1034,1201,2235,"Brenham, TX",30.215075,-96.410272,35891
1234,14780,25-29,897,803,1700,"Brenham, TX",30.215075,-96.410272,35891
1235,14780,30-34,960,873,1833,"Brenham, TX",30.215075,-96.410272,35891
1236,14780,35-39,1015,962,1977,"Brenham, TX",30.215075,-96.410272,35891
1237,14780,40-44,958,971,1929,"Brenham, TX",30.215075,-96.410272,35891
1238,14780,45-49,936,908,1844,"Brenham, TX",30.215075,-96.410272,35891
1239,14780,50-54,965,972,1937,"Brenham, TX",30.215075,-96.410272,35891
1240,14780,55-59,1194,1141,2335,"Brenham, TX",30.215075,-96.410272,35891
1241,14780,60-64,1328,1224,2552,"Brenham, TX",30.215075,-96.410272,35891
1242,14780,65+,4477,3693,8170,"Brenham, TX",30.215075,-96.410272,35891
1243,14820,15-19,810,877,1687,"Brevard, NC",35.210103,-82.816666,33165
1244,14820,20-24,739,932,1671,"Brevard, NC",35.210103,-82.816666,33165
1245,14820,25-29,731,800,1531,"Brevard, NC",35.210103,-82.816666,33165
1246,14820,30-34,827,760,1587,"Brevard, NC",35.210103,-82.816666,33165
1247,14820,35-39,857,786,1643,"Brevard, NC",35.210103,-82.816666,33165
1248,14820,40-44,831,811,1642,"Brevard, NC",35.210103,-82.816666,33165
1249,14820,45-49,888,905,1793,"Brevard, NC",35.210103,-82.816666,33165
1250,14820,50-54,960,900,1860,"Brevard, NC",35.210103,-82.816666,33165
1251,14820,55-59,1294,1053,2347,"Brevard, NC",35.210103,-82.816666,33165
1252,14820,60-64,1524,1296,2820,"Brevard, NC",35.210103,-82.816666,33165
1253,14820,65+,5516,4860,10376,"Brevard, NC",35.210103,-82.816666,33165
1254,14860,15-19,32918,33679,66597,"Bridgeport-Stamford-Norwalk, CT",41.227413,-73.367061,959768
1255,14860,20-24,29582,30449,60031,"Bridgeport-Stamford-Norwalk, CT",41.227413,-73.367061,959768
1256,14860,25-29,26930,28038,54968,"Bridgeport-Stamford-Norwalk, CT",41.227413,-73.367061,959768
1257,14860,30-34,28536,27966,56502,"Bridgeport-Stamford-Norwalk, CT",41.227413,-73.367061,959768
1258,14860,35-39,30553,30844,61397,"Bridgeport-Stamford-Norwalk, CT",41.227413,-73.367061,959768
1259,14860,40-44,31462,30674,62136,"Bridgeport-Stamford-Norwalk, CT",41.227413,-73.367061,959768
1260,14860,45-49,31376,30220,61596,"Bridgeport-Stamford-Norwalk, CT",41.227413,-73.367061,959768
1261,14860,50-54,35484,34340,69824,"Bridgeport-Stamford-Norwalk, CT",41.227413,-73.367061,959768
1262,14860,55-59,37015,35305,72320,"Bridgeport-Stamford-Norwalk, CT",41.227413,-73.367061,959768
1263,14860,60-64,33745,31980,65725,"Bridgeport-Stamford-Norwalk, CT",41.227413,-73.367061,959768
1264,14860,65+,88068,70535,158603,"Bridgeport-Stamford-Norwalk, CT",41.227413,-73.367061,959768
1265,15020,15-19,1088,1143,2231,"Brookhaven, MS",31.535216,-90.453566,34943
1266,15020,20-24,1035,947,1982,"Brookhaven, MS",31.535216,-90.453566,34943
1267,15020,25-29,1056,1078,2134,"Brookhaven, MS",31.535216,-90.453566,34943
1268,15020,30-34,1101,975,2076,"Brookhaven, MS",31.535216,-90.453566,34943
1269,15020,35-39,1123,1033,2156,"Brookhaven, MS",31.535216,-90.453566,34943
1270,15020,40-44,1212,1163,2375,"Brookhaven, MS",31.535216,-90.453566,34943
1271,15020,45-49,1170,1090,2260,"Brookhaven, MS",31.535216,-90.453566,34943
1272,15020,50-54,1163,1140,2303,"Brookhaven, MS",31.535216,-90.453566,34943
1273,15020,55-59,1161,1107,2268,"Brookhaven, MS",31.535216,-90.453566,34943
1274,15020,60-64,1254,1114,2368,"Brookhaven, MS",31.535216,-90.453566,34943
1275,15020,65+,3558,2675,6233,"Brookhaven, MS",31.535216,-90.453566,34943
1276,15060,15-19,420,456,876,"Brookings, OR",42.466439,-124.210929,23683
1277,15060,20-24,356,422,778,"Brookings, OR",42.466439,-124.210929,23683
1278,15060,25-29,456,515,971,"Brookings, OR",42.466439,-124.210929,23683
1279,15060,30-34,515,583,1098,"Brookings, OR",42.466439,-124.210929,23683
1280,15060,35-39,560,525,1085,"Brookings, OR",42.466439,-124.210929,23683
1281,15060,40-44,556,527,1083,"Brookings, OR",42.466439,-124.210929,23683
1282,15060,45-49,541,541,1082,"Brookings, OR",42.466439,-124.210929,23683
1283,15060,50-54,678,632,1310,"Brookings, OR",42.466439,-124.210929,23683
1284,15060,55-59,967,827,1794,"Brookings, OR",42.466439,-124.210929,23683
1285,15060,60-64,1261,1110,2371,"Brookings, OR",42.466439,-124.210929,23683
1286,15060,65+,4317,4100,8417,"Brookings, OR",42.466439,-124.210929,23683
1287,15100,15-19,1993,2023,4016,"Brookings, SD",44.376675,-96.797797,34639
1288,15100,20-24,2891,3152,6043,"Brookings, SD",44.376675,-96.797797,34639
1289,15100,25-29,970,1224,2194,"Brookings, SD",44.376675,-96.797797,34639
1290,15100,30-34,900,1125,2025,"Brookings, SD",44.376675,-96.797797,34639
1291,15100,35-39,934,1050,1984,"Brookings, SD",44.376675,-96.797797,34639
1292,15100,40-44,829,937,1766,"Brookings, SD",44.376675,-96.797797,34639
1293,15100,45-49,656,742,1398,"Brookings, SD",44.376675,-96.797797,34639
1294,15100,50-54,694,721,1415,"Brookings, SD",44.376675,-96.797797,34639
1295,15100,55-59,749,823,1572,"Brookings, SD",44.376675,-96.797797,34639
1296,15100,60-64,789,825,1614,"Brookings, SD",44.376675,-96.797797,34639
1297,15100,65+,2382,2132,4514,"Brookings, SD",44.376675,-96.797797,34639
1298,15140,15-19,541,547,1088,"Brownsville, TN",35.586678,-89.282691,17694
1299,15140,20-24,495,502,997,"Brownsville, TN",35.586678,-89.282691,17694
1300,15140,25-29,513,518,1031,"Brownsville, TN",35.586678,-89.282691,17694
1301,15140,30-34,561,432,993,"Brownsville, TN",35.586678,-89.282691,17694
1302,15140,35-39,525,470,995,"Brownsville, TN",35.586678,-89.282691,17694
1303,15140,40-44,614,474,1088,"Brownsville, TN",35.586678,-89.282691,17694
1304,15140,45-49,511,458,969,"Brownsville, TN",35.586678,-89.282691,17694
1305,15140,50-54,608,523,1131,"Brownsville, TN",35.586678,-89.282691,17694
1306,15140,55-59,681,612,1293,"Brownsville, TN",35.586678,-89.282691,17694
1307,15140,60-64,718,620,1338,"Brownsville, TN",35.586678,-89.282691,17694
1308,15140,65+,2017,1544,3561,"Brownsville, TN",35.586678,-89.282691,17694
1309,15180,15-19,17740,18541,36281,"Brownsville-Harlingen, TX",26.102923,-97.478958,423029
1310,15180,20-24,15557,16445,32002,"Brownsville-Harlingen, TX",26.102923,-97.478958,423029
1311,15180,25-29,13796,14657,28453,"Brownsville-Harlingen, TX",26.102923,-97.478958,423029
1312,15180,30-34,12568,12721,25289,"Brownsville-Harlingen, TX",26.102923,-97.478958,423029
1313,15180,35-39,12198,12199,24397,"Brownsville-Harlingen, TX",26.102923,-97.478958,423029
1314,15180,40-44,12752,12527,25279,"Brownsville-Harlingen, TX",26.102923,-97.478958,423029
1315,15180,45-49,13246,12395,25641,"Brownsville-Harlingen, TX",26.102923,-97.478958,423029
1316,15180,50-54,12486,10976,23462,"Brownsville-Harlingen, TX",26.102923,-97.478958,423029
1317,15180,55-59,11346,9915,21261,"Brownsville-Harlingen, TX",26.102923,-97.478958,423029
1318,15180,60-64,10739,9367,20106,"Brownsville-Harlingen, TX",26.102923,-97.478958,423029
1319,15180,65+,32850,26386,59236,"Brownsville-Harlingen, TX",26.102923,-97.478958,423029
1320,15220,15-19,1315,1343,2658,"Brownwood, TX",31.764137,-98.998456,38192
1321,15220,20-24,1134,1212,2346,"Brownwood, TX",31.764137,-98.998456,38192
1322,15220,25-29,998,1095,2093,"Brownwood, TX",31.764137,-98.998456,38192
1323,15220,30-34,1161,1188,2349,"Brownwood, TX",31.764137,-98.998456,38192
1324,15220,35-39,1190,1168,2358,"Brownwood, TX",31.764137,-98.998456,38192
1325,15220,40-44,1131,1179,2310,"Brownwood, TX",31.764137,-98.998456,38192
1326,15220,45-49,1122,1108,2230,"Brownwood, TX",31.764137,-98.998456,38192
1327,15220,50-54,1153,1164,2317,"Brownwood, TX",31.764137,-98.998456,38192
1328,15220,55-59,1327,1299,2626,"Brownwood, TX",31.764137,-98.998456,38192
1329,15220,60-64,1373,1330,2703,"Brownwood, TX",31.764137,-98.998456,38192
1330,15220,65+,4217,3686,7903,"Brownwood, TX",31.764137,-98.998456,38192
1331,15260,15-19,3388,3481,6869,"Brunswick, GA",31.301739,-81.588909,113963
1332,15260,20-24,3096,3249,6345,"Brunswick, GA",31.301739,-81.588909,113963
1333,15260,25-29,3408,3189,6597,"Brunswick, GA",31.301739,-81.588909,113963
1334,15260,30-34,3531,3122,6653,"Brunswick, GA",31.301739,-81.588909,113963
1335,15260,35-39,3439,3010,6449,"Brunswick, GA",31.301739,-81.588909,113963
1336,15260,40-44,3609,3030,6639,"Brunswick, GA",31.301739,-81.588909,113963
1337,15260,45-49,3470,3205,6675,"Brunswick, GA",31.301739,-81.588909,113963
1338,15260,50-54,3877,3530,7407,"Brunswick, GA",31.301739,-81.588909,113963
1339,15260,55-59,4265,3833,8098,"Brunswick, GA",31.301739,-81.588909,113963
1340,15260,60-64,4518,3820,8338,"Brunswick, GA",31.301739,-81.588909,113963
1341,15260,65+,13503,10994,24497,"Brunswick, GA",31.301739,-81.588909,113963
1342,15340,15-19,1225,1318,2543,"Bucyrus-Galion, OH",40.848524,-82.924783,41754
1343,15340,20-24,1154,1143,2297,"Bucyrus-Galion, OH",40.848524,-82.924783,41754
1344,15340,25-29,1155,1287,2442,"Bucyrus-Galion, OH",40.848524,-82.924783,41754
1345,15340,30-34,1170,1174,2344,"Bucyrus-Galion, OH",40.848524,-82.924783,41754
1346,15340,35-39,1154,1116,2270,"Bucyrus-Galion, OH",40.848524,-82.924783,41754
1347,15340,40-44,1260,1130,2390,"Bucyrus-Galion, OH",40.848524,-82.924783,41754
1348,15340,45-49,1261,1324,2585,"Bucyrus-Galion, OH",40.848524,-82.924783,41754
1349,15340,50-54,1350,1415,2765,"Bucyrus-Galion, OH",40.848524,-82.924783,41754
1350,15340,55-59,1384,1413,2797,"Bucyrus-Galion, OH",40.848524,-82.924783,41754
1351,15340,60-64,1523,1458,2981,"Bucyrus-Galion, OH",40.848524,-82.924783,41754
1352,15340,65+,4916,3995,8911,"Bucyrus-Galion, OH",40.848524,-82.924783,41754
1353,15380,15-19,34708,35627,70335,"Buffalo-Cheektowaga, NY",43.044371,-78.777335,1162336
1354,15380,20-24,35885,36105,71990,"Buffalo-Cheektowaga, NY",43.044371,-78.777335,1162336
1355,15380,25-29,38088,38580,76668,"Buffalo-Cheektowaga, NY",43.044371,-78.777335,1162336
1356,15380,30-34,40984,41320,82304,"Buffalo-Cheektowaga, NY",43.044371,-78.777335,1162336
1357,15380,35-39,37616,37425,75041,"Buffalo-Cheektowaga, NY",43.044371,-78.777335,1162336
1358,15380,40-44,33552,33052,66604,"Buffalo-Cheektowaga, NY",43.044371,-78.777335,1162336
1359,15380,45-49,31284,30803,62087,"Buffalo-Cheektowaga, NY",43.044371,-78.777335,1162336
1360,15380,50-54,38041,36704,74745,"Buffalo-Cheektowaga, NY",43.044371,-78.777335,1162336
1361,15380,55-59,42160,40043,82203,"Buffalo-Cheektowaga, NY",43.044371,-78.777335,1162336
1362,15380,60-64,44880,41705,86585,"Buffalo-Cheektowaga, NY",43.044371,-78.777335,1162336
1363,15380,65+,123104,97817,220921,"Buffalo-Cheektowaga, NY",43.044371,-78.777335,1162336
1364,15420,15-19,1763,1963,3726,"Burley, ID",42.369199,-113.642424,47119
1365,15420,20-24,1391,1505,2896,"Burley, ID",42.369199,-113.642424,47119
1366,15420,25-29,1481,1573,3054,"Burley, ID",42.369199,-113.642424,47119
1367,15420,30-34,1390,1443,2833,"Burley, ID",42.369199,-113.642424,47119
1368,15420,35-39,1403,1457,2860,"Burley, ID",42.369199,-113.642424,47119
1369,15420,40-44,1323,1465,2788,"Burley, ID",42.369199,-113.642424,47119
1370,15420,45-49,1206,1285,2491,"Burley, ID",42.369199,-113.642424,47119
1371,15420,50-54,1087,1273,2360,"Burley, ID",42.369199,-113.642424,47119
1372,15420,55-59,1234,1248,2482,"Burley, ID",42.369199,-113.642424,47119
1373,15420,60-64,1347,1377,2724,"Burley, ID",42.369199,-113.642424,47119
1374,15420,65+,3805,3449,7254,"Burley, ID",42.369199,-113.642424,47119
1375,15460,15-19,1298,1307,2605,"Burlington, IA-IL",40.863823,-91.069976,44803
1376,15460,20-24,1129,1188,2317,"Burlington, IA-IL",40.863823,-91.069976,44803
1377,15460,25-29,1247,1254,2501,"Burlington, IA-IL",40.863823,-91.069976,44803
1378,15460,30-34,1218,1162,2380,"Burlington, IA-IL",40.863823,-91.069976,44803
1379,15460,35-39,1361,1301,2662,"Burlington, IA-IL",40.863823,-91.069976,44803
1380,15460,40-44,1314,1377,2691,"Burlington, IA-IL",40.863823,-91.069976,44803
1381,15460,45-49,1237,1200,2437,"Burlington, IA-IL",40.863823,-91.069976,44803
1382,15460,50-54,1402,1354,2756,"Burlington, IA-IL",40.863823,-91.069976,44803
1383,15460,55-59,1573,1539,3112,"Burlington, IA-IL",40.863823,-91.069976,44803
1384,15460,60-64,1678,1671,3349,"Burlington, IA-IL",40.863823,-91.069976,44803
1385,15460,65+,5336,4553,9889,"Burlington, IA-IL",40.863823,-91.069976,44803
1386,15500,15-19,6928,6467,13395,"Burlington, NC",36.043954,-79.400573,173877
1387,15500,20-24,6066,5497,11563,"Burlington, NC",36.043954,-79.400573,173877
1388,15500,25-29,5441,5042,10483,"Burlington, NC",36.043954,-79.400573,173877
1389,15500,30-34,5997,5440,11437,"Burlington, NC",36.043954,-79.400573,173877
1390,15500,35-39,5491,4871,10362,"Burlington, NC",36.043954,-79.400573,173877
1391,15500,40-44,5267,4792,10059,"Burlington, NC",36.043954,-79.400573,173877
1392,15500,45-49,5357,5009,10366,"Burlington, NC",36.043954,-79.400573,173877
1393,15500,50-54,5912,5648,11560,"Burlington, NC",36.043954,-79.400573,173877
1394,15500,55-59,6176,5801,11977,"Burlington, NC",36.043954,-79.400573,173877
1395,15500,60-64,5882,5343,11225,"Burlington, NC",36.043954,-79.400573,173877
1396,15500,65+,17055,12765,29820,"Burlington, NC",36.043954,-79.400573,173877
1397,15540,15-19,8493,8514,17007,"Burlington-South Burlington, VT",44.689117,-73.041171,226611
1398,15540,20-24,10630,10197,20827,"Burlington-South Burlington, VT",44.689117,-73.041171,226611
1399,15540,25-29,8040,8469,16509,"Burlington-South Burlington, VT",44.689117,-73.041171,226611
1400,15540,30-34,7566,7821,15387,"Burlington-South Burlington, VT",44.689117,-73.041171,226611
1401,15540,35-39,7343,7442,14785,"Burlington-South Burlington, VT",44.689117,-73.041171,226611
1402,15540,40-44,6854,6819,13673,"Burlington-South Burlington, VT",44.689117,-73.041171,226611
1403,15540,45-49,6300,6281,12581,"Burlington-South Burlington, VT",44.689117,-73.041171,226611
1404,15540,50-54,7127,6977,14104,"Burlington-South Burlington, VT",44.689117,-73.041171,226611
1405,15540,55-59,7557,7373,14930,"Burlington-South Burlington, VT",44.689117,-73.041171,226611
1406,15540,60-64,7706,7559,15265,"Burlington-South Burlington, VT",44.689117,-73.041171,226611
1407,15540,65+,20525,17048,37573,"Burlington-South Burlington, VT",44.689117,-73.041171,226611
1408,15580,15-19,985,1096,2081,"Butte-Silver Bow, MT",45.896232,-112.660071,35411
1409,15580,20-24,1348,1576,2924,"Butte-Silver Bow, MT",45.896232,-112.660071,35411
1410,15580,25-29,1195,1244,2439,"Butte-Silver Bow, MT",45.896232,-112.660071,35411
1411,15580,30-34,1012,1090,2102,"Butte-Silver Bow, MT",45.896232,-112.660071,35411
1412,15580,35-39,983,1145,2128,"Butte-Silver Bow, MT",45.896232,-112.660071,35411
1413,15580,40-44,978,1127,2105,"Butte-Silver Bow, MT",45.896232,-112.660071,35411
1414,15580,45-49,889,916,1805,"Butte-Silver Bow, MT",45.896232,-112.660071,35411
1415,15580,50-54,978,1021,1999,"Butte-Silver Bow, MT",45.896232,-112.660071,35411
1416,15580,55-59,1112,1176,2288,"Butte-Silver Bow, MT",45.896232,-112.660071,35411
1417,15580,60-64,1359,1307,2666,"Butte-Silver Bow, MT",45.896232,-112.660071,35411
1418,15580,65+,3645,3207,6852,"Butte-Silver Bow, MT",45.896232,-112.660071,35411
1419,15620,15-19,1479,1513,2992,"Cadillac, MI",44.328738,-85.326429,49031
1420,15620,20-24,1117,1268,2385,"Cadillac, MI",44.328738,-85.326429,49031
1421,15620,25-29,1390,1513,2903,"Cadillac, MI",44.328738,-85.326429,49031
1422,15620,30-34,1410,1420,2830,"Cadillac, MI",44.328738,-85.326429,49031
1423,15620,35-39,1444,1486,2930,"Cadillac, MI",44.328738,-85.326429,49031
1424,15620,40-44,1390,1367,2757,"Cadillac, MI",44.328738,-85.326429,49031
1425,15620,45-49,1261,1320,2581,"Cadillac, MI",44.328738,-85.326429,49031
1426,15620,50-54,1485,1573,3058,"Cadillac, MI",44.328738,-85.326429,49031
1427,15620,55-59,1760,1824,3584,"Cadillac, MI",44.328738,-85.326429,49031
1428,15620,60-64,1865,1933,3798,"Cadillac, MI",44.328738,-85.326429,49031
1429,15620,65+,5178,4832,10010,"Cadillac, MI",44.328738,-85.326429,49031
1430,15660,15-19,1951,2084,4035,"Calhoun, GA",34.509667,-84.873862,58237
1431,15660,20-24,1803,1954,3757,"Calhoun, GA",34.509667,-84.873862,58237
1432,15660,25-29,1860,1859,3719,"Calhoun, GA",34.509667,-84.873862,58237
1433,15660,30-34,1903,1834,3737,"Calhoun, GA",34.509667,-84.873862,58237
1434,15660,35-39,1768,1863,3631,"Calhoun, GA",34.509667,-84.873862,58237
1435,15660,40-44,1973,1769,3742,"Calhoun, GA",34.509667,-84.873862,58237
1436,15660,45-49,1965,1987,3952,"Calhoun, GA",34.509667,-84.873862,58237
1437,15660,50-54,2095,2096,4191,"Calhoun, GA",34.509667,-84.873862,58237
1438,15660,55-59,1961,2038,3999,"Calhoun, GA",34.509667,-84.873862,58237
1439,15660,60-64,1828,1658,3486,"Calhoun, GA",34.509667,-84.873862,58237
1440,15660,65+,4889,4066,8955,"Calhoun, GA",34.509667,-84.873862,58237
1441,15680,15-19,3881,3968,7849,"California-Lexington Park, MD",38.223077,-76.534487,114468
1442,15680,20-24,3687,3730,7417,"California-Lexington Park, MD",38.223077,-76.534487,114468
1443,15680,25-29,3768,4139,7907,"California-Lexington Park, MD",38.223077,-76.534487,114468
1444,15680,30-34,4050,4248,8298,"California-Lexington Park, MD",38.223077,-76.534487,114468
1445,15680,35-39,4005,4018,8023,"California-Lexington Park, MD",38.223077,-76.534487,114468
1446,15680,40-44,3524,3585,7109,"California-Lexington Park, MD",38.223077,-76.534487,114468
1447,15680,45-49,3318,3285,6603,"California-Lexington Park, MD",38.223077,-76.534487,114468
1448,15680,50-54,3897,3740,7637,"California-Lexington Park, MD",38.223077,-76.534487,114468
1449,15680,55-59,4107,4215,8322,"California-Lexington Park, MD",38.223077,-76.534487,114468
1450,15680,60-64,3503,3655,7158,"California-Lexington Park, MD",38.223077,-76.534487,114468
1451,15680,65+,8279,7373,15652,"California-Lexington Park, MD",38.223077,-76.534487,114468
1452,15700,15-19,868,960,1828,"Cambridge, MD",38.429196,-76.047433,32489
1453,15700,20-24,762,795,1557,"Cambridge, MD",38.429196,-76.047433,32489
1454,15700,25-29,995,822,1817,"Cambridge, MD",38.429196,-76.047433,32489
1455,15700,30-34,1090,952,2042,"Cambridge, MD",38.429196,-76.047433,32489
1456,15700,35-39,992,839,1831,"Cambridge, MD",38.429196,-76.047433,32489
1457,15700,40-44,924,776,1700,"Cambridge, MD",38.429196,-76.047433,32489
1458,15700,45-49,912,756,1668,"Cambridge, MD",38.429196,-76.047433,32489
1459,15700,50-54,1072,940,2012,"Cambridge, MD",38.429196,-76.047433,32489
1460,15700,55-59,1243,1199,2442,"Cambridge, MD",38.429196,-76.047433,32489
1461,15700,60-64,1418,1235,2653,"Cambridge, MD",38.429196,-76.047433,32489
1462,15700,65+,4002,3313,7315,"Cambridge, MD",38.429196,-76.047433,32489
1463,15740,15-19,1102,1189,2291,"Cambridge, OH",40.056665,-81.497875,38287
1464,15740,20-24,982,1062,2044,"Cambridge, OH",40.056665,-81.497875,38287
1465,15740,25-29,1150,1230,2380,"Cambridge, OH",40.056665,-81.497875,38287
1466,15740,30-34,1129,1196,2325,"Cambridge, OH",40.056665,-81.497875,38287
1467,15740,35-39,1074,1103,2177,"Cambridge, OH",40.056665,-81.497875,38287
1468,15740,40-44,1034,1112,2146,"Cambridge, OH",40.056665,-81.497875,38287
1469,15740,45-49,1090,1070,2160,"Cambridge, OH",40.056665,-81.497875,38287
1470,15740,50-54,1263,1304,2567,"Cambridge, OH",40.056665,-81.497875,38287
1471,15740,55-59,1338,1367,2705,"Cambridge, OH",40.056665,-81.497875,38287
1472,15740,60-64,1440,1380,2820,"Cambridge, OH",40.056665,-81.497875,38287
1473,15740,65+,4115,3641,7756,"Cambridge, OH",40.056665,-81.497875,38287
1474,15780,15-19,782,861,1643,"Camden, AR",33.567513,-92.708217,27047
1475,15780,20-24,692,754,1446,"Camden, AR",33.567513,-92.708217,27047
1476,15780,25-29,765,810,1575,"Camden, AR",33.567513,-92.708217,27047
1477,15780,30-34,774,743,1517,"Camden, AR",33.567513,-92.708217,27047
1478,15780,35-39,774,767,1541,"Camden, AR",33.567513,-92.708217,27047
1479,15780,40-44,751,672,1423,"Camden, AR",33.567513,-92.708217,27047
1480,15780,45-49,787,736,1523,"Camden, AR",33.567513,-92.708217,27047
1481,15780,50-54,876,822,1698,"Camden, AR",33.567513,-92.708217,27047
1482,15780,55-59,977,980,1957,"Camden, AR",33.567513,-92.708217,27047
1483,15780,60-64,1119,1045,2164,"Camden, AR",33.567513,-92.708217,27047
1484,15780,65+,3240,2514,5754,"Camden, AR",33.567513,-92.708217,27047
1485,15820,15-19,1274,1345,2619,"Campbellsville, KY",37.31554,-85.443011,37526
1486,15820,20-24,1239,1274,2513,"Campbellsville, KY",37.31554,-85.443011,37526
1487,15820,25-29,1088,1189,2277,"Campbellsville, KY",37.31554,-85.443011,37526
1488,15820,30-34,1141,1122,2263,"Campbellsville, KY",37.31554,-85.443011,37526
1489,15820,35-39,1049,1108,2157,"Campbellsville, KY",37.31554,-85.443011,37526
1490,15820,40-44,1075,1079,2154,"Campbellsville, KY",37.31554,-85.443011,37526
1491,15820,45-49,954,1003,1957,"Campbellsville, KY",37.31554,-85.443011,37526
1492,15820,50-54,1179,1124,2303,"Campbellsville, KY",37.31554,-85.443011,37526
1493,15820,55-59,1309,1264,2573,"Campbellsville, KY",37.31554,-85.443011,37526
1494,15820,60-64,1373,1260,2633,"Campbellsville, KY",37.31554,-85.443011,37526
1495,15820,65+,3924,3203,7127,"Campbellsville, KY",37.31554,-85.443011,37526
1496,15860,15-19,1081,1204,2285,"Cañon City, CO",38.45517,-105.424958,49661
1497,15860,20-24,903,1599,2502,"Cañon City, CO",38.45517,-105.424958,49661
1498,15860,25-29,981,2463,3444,"Cañon City, CO",38.45517,-105.424958,49661
1499,15860,30-34,1124,2483,3607,"Cañon City, CO",38.45517,-105.424958,49661
1500,15860,35-39,1156,2442,3598,"Cañon City, CO",38.45517,-105.424958,49661
1501,15860,40-44,1095,2237,3332,"Cañon City, CO",38.45517,-105.424958,49661
1502,15860,45-49,996,1994,2990,"Cañon City, CO",38.45517,-105.424958,49661
1503,15860,50-54,1250,1899,3149,"Cañon City, CO",38.45517,-105.424958,49661
1504,15860,55-59,1598,1775,3373,"Cañon City, CO",38.45517,-105.424958,49661
1505,15860,60-64,1875,1873,3748,"Cañon City, CO",38.45517,-105.424958,49661
1506,15860,65+,5726,5422,11148,"Cañon City, CO",38.45517,-105.424958,49661
1507,15940,15-19,12132,12849,24981,"Canton-Massillon, OH",40.711051,-81.261468,400525
1508,15940,20-24,11744,11877,23621,"Canton-Massillon, OH",40.711051,-81.261468,400525
1509,15940,25-29,11842,11947,23789,"Canton-Massillon, OH",40.711051,-81.261468,400525
1510,15940,30-34,12313,12009,24322,"Canton-Massillon, OH",40.711051,-81.261468,400525
1511,15940,35-39,11701,11815,23516,"Canton-Massillon, OH",40.711051,-81.261468,400525
1512,15940,40-44,11801,11613,23414,"Canton-Massillon, OH",40.711051,-81.261468,400525
1513,15940,45-49,11459,11082,22541,"Canton-Massillon, OH",40.711051,-81.261468,400525
1514,15940,50-54,12908,13040,25948,"Canton-Massillon, OH",40.711051,-81.261468,400525
1515,15940,55-59,14033,13646,27679,"Canton-Massillon, OH",40.711051,-81.261468,400525
1516,15940,60-64,15124,14208,29332,"Canton-Massillon, OH",40.711051,-81.261468,400525
1517,15940,65+,44834,36300,81134,"Canton-Massillon, OH",40.711051,-81.261468,400525
1518,15980,15-19,19125,20259,39384,"Cape Coral-Fort Myers, FL",26.563273,-81.984182,787976
1519,15980,20-24,19099,19060,38159,"Cape Coral-Fort Myers, FL",26.563273,-81.984182,787976
1520,15980,25-29,20212,20540,40752,"Cape Coral-Fort Myers, FL",26.563273,-81.984182,787976
1521,15980,30-34,21687,21712,43399,"Cape Coral-Fort Myers, FL",26.563273,-81.984182,787976
1522,15980,35-39,21082,21548,42630,"Cape Coral-Fort Myers, FL",26.563273,-81.984182,787976
1523,15980,40-44,20358,20653,41011,"Cape Coral-Fort Myers, FL",26.563273,-81.984182,787976
1524,15980,45-49,20964,20537,41501,"Cape Coral-Fort Myers, FL",26.563273,-81.984182,787976
1525,15980,50-54,24153,23176,47329,"Cape Coral-Fort Myers, FL",26.563273,-81.984182,787976
1526,15980,55-59,28141,25568,53709,"Cape Coral-Fort Myers, FL",26.563273,-81.984182,787976
1527,15980,60-64,31383,27997,59380,"Cape Coral-Fort Myers, FL",26.563273,-81.984182,787976
1528,15980,65+,119470,109460,228930,"Cape Coral-Fort Myers, FL",26.563273,-81.984182,787976
1529,16020,15-19,3681,3418,7099,"Cape Girardeau, MO-IL",37.325936,-89.762639,97699
1530,16020,20-24,4630,4169,8799,"Cape Girardeau, MO-IL",37.325936,-89.762639,97699
1531,16020,25-29,3001,3060,6061,"Cape Girardeau, MO-IL",37.325936,-89.762639,97699
1532,16020,30-34,2968,2949,5917,"Cape Girardeau, MO-IL",37.325936,-89.762639,97699
1533,16020,35-39,2911,2917,5828,"Cape Girardeau, MO-IL",37.325936,-89.762639,97699
1534,16020,40-44,2781,2846,5627,"Cape Girardeau, MO-IL",37.325936,-89.762639,97699
1535,16020,45-49,2654,2602,5256,"Cape Girardeau, MO-IL",37.325936,-89.762639,97699
1536,16020,50-54,2809,2726,5535,"Cape Girardeau, MO-IL",37.325936,-89.762639,97699
1537,16020,55-59,3039,3059,6098,"Cape Girardeau, MO-IL",37.325936,-89.762639,97699
1538,16020,60-64,3242,3166,6408,"Cape Girardeau, MO-IL",37.325936,-89.762639,97699
1539,16020,65+,9814,7915,17729,"Cape Girardeau, MO-IL",37.325936,-89.762639,97699
1540,16060,15-19,4362,4668,9030,"Carbondale-Marion, IL",37.689742,-89.105149,132907
1541,16060,20-24,5887,6604,12491,"Carbondale-Marion, IL",37.689742,-89.105149,132907
1542,16060,25-29,3964,4344,8308,"Carbondale-Marion, IL",37.689742,-89.105149,132907
1543,16060,30-34,4013,4420,8433,"Carbondale-Marion, IL",37.689742,-89.105149,132907
1544,16060,35-39,3831,4225,8056,"Carbondale-Marion, IL",37.689742,-89.105149,132907
1545,16060,40-44,3764,4148,7912,"Carbondale-Marion, IL",37.689742,-89.105149,132907
1546,16060,45-49,3472,3918,7390,"Carbondale-Marion, IL",37.689742,-89.105149,132907
1547,16060,50-54,3701,3865,7566,"Carbondale-Marion, IL",37.689742,-89.105149,132907
1548,16060,55-59,4102,4056,8158,"Carbondale-Marion, IL",37.689742,-89.105149,132907
1549,16060,60-64,4337,4228,8565,"Carbondale-Marion, IL",37.689742,-89.105149,132907
1550,16060,65+,13464,11393,24857,"Carbondale-Marion, IL",37.689742,-89.105149,132907
1551,16100,15-19,2069,2115,4184,"Carlsbad-Artesia, NM",32.457835,-104.306434,60911
1552,16100,20-24,1796,1939,3735,"Carlsbad-Artesia, NM",32.457835,-104.306434,60911
1553,16100,25-29,1981,2129,4110,"Carlsbad-Artesia, NM",32.457835,-104.306434,60911
1554,16100,30-34,2051,2278,4329,"Carlsbad-Artesia, NM",32.457835,-104.306434,60911
1555,16100,35-39,2010,2415,4425,"Carlsbad-Artesia, NM",32.457835,-104.306434,60911
1556,16100,40-44,1809,2080,3889,"Carlsbad-Artesia, NM",32.457835,-104.306434,60911
1557,16100,45-49,1596,1639,3235,"Carlsbad-Artesia, NM",32.457835,-104.306434,60911
1558,16100,50-54,1641,1720,3361,"Carlsbad-Artesia, NM",32.457835,-104.306434,60911
1559,16100,55-59,1743,1799,3542,"Carlsbad-Artesia, NM",32.457835,-104.306434,60911
1560,16100,60-64,1744,1817,3561,"Carlsbad-Artesia, NM",32.457835,-104.306434,60911
1561,16100,65+,4806,4210,9016,"Carlsbad-Artesia, NM",32.457835,-104.306434,60911
1562,16140,15-19,643,689,1332,"Carroll, IA",42.039502,-94.86765,20692
1563,16140,20-24,510,540,1050,"Carroll, IA",42.039502,-94.86765,20692
1564,16140,25-29,560,546,1106,"Carroll, IA",42.039502,-94.86765,20692
1565,16140,30-34,551,553,1104,"Carroll, IA",42.039502,-94.86765,20692
1566,16140,35-39,556,628,1184,"Carroll, IA",42.039502,-94.86765,20692
1567,16140,40-44,577,591,1168,"Carroll, IA",42.039502,-94.86765,20692
1568,16140,45-49,507,522,1029,"Carroll, IA",42.039502,-94.86765,20692
1569,16140,50-54,572,610,1182,"Carroll, IA",42.039502,-94.86765,20692
1570,16140,55-59,721,728,1449,"Carroll, IA",42.039502,-94.86765,20692
1571,16140,60-64,761,800,1561,"Carroll, IA",42.039502,-94.86765,20692
1572,16140,65+,2383,1945,4328,"Carroll, IA",42.039502,-94.86765,20692
1573,16180,15-19,1591,1704,3295,"Carson City, NV",39.15306,-119.747368,58993
1574,16180,20-24,1466,1737,3203,"Carson City, NV",39.15306,-119.747368,58993
1575,16180,25-29,1707,2093,3800,"Carson City, NV",39.15306,-119.747368,58993
1576,16180,30-34,1788,2220,4008,"Carson City, NV",39.15306,-119.747368,58993
1577,16180,35-39,1624,2080,3704,"Carson City, NV",39.15306,-119.747368,58993
1578,16180,40-44,1543,1862,3405,"Carson City, NV",39.15306,-119.747368,58993
1579,16180,45-49,1484,1769,3253,"Carson City, NV",39.15306,-119.747368,58993
1580,16180,50-54,1674,1995,3669,"Carson City, NV",39.15306,-119.747368,58993
1581,16180,55-59,1990,2078,4068,"Carson City, NV",39.15306,-119.747368,58993
1582,16180,60-64,2229,2161,4390,"Carson City, NV",39.15306,-119.747368,58993
1583,16180,65+,6671,5740,12411,"Carson City, NV",39.15306,-119.747368,58993
1584,16220,15-19,2504,2670,5174,"Casper, WY",42.977645,-106.768219,79555
1585,16220,20-24,2095,2241,4336,"Casper, WY",42.977645,-106.768219,79555
1586,16220,25-29,2520,2609,5129,"Casper, WY",42.977645,-106.768219,79555
1587,16220,30-34,2796,2948,5744,"Casper, WY",42.977645,-106.768219,79555
1588,16220,35-39,2809,3061,5870,"Casper, WY",42.977645,-106.768219,79555
1589,16220,40-44,2643,2749,5392,"Casper, WY",42.977645,-106.768219,79555
1590,16220,45-49,2149,2279,4428,"Casper, WY",42.977645,-106.768219,79555
1591,16220,50-54,2145,2281,4426,"Casper, WY",42.977645,-106.768219,79555
1592,16220,55-59,2380,2355,4735,"Casper, WY",42.977645,-106.768219,79555
1593,16220,60-64,2685,2748,5433,"Casper, WY",42.977645,-106.768219,79555
1594,16220,65+,6942,6193,13135,"Casper, WY",42.977645,-106.768219,79555
1595,16260,15-19,2963,2642,5605,"Cedar City, UT",37.909304,-113.30674,60519
1596,16260,20-24,3212,3233,6445,"Cedar City, UT",37.909304,-113.30674,60519
1597,16260,25-29,2026,2173,4199,"Cedar City, UT",37.909304,-113.30674,60519
1598,16260,30-34,1781,1841,3622,"Cedar City, UT",37.909304,-113.30674,60519
1599,16260,35-39,1802,1783,3585,"Cedar City, UT",37.909304,-113.30674,60519
1600,16260,40-44,1861,1903,3764,"Cedar City, UT",37.909304,-113.30674,60519
1601,16260,45-49,1483,1509,2992,"Cedar City, UT",37.909304,-113.30674,60519
1602,16260,50-54,1312,1285,2597,"Cedar City, UT",37.909304,-113.30674,60519
1603,16260,55-59,1316,1345,2661,"Cedar City, UT",37.909304,-113.30674,60519
1604,16260,60-64,1507,1488,2995,"Cedar City, UT",37.909304,-113.30674,60519
1605,16260,65+,4214,4005,8219,"Cedar City, UT",37.909304,-113.30674,60519
1606,16300,15-19,8831,9125,17956,"Cedar Rapids, IA",42.086289,-91.631095,275435
1607,16300,20-24,8493,8600,17093,"Cedar Rapids, IA",42.086289,-91.631095,275435
1608,16300,25-29,8593,9013,17606,"Cedar Rapids, IA",42.086289,-91.631095,275435
1609,16300,30-34,8679,9080,17759,"Cedar Rapids, IA",42.086289,-91.631095,275435
1610,16300,35-39,9079,9315,18394,"Cedar Rapids, IA",42.086289,-91.631095,275435
1611,16300,40-44,8877,9280,18157,"Cedar Rapids, IA",42.086289,-91.631095,275435
1612,16300,45-49,8016,8169,16185,"Cedar Rapids, IA",42.086289,-91.631095,275435
1613,16300,50-54,8451,8751,17202,"Cedar Rapids, IA",42.086289,-91.631095,275435
1614,16300,55-59,9115,9241,18356,"Cedar Rapids, IA",42.086289,-91.631095,275435
1615,16300,60-64,9093,8938,18031,"Cedar Rapids, IA",42.086289,-91.631095,275435
1616,16300,65+,25841,21602,47443,"Cedar Rapids, IA",42.086289,-91.631095,275435
1617,16340,15-19,1422,1569,2991,"Cedartown, GA",33.996015,-85.188338,43496
1618,16340,20-24,1312,1362,2674,"Cedartown, GA",33.996015,-85.188338,43496
1619,16340,25-29,1376,1385,2761,"Cedartown, GA",33.996015,-85.188338,43496
1620,16340,30-34,1519,1444,2963,"Cedartown, GA",33.996015,-85.188338,43496
1621,16340,35-39,1383,1434,2817,"Cedartown, GA",33.996015,-85.188338,43496
1622,16340,40-44,1271,1299,2570,"Cedartown, GA",33.996015,-85.188338,43496
1623,16340,45-49,1319,1234,2553,"Cedartown, GA",33.996015,-85.188338,43496
1624,16340,50-54,1352,1384,2736,"Cedartown, GA",33.996015,-85.188338,43496
1625,16340,55-59,1426,1402,2828,"Cedartown, GA",33.996015,-85.188338,43496
1626,16340,60-64,1415,1277,2692,"Cedartown, GA",33.996015,-85.188338,43496
1627,16340,65+,3790,2986,6776,"Cedartown, GA",33.996015,-85.188338,43496
1628,16380,15-19,1311,1446,2757,"Celina, OH",40.535333,-84.632059,42309
1629,16380,20-24,1123,1241,2364,"Celina, OH",40.535333,-84.632059,42309
1630,16380,25-29,1166,1177,2343,"Celina, OH",40.535333,-84.632059,42309
1631,16380,30-34,1158,1321,2479,"Celina, OH",40.535333,-84.632059,42309
1632,16380,35-39,1176,1286,2462,"Celina, OH",40.535333,-84.632059,42309
1633,16380,40-44,1094,1186,2280,"Celina, OH",40.535333,-84.632059,42309
1634,16380,45-49,1034,1111,2145,"Celina, OH",40.535333,-84.632059,42309
1635,16380,50-54,1202,1187,2389,"Celina, OH",40.535333,-84.632059,42309
1636,16380,55-59,1370,1401,2771,"Celina, OH",40.535333,-84.632059,42309
1637,16380,60-64,1489,1538,3027,"Celina, OH",40.535333,-84.632059,42309
1638,16380,65+,4252,3782,8034,"Celina, OH",40.535333,-84.632059,42309
1639,16420,15-19,894,1029,1923,"Central City, KY",37.213816,-87.134092,30694
1640,16420,20-24,844,1115,1959,"Central City, KY",37.213816,-87.134092,30694
1641,16420,25-29,828,1055,1883,"Central City, KY",37.213816,-87.134092,30694
1642,16420,30-34,851,1026,1877,"Central City, KY",37.213816,-87.134092,30694
1643,16420,35-39,827,974,1801,"Central City, KY",37.213816,-87.134092,30694
1644,16420,40-44,909,1013,1922,"Central City, KY",37.213816,-87.134092,30694
1645,16420,45-49,906,1044,1950,"Central City, KY",37.213816,-87.134092,30694
1646,16420,50-54,938,1025,1963,"Central City, KY",37.213816,-87.134092,30694
1647,16420,55-59,1052,1045,2097,"Central City, KY",37.213816,-87.134092,30694
1648,16420,60-64,1074,1027,2101,"Central City, KY",37.213816,-87.134092,30694
1649,16420,65+,3315,2723,6038,"Central City, KY",37.213816,-87.134092,30694
1650,16460,15-19,1038,1177,2215,"Centralia, IL",38.648236,-88.920362,37390
1651,16460,20-24,950,943,1893,"Centralia, IL",38.648236,-88.920362,37390
1652,16460,25-29,1076,1108,2184,"Centralia, IL",38.648236,-88.920362,37390
1653,16460,30-34,1103,1130,2233,"Centralia, IL",38.648236,-88.920362,37390
1654,16460,35-39,1051,1076,2127,"Centralia, IL",38.648236,-88.920362,37390
1655,16460,40-44,1075,1118,2193,"Centralia, IL",38.648236,-88.920362,37390
1656,16460,45-49,1042,1095,2137,"Centralia, IL",38.648236,-88.920362,37390
1657,16460,50-54,1119,1106,2225,"Centralia, IL",38.648236,-88.920362,37390
1658,16460,55-59,1300,1299,2599,"Centralia, IL",38.648236,-88.920362,37390
1659,16460,60-64,1425,1278,2703,"Centralia, IL",38.648236,-88.920362,37390
1660,16460,65+,4132,3410,7542,"Centralia, IL",38.648236,-88.920362,37390
1661,16500,15-19,2224,2532,4756,"Centralia, WA",46.580071,-122.377444,84398
1662,16500,20-24,2079,2223,4302,"Centralia, WA",46.580071,-122.377444,84398
1663,16500,25-29,2396,2591,4987,"Centralia, WA",46.580071,-122.377444,84398
1664,16500,30-34,2654,2721,5375,"Centralia, WA",46.580071,-122.377444,84398
1665,16500,35-39,2599,2684,5283,"Centralia, WA",46.580071,-122.377444,84398
1666,16500,40-44,2510,2644,5154,"Centralia, WA",46.580071,-122.377444,84398
1667,16500,45-49,2292,2375,4667,"Centralia, WA",46.580071,-122.377444,84398
1668,16500,50-54,2487,2490,4977,"Centralia, WA",46.580071,-122.377444,84398
1669,16500,55-59,2802,2729,5531,"Centralia, WA",46.580071,-122.377444,84398
1670,16500,60-64,3189,3064,6253,"Centralia, WA",46.580071,-122.377444,84398
1671,16500,65+,9221,8585,17806,"Centralia, WA",46.580071,-122.377444,84398
1672,16540,15-19,4669,5164,9833,"Chambersburg-Waynesboro, PA",39.926772,-77.724521,156289
1673,16540,20-24,4178,4130,8308,"Chambersburg-Waynesboro, PA",39.926772,-77.724521,156289
1674,16540,25-29,4470,4584,9054,"Chambersburg-Waynesboro, PA",39.926772,-77.724521,156289
1675,16540,30-34,4870,4733,9603,"Chambersburg-Waynesboro, PA",39.926772,-77.724521,156289
1676,16540,35-39,4731,4704,9435,"Chambersburg-Waynesboro, PA",39.926772,-77.724521,156289
1677,16540,40-44,4635,4501,9136,"Chambersburg-Waynesboro, PA",39.926772,-77.724521,156289
1678,16540,45-49,4681,4712,9393,"Chambersburg-Waynesboro, PA",39.926772,-77.724521,156289
1679,16540,50-54,5133,5315,10448,"Chambersburg-Waynesboro, PA",39.926772,-77.724521,156289
1680,16540,55-59,5400,5554,10954,"Chambersburg-Waynesboro, PA",39.926772,-77.724521,156289
1681,16540,60-64,5484,5131,10615,"Chambersburg-Waynesboro, PA",39.926772,-77.724521,156289
1682,16540,65+,17210,14200,31410,"Chambersburg-Waynesboro, PA",39.926772,-77.724521,156289
1683,16580,15-19,10533,11000,21533,"Champaign-Urbana, IL",40.102988,-88.318504,222696
1684,16580,20-24,15738,17456,33194,"Champaign-Urbana, IL",40.102988,-88.318504,222696
1685,16580,25-29,7562,7863,15425,"Champaign-Urbana, IL",40.102988,-88.318504,222696
1686,16580,30-34,7059,7182,14241,"Champaign-Urbana, IL",40.102988,-88.318504,222696
1687,16580,35-39,6831,6805,13636,"Champaign-Urbana, IL",40.102988,-88.318504,222696
1688,16580,40-44,6303,6155,12458,"Champaign-Urbana, IL",40.102988,-88.318504,222696
1689,16580,45-49,5560,5447,11007,"Champaign-Urbana, IL",40.102988,-88.318504,222696
1690,16580,50-54,5405,5438,10843,"Champaign-Urbana, IL",40.102988,-88.318504,222696
1691,16580,55-59,5718,5347,11065,"Champaign-Urbana, IL",40.102988,-88.318504,222696
1692,16580,60-64,6186,5752,11938,"Champaign-Urbana, IL",40.102988,-88.318504,222696
1693,16580,65+,17461,14211,31672,"Champaign-Urbana, IL",40.102988,-88.318504,222696
1694,16620,15-19,7139,7773,14912,"Charleston, WV",38.355177,-81.620341,255020
1695,16620,20-24,6731,6827,13558,"Charleston, WV",38.355177,-81.620341,255020
1696,16620,25-29,7445,7617,15062,"Charleston, WV",38.355177,-81.620341,255020
1697,16620,30-34,7495,7435,14930,"Charleston, WV",38.355177,-81.620341,255020
1698,16620,35-39,7252,7152,14404,"Charleston, WV",38.355177,-81.620341,255020
1699,16620,40-44,8083,7878,15961,"Charleston, WV",38.355177,-81.620341,255020
1700,16620,45-49,7786,7843,15629,"Charleston, WV",38.355177,-81.620341,255020
1701,16620,50-54,8421,8257,16678,"Charleston, WV",38.355177,-81.620341,255020
1702,16620,55-59,9023,8558,17581,"Charleston, WV",38.355177,-81.620341,255020
1703,16620,60-64,9820,9203,19023,"Charleston, WV",38.355177,-81.620341,255020
1704,16620,65+,30143,24704,54847,"Charleston, WV",38.355177,-81.620341,255020
1705,16660,15-19,2257,2102,4359,"Charleston-Mattoon, IL",39.423163,-88.242212,57110
1706,16660,20-24,3201,2987,6188,"Charleston-Mattoon, IL",39.423163,-88.242212,57110
1707,16660,25-29,1676,1724,3400,"Charleston-Mattoon, IL",39.423163,-88.242212,57110
1708,16660,30-34,1810,1766,3576,"Charleston-Mattoon, IL",39.423163,-88.242212,57110
1709,16660,35-39,1656,1682,3338,"Charleston-Mattoon, IL",39.423163,-88.242212,57110
1710,16660,40-44,1596,1647,3243,"Charleston-Mattoon, IL",39.423163,-88.242212,57110
1711,16660,45-49,1456,1595,3051,"Charleston-Mattoon, IL",39.423163,-88.242212,57110
1712,16660,50-54,1576,1628,3204,"Charleston-Mattoon, IL",39.423163,-88.242212,57110
1713,16660,55-59,1743,1698,3441,"Charleston-Mattoon, IL",39.423163,-88.242212,57110
1714,16660,60-64,2007,1948,3955,"Charleston-Mattoon, IL",39.423163,-88.242212,57110
1715,16660,65+,5764,4703,10467,"Charleston-Mattoon, IL",39.423163,-88.242212,57110
1716,16700,15-19,23837,25748,49585,"Charleston-North Charleston, SC",33.01754,-80.009947,813052
1717,16700,20-24,23439,26101,49540,"Charleston-North Charleston, SC",33.01754,-80.009947,813052
1718,16700,25-29,28938,28347,57285,"Charleston-North Charleston, SC",33.01754,-80.009947,813052
1719,16700,30-34,32632,30968,63600,"Charleston-North Charleston, SC",33.01754,-80.009947,813052
1720,16700,35-39,30796,29824,60620,"Charleston-North Charleston, SC",33.01754,-80.009947,813052
1721,16700,40-44,27419,26541,53960,"Charleston-North Charleston, SC",33.01754,-80.009947,813052
1722,16700,45-49,24026,23365,47391,"Charleston-North Charleston, SC",33.01754,-80.009947,813052
1723,16700,50-54,25443,24353,49796,"Charleston-North Charleston, SC",33.01754,-80.009947,813052
1724,16700,55-59,27399,25095,52494,"Charleston-North Charleston, SC",33.01754,-80.009947,813052
1725,16700,60-64,27337,24316,51653,"Charleston-North Charleston, SC",33.01754,-80.009947,813052
1726,16700,65+,72349,58792,131141,"Charleston-North Charleston, SC",33.01754,-80.009947,813052
1727,16740,15-19,87512,90442,177954,"Charlotte-Concord-Gastonia, NC-SC",35.166342,-80.797285,2701046
1728,16740,20-24,81898,80052,161950,"Charlotte-Concord-Gastonia, NC-SC",35.166342,-80.797285,2701046
1729,16740,25-29,93935,91790,185725,"Charlotte-Concord-Gastonia, NC-SC",35.166342,-80.797285,2701046
1730,16740,30-34,100658,95535,196193,"Charlotte-Concord-Gastonia, NC-SC",35.166342,-80.797285,2701046
1731,16740,35-39,96211,92237,188448,"Charlotte-Concord-Gastonia, NC-SC",35.166342,-80.797285,2701046
1732,16740,40-44,95448,90351,185799,"Charlotte-Concord-Gastonia, NC-SC",35.166342,-80.797285,2701046
1733,16740,45-49,93350,88473,181823,"Charlotte-Concord-Gastonia, NC-SC",35.166342,-80.797285,2701046
1734,16740,50-54,95843,93309,189152,"Charlotte-Concord-Gastonia, NC-SC",35.166342,-80.797285,2701046
1735,16740,55-59,89976,86417,176393,"Charlotte-Concord-Gastonia, NC-SC",35.166342,-80.797285,2701046
1736,16740,60-64,82311,76845,159156,"Charlotte-Concord-Gastonia, NC-SC",35.166342,-80.797285,2701046
1737,16740,65+,215461,169136,384597,"Charlotte-Concord-Gastonia, NC-SC",35.166342,-80.797285,2701046
1738,16820,15-19,7837,7662,15499,"Charlottesville, VA",37.949084,-78.593206,222688
1739,16820,20-24,9119,8648,17767,"Charlottesville, VA",37.949084,-78.593206,222688
1740,16820,25-29,7746,7115,14861,"Charlottesville, VA",37.949084,-78.593206,222688
1741,16820,30-34,7927,7405,15332,"Charlottesville, VA",37.949084,-78.593206,222688
1742,16820,35-39,7385,7128,14513,"Charlottesville, VA",37.949084,-78.593206,222688
1743,16820,40-44,6956,6583,13539,"Charlottesville, VA",37.949084,-78.593206,222688
1744,16820,45-49,6065,5861,11926,"Charlottesville, VA",37.949084,-78.593206,222688
1745,16820,50-54,6748,6423,13171,"Charlottesville, VA",37.949084,-78.593206,222688
1746,16820,55-59,7383,6560,13943,"Charlottesville, VA",37.949084,-78.593206,222688
1747,16820,60-64,7699,6889,14588,"Charlottesville, VA",37.949084,-78.593206,222688
1748,16820,65+,23350,18973,42323,"Charlottesville, VA",37.949084,-78.593206,222688
1749,16860,15-19,17052,17275,34327,"Chattanooga, TN-GA",35.049361,-85.361158,567641
1750,16860,20-24,16608,16885,33493,"Chattanooga, TN-GA",35.049361,-85.361158,567641
1751,16860,25-29,18970,18736,37706,"Chattanooga, TN-GA",35.049361,-85.361158,567641
1752,16860,30-34,20261,19296,39557,"Chattanooga, TN-GA",35.049361,-85.361158,567641
1753,16860,35-39,18151,17939,36090,"Chattanooga, TN-GA",35.049361,-85.361158,567641
1754,16860,40-44,17897,17521,35418,"Chattanooga, TN-GA",35.049361,-85.361158,567641
1755,16860,45-49,17434,17014,34448,"Chattanooga, TN-GA",35.049361,-85.361158,567641
1756,16860,50-54,18651,18165,36816,"Chattanooga, TN-GA",35.049361,-85.361158,567641
1757,16860,55-59,19355,18476,37831,"Chattanooga, TN-GA",35.049361,-85.361158,567641
1758,16860,60-64,19846,18129,37975,"Chattanooga, TN-GA",35.049361,-85.361158,567641
1759,16860,65+,58724,46824,105548,"Chattanooga, TN-GA",35.049361,-85.361158,567641
1760,16940,15-19,3030,3265,6295,"Cheyenne, WY",41.29283,-104.660395,100863
1761,16940,20-24,3027,3722,6749,"Cheyenne, WY",41.29283,-104.660395,100863
1762,16940,25-29,3347,3627,6974,"Cheyenne, WY",41.29283,-104.660395,100863
1763,16940,30-34,3509,3784,7293,"Cheyenne, WY",41.29283,-104.660395,100863
1764,16940,35-39,3485,3702,7187,"Cheyenne, WY",41.29283,-104.660395,100863
1765,16940,40-44,2951,3232,6183,"Cheyenne, WY",41.29283,-104.660395,100863
1766,16940,45-49,2651,2811,5462,"Cheyenne, WY",41.29283,-104.660395,100863
1767,16940,50-54,2786,2940,5726,"Cheyenne, WY",41.29283,-104.660395,100863
1768,16940,55-59,3111,3226,6337,"Cheyenne, WY",41.29283,-104.660395,100863
1769,16940,60-64,3317,3236,6553,"Cheyenne, WY",41.29283,-104.660395,100863
1770,16940,65+,9146,8037,17183,"Cheyenne, WY",41.29283,-104.660395,100863
1771,16980,15-19,306021,321319,627340,"Chicago-Naperville-Elgin, IL-IN-WI",41.823521,-87.828297,9509934
1772,16980,20-24,297147,299995,597142,"Chicago-Naperville-Elgin, IL-IN-WI",41.823521,-87.828297,9509934
1773,16980,25-29,331915,331272,663187,"Chicago-Naperville-Elgin, IL-IN-WI",41.823521,-87.828297,9509934
1774,16980,30-34,333669,336217,669886,"Chicago-Naperville-Elgin, IL-IN-WI",41.823521,-87.828297,9509934
1775,16980,35-39,329945,332907,662852,"Chicago-Naperville-Elgin, IL-IN-WI",41.823521,-87.828297,9509934
1776,16980,40-44,317789,317692,635481,"Chicago-Naperville-Elgin, IL-IN-WI",41.823521,-87.828297,9509934
1777,16980,45-49,299187,296208,595395,"Chicago-Naperville-Elgin, IL-IN-WI",41.823521,-87.828297,9509934
1778,16980,50-54,311014,308695,619709,"Chicago-Naperville-Elgin, IL-IN-WI",41.823521,-87.828297,9509934
1779,16980,55-59,313589,306646,620235,"Chicago-Naperville-Elgin, IL-IN-WI",41.823521,-87.828297,9509934
1780,16980,60-64,308997,292412,601409,"Chicago-Naperville-Elgin, IL-IN-WI",41.823521,-87.828297,9509934
1781,16980,65+,826917,655681,1482598,"Chicago-Naperville-Elgin, IL-IN-WI",41.823521,-87.828297,9509934
1782,17020,15-19,7572,7368,14940,"Chico, CA",39.665336,-121.603209,208309
1783,17020,20-24,11239,11473,22712,"Chico, CA",39.665336,-121.603209,208309
1784,17020,25-29,6777,7241,14018,"Chico, CA",39.665336,-121.603209,208309
1785,17020,30-34,6317,6836,13153,"Chico, CA",39.665336,-121.603209,208309
1786,17020,35-39,6203,6454,12657,"Chico, CA",39.665336,-121.603209,208309
1787,17020,40-44,5746,6223,11969,"Chico, CA",39.665336,-121.603209,208309
1788,17020,45-49,5119,5252,10371,"Chico, CA",39.665336,-121.603209,208309
1789,17020,50-54,5446,5521,10967,"Chico, CA",39.665336,-121.603209,208309
1790,17020,55-59,6080,5619,11699,"Chico, CA",39.665336,-121.603209,208309
1791,17020,60-64,6590,6223,12813,"Chico, CA",39.665336,-121.603209,208309
1792,17020,65+,20655,17337,37992,"Chico, CA",39.665336,-121.603209,208309
1793,17060,15-19,2116,2381,4497,"Chillicothe, OH",39.323895,-83.059538,76891
1794,17060,20-24,1942,2414,4356,"Chillicothe, OH",39.323895,-83.059538,76891
1795,17060,25-29,2167,2757,4924,"Chillicothe, OH",39.323895,-83.059538,76891
1796,17060,30-34,2083,2806,4889,"Chillicothe, OH",39.323895,-83.059538,76891
1797,17060,35-39,2071,2816,4887,"Chillicothe, OH",39.323895,-83.059538,76891
1798,17060,40-44,2296,2874,5170,"Chillicothe, OH",39.323895,-83.059538,76891
1799,17060,45-49,2224,2858,5082,"Chillicothe, OH",39.323895,-83.059538,76891
1800,17060,50-54,2415,2985,5400,"Chillicothe, OH",39.323895,-83.059538,76891
1801,17060,55-59,2585,2872,5457,"Chillicothe, OH",39.323895,-83.059538,76891
1802,17060,60-64,2752,2693,5445,"Chillicothe, OH",39.323895,-83.059538,76891
1803,17060,65+,7347,6190,13537,"Chillicothe, OH",39.323895,-83.059538,76891
1804,17140,15-19,75436,78802,154238,"Cincinnati, OH-KY-IN",39.100546,-84.479533,2259935
1805,17140,20-24,72274,74625,146899,"Cincinnati, OH-KY-IN",39.100546,-84.479533,2259935
1806,17140,25-29,73198,74857,148055,"Cincinnati, OH-KY-IN",39.100546,-84.479533,2259935
1807,17140,30-34,76467,76339,152806,"Cincinnati, OH-KY-IN",39.100546,-84.479533,2259935
1808,17140,35-39,74239,73718,147957,"Cincinnati, OH-KY-IN",39.100546,-84.479533,2259935
1809,17140,40-44,71136,70356,141492,"Cincinnati, OH-KY-IN",39.100546,-84.479533,2259935
1810,17140,45-49,65222,65046,130268,"Cincinnati, OH-KY-IN",39.100546,-84.479533,2259935
1811,17140,50-54,72002,71459,143461,"Cincinnati, OH-KY-IN",39.100546,-84.479533,2259935
1812,17140,55-59,75926,74258,150184,"Cincinnati, OH-KY-IN",39.100546,-84.479533,2259935
1813,17140,60-64,76706,72887,149593,"Cincinnati, OH-KY-IN",39.100546,-84.479533,2259935
1814,17140,65+,199783,163402,363185,"Cincinnati, OH-KY-IN",39.100546,-84.479533,2259935
1815,17220,15-19,2373,2738,5111,"Clarksburg, WV",39.28835,-80.43153,89385
1816,17220,20-24,2206,2454,4660,"Clarksburg, WV",39.28835,-80.43153,89385
1817,17220,25-29,2531,2811,5342,"Clarksburg, WV",39.28835,-80.43153,89385
1818,17220,30-34,2588,2761,5349,"Clarksburg, WV",39.28835,-80.43153,89385
1819,17220,35-39,2675,2826,5501,"Clarksburg, WV",39.28835,-80.43153,89385
1820,17220,40-44,2831,2995,5826,"Clarksburg, WV",39.28835,-80.43153,89385
1821,17220,45-49,2771,2893,5664,"Clarksburg, WV",39.28835,-80.43153,89385
1822,17220,50-54,2916,3086,6002,"Clarksburg, WV",39.28835,-80.43153,89385
1823,17220,55-59,3136,3217,6353,"Clarksburg, WV",39.28835,-80.43153,89385
1824,17220,60-64,3211,3231,6442,"Clarksburg, WV",39.28835,-80.43153,89385
1825,17220,65+,9899,8286,18185,"Clarksburg, WV",39.28835,-80.43153,89385
1826,17260,15-19,716,816,1532,"Clarksdale, MS",34.230316,-90.60401,20810
1827,17260,20-24,711,681,1392,"Clarksdale, MS",34.230316,-90.60401,20810
1828,17260,25-29,723,591,1314,"Clarksdale, MS",34.230316,-90.60401,20810
1829,17260,30-34,653,546,1199,"Clarksdale, MS",34.230316,-90.60401,20810
1830,17260,35-39,641,505,1146,"Clarksdale, MS",34.230316,-90.60401,20810
1831,17260,40-44,663,503,1166,"Clarksdale, MS",34.230316,-90.60401,20810
1832,17260,45-49,594,477,1071,"Clarksdale, MS",34.230316,-90.60401,20810
1833,17260,50-54,645,496,1141,"Clarksdale, MS",34.230316,-90.60401,20810
1834,17260,55-59,692,592,1284,"Clarksdale, MS",34.230316,-90.60401,20810
1835,17260,60-64,752,638,1390,"Clarksdale, MS",34.230316,-90.60401,20810
1836,17260,65+,1926,1480,3406,"Clarksdale, MS",34.230316,-90.60401,20810
1837,17300,15-19,9965,11181,21146,"Clarksville, TN-KY",36.69571,-87.624307,328304
1838,17300,20-24,12287,16528,28815,"Clarksville, TN-KY",36.69571,-87.624307,328304
1839,17300,25-29,13979,16183,30162,"Clarksville, TN-KY",36.69571,-87.624307,328304
1840,17300,30-34,13171,13657,26828,"Clarksville, TN-KY",36.69571,-87.624307,328304
1841,17300,35-39,11492,11660,23152,"Clarksville, TN-KY",36.69571,-87.624307,328304
1842,17300,40-44,9864,9686,19550,"Clarksville, TN-KY",36.69571,-87.624307,328304
1843,17300,45-49,8635,8357,16992,"Clarksville, TN-KY",36.69571,-87.624307,328304
1844,17300,50-54,8604,8080,16684,"Clarksville, TN-KY",36.69571,-87.624307,328304
1845,17300,55-59,8840,8225,17065,"Clarksville, TN-KY",36.69571,-87.624307,328304
1846,17300,60-64,8285,7434,15719,"Clarksville, TN-KY",36.69571,-87.624307,328304
1847,17300,65+,20726,16857,37583,"Clarksville, TN-KY",36.69571,-87.624307,328304
1848,17340,15-19,1789,1963,3752,"Clearlake, CA",39.094802,-122.746757,68766
1849,17340,20-24,1504,1655,3159,"Clearlake, CA",39.094802,-122.746757,68766
1850,17340,25-29,1698,1863,3561,"Clearlake, CA",39.094802,-122.746757,68766
1851,17340,30-34,2051,2134,4185,"Clearlake, CA",39.094802,-122.746757,68766
1852,17340,35-39,1974,2165,4139,"Clearlake, CA",39.094802,-122.746757,68766
1853,17340,40-44,1869,1972,3841,"Clearlake, CA",39.094802,-122.746757,68766
1854,17340,45-49,1726,1728,3454,"Clearlake, CA",39.094802,-122.746757,68766
1855,17340,50-54,2102,1946,4048,"Clearlake, CA",39.094802,-122.746757,68766
1856,17340,55-59,2441,2320,4761,"Clearlake, CA",39.094802,-122.746757,68766
1857,17340,60-64,2774,2676,5450,"Clearlake, CA",39.094802,-122.746757,68766
1858,17340,65+,8165,7699,15864,"Clearlake, CA",39.094802,-122.746757,68766
1859,17380,15-19,1066,983,2049,"Cleveland, MS",33.799139,-90.88412,30308
1860,17380,20-24,1120,1051,2171,"Cleveland, MS",33.799139,-90.88412,30308
1861,17380,25-29,935,912,1847,"Cleveland, MS",33.799139,-90.88412,30308
1862,17380,30-34,1042,991,2033,"Cleveland, MS",33.799139,-90.88412,30308
1863,17380,35-39,988,900,1888,"Cleveland, MS",33.799139,-90.88412,30308
1864,17380,40-44,899,808,1707,"Cleveland, MS",33.799139,-90.88412,30308
1865,17380,45-49,893,733,1626,"Cleveland, MS",33.799139,-90.88412,30308
1866,17380,50-54,965,811,1776,"Cleveland, MS",33.799139,-90.88412,30308
1867,17380,55-59,1012,841,1853,"Cleveland, MS",33.799139,-90.88412,30308
1868,17380,60-64,1039,832,1871,"Cleveland, MS",33.799139,-90.88412,30308
1869,17380,65+,3044,2127,5171,"Cleveland, MS",33.799139,-90.88412,30308
1870,17420,15-19,4110,4246,8356,"Cleveland, TN",35.138117,-84.655079,127938
1871,17420,20-24,4076,4012,8088,"Cleveland, TN",35.138117,-84.655079,127938
1872,17420,25-29,4022,4005,8027,"Cleveland, TN",35.138117,-84.655079,127938
1873,17420,30-34,4133,4002,8135,"Cleveland, TN",35.138117,-84.655079,127938
1874,17420,35-39,3650,3708,7358,"Cleveland, TN",35.138117,-84.655079,127938
1875,17420,40-44,4056,3848,7904,"Cleveland, TN",35.138117,-84.655079,127938
1876,17420,45-49,4116,4225,8341,"Cleveland, TN",35.138117,-84.655079,127938
1877,17420,50-54,4436,4409,8845,"Cleveland, TN",35.138117,-84.655079,127938
1878,17420,55-59,4611,4406,9017,"Cleveland, TN",35.138117,-84.655079,127938
1879,17420,60-64,4440,4008,8448,"Cleveland, TN",35.138117,-84.655079,127938
1880,17420,65+,12706,10335,23041,"Cleveland, TN",35.138117,-84.655079,127938
1881,17460,15-19,61537,64544,126081,"Cleveland-Elyria, OH",41.555037,-81.604957,2075662
1882,17460,20-24,60999,61468,122467,"Cleveland-Elyria, OH",41.555037,-81.604957,2075662
1883,17460,25-29,68357,67446,135803,"Cleveland-Elyria, OH",41.555037,-81.604957,2075662
1884,17460,30-34,69138,67578,136716,"Cleveland-Elyria, OH",41.555037,-81.604957,2075662
1885,17460,35-39,64984,63241,128225,"Cleveland-Elyria, OH",41.555037,-81.604957,2075662
1886,17460,40-44,62351,60683,123034,"Cleveland-Elyria, OH",41.555037,-81.604957,2075662
1887,17460,45-49,60090,57909,117999,"Cleveland-Elyria, OH",41.555037,-81.604957,2075662
1888,17460,50-54,68280,65946,134226,"Cleveland-Elyria, OH",41.555037,-81.604957,2075662
1889,17460,55-59,74229,69406,143635,"Cleveland-Elyria, OH",41.555037,-81.604957,2075662
1890,17460,60-64,78510,72998,151508,"Cleveland-Elyria, OH",41.555037,-81.604957,2075662
1891,17460,65+,225512,177075,402587,"Cleveland-Elyria, OH",41.555037,-81.604957,2075662
1892,17500,15-19,1426,1460,2886,"Clewiston, FL",26.539967,-81.152114,40313
1893,17500,20-24,1144,1459,2603,"Clewiston, FL",26.539967,-81.152114,40313
1894,17500,25-29,1178,1541,2719,"Clewiston, FL",26.539967,-81.152114,40313
1895,17500,30-34,1255,1500,2755,"Clewiston, FL",26.539967,-81.152114,40313
1896,17500,35-39,1154,1496,2650,"Clewiston, FL",26.539967,-81.152114,40313
1897,17500,40-44,1182,1342,2524,"Clewiston, FL",26.539967,-81.152114,40313
1898,17500,45-49,1163,1278,2441,"Clewiston, FL",26.539967,-81.152114,40313
1899,17500,50-54,1179,1333,2512,"Clewiston, FL",26.539967,-81.152114,40313
1900,17500,55-59,1245,1385,2630,"Clewiston, FL",26.539967,-81.152114,40313
1901,17500,60-64,1041,1102,2143,"Clewiston, FL",26.539967,-81.152114,40313
1902,17500,65+,2764,2766,5530,"Clewiston, FL",26.539967,-81.152114,40313
1903,17540,15-19,1340,1409,2749,"Clinton, IA",41.898073,-90.534243,46463
1904,17540,20-24,1242,1209,2451,"Clinton, IA",41.898073,-90.534243,46463
1905,17540,25-29,1360,1320,2680,"Clinton, IA",41.898073,-90.534243,46463
1906,17540,30-34,1317,1289,2606,"Clinton, IA",41.898073,-90.534243,46463
1907,17540,35-39,1336,1345,2681,"Clinton, IA",41.898073,-90.534243,46463
1908,17540,40-44,1385,1423,2808,"Clinton, IA",41.898073,-90.534243,46463
1909,17540,45-49,1264,1234,2498,"Clinton, IA",41.898073,-90.534243,46463
1910,17540,50-54,1423,1464,2887,"Clinton, IA",41.898073,-90.534243,46463
1911,17540,55-59,1687,1655,3342,"Clinton, IA",41.898073,-90.534243,46463
1912,17540,60-64,1788,1784,3572,"Clinton, IA",41.898073,-90.534243,46463
1913,17540,65+,5037,4330,9367,"Clinton, IA",41.898073,-90.534243,46463
1914,17580,15-19,1525,1780,3305,"Clovis, NM",34.572984,-103.346055,47999
1915,17580,20-24,1722,2720,4442,"Clovis, NM",34.572984,-103.346055,47999
1916,17580,25-29,1866,2422,4288,"Clovis, NM",34.572984,-103.346055,47999
1917,17580,30-34,1806,1991,3797,"Clovis, NM",34.572984,-103.346055,47999
1918,17580,35-39,1595,1690,3285,"Clovis, NM",34.572984,-103.346055,47999
1919,17580,40-44,1234,1361,2595,"Clovis, NM",34.572984,-103.346055,47999
1920,17580,45-49,1112,1078,2190,"Clovis, NM",34.572984,-103.346055,47999
1921,17580,50-54,1080,1079,2159,"Clovis, NM",34.572984,-103.346055,47999
1922,17580,55-59,1292,1166,2458,"Clovis, NM",34.572984,-103.346055,47999
1923,17580,60-64,1211,1242,2453,"Clovis, NM",34.572984,-103.346055,47999
1924,17580,65+,3443,2851,6294,"Clovis, NM",34.572984,-103.346055,47999
1925,17660,15-19,5163,5672,10835,"Coeur d'Alene, ID",47.675957,-116.695919,179789
1926,17660,20-24,4448,4768,9216,"Coeur d'Alene, ID",47.675957,-116.695919,179789
1927,17660,25-29,5327,5592,10919,"Coeur d'Alene, ID",47.675957,-116.695919,179789
1928,17660,30-34,6072,5966,12038,"Coeur d'Alene, ID",47.675957,-116.695919,179789
1929,17660,35-39,6018,5889,11907,"Coeur d'Alene, ID",47.675957,-116.695919,179789
1930,17660,40-44,5586,5708,11294,"Coeur d'Alene, ID",47.675957,-116.695919,179789
1931,17660,45-49,4967,5145,10112,"Coeur d'Alene, ID",47.675957,-116.695919,179789
1932,17660,50-54,5427,5488,10915,"Coeur d'Alene, ID",47.675957,-116.695919,179789
1933,17660,55-59,6026,5553,11579,"Coeur d'Alene, ID",47.675957,-116.695919,179789
1934,17660,60-64,6431,6068,12499,"Coeur d'Alene, ID",47.675957,-116.695919,179789
1935,17660,65+,18565,16441,35006,"Coeur d'Alene, ID",47.675957,-116.695919,179789
1936,17700,15-19,1121,1346,2467,"Coffeyville, KS",37.189537,-95.742403,31156
1937,17700,20-24,740,996,1736,"Coffeyville, KS",37.189537,-95.742403,31156
1938,17700,25-29,752,818,1570,"Coffeyville, KS",37.189537,-95.742403,31156
1939,17700,30-34,915,873,1788,"Coffeyville, KS",37.189537,-95.742403,31156
1940,17700,35-39,937,952,1889,"Coffeyville, KS",37.189537,-95.742403,31156
1941,17700,40-44,851,820,1671,"Coffeyville, KS",37.189537,-95.742403,31156
1942,17700,45-49,788,848,1636,"Coffeyville, KS",37.189537,-95.742403,31156
1943,17700,50-54,887,853,1740,"Coffeyville, KS",37.189537,-95.742403,31156
1944,17700,55-59,1044,1003,2047,"Coffeyville, KS",37.189537,-95.742403,31156
1945,17700,60-64,1154,1101,2255,"Coffeyville, KS",37.189537,-95.742403,31156
1946,17700,65+,3484,2940,6424,"Coffeyville, KS",37.189537,-95.742403,31156
1947,17740,15-19,1362,1460,2822,"Coldwater, MI",41.918455,-85.066885,44985
1948,17740,20-24,1117,1343,2460,"Coldwater, MI",41.918455,-85.066885,44985
1949,17740,25-29,1222,1422,2644,"Coldwater, MI",41.918455,-85.066885,44985
1950,17740,30-34,1188,1408,2596,"Coldwater, MI",41.918455,-85.066885,44985
1951,17740,35-39,1290,1559,2849,"Coldwater, MI",41.918455,-85.066885,44985
1952,17740,40-44,1176,1546,2722,"Coldwater, MI",41.918455,-85.066885,44985
1953,17740,45-49,1098,1493,2591,"Coldwater, MI",41.918455,-85.066885,44985
1954,17740,50-54,1289,1531,2820,"Coldwater, MI",41.918455,-85.066885,44985
1955,17740,55-59,1463,1604,3067,"Coldwater, MI",41.918455,-85.066885,44985
1956,17740,60-64,1669,1693,3362,"Coldwater, MI",41.918455,-85.066885,44985
1957,17740,65+,4482,3953,8435,"Coldwater, MI",41.918455,-85.066885,44985
1958,17780,15-19,12438,12365,24803,"College Station-Bryan, TX",30.754392,-96.488537,272041
1959,17780,20-24,21203,23743,44946,"College Station-Bryan, TX",30.754392,-96.488537,272041
1960,17780,25-29,10113,10823,20936,"College Station-Bryan, TX",30.754392,-96.488537,272041
1961,17780,30-34,9328,9391,18719,"College Station-Bryan, TX",30.754392,-96.488537,272041
1962,17780,35-39,8544,8850,17394,"College Station-Bryan, TX",30.754392,-96.488537,272041
1963,17780,40-44,7549,7721,15270,"College Station-Bryan, TX",30.754392,-96.488537,272041
1964,17780,45-49,6412,6217,12629,"College Station-Bryan, TX",30.754392,-96.488537,272041
1965,17780,50-54,6561,6362,12923,"College Station-Bryan, TX",30.754392,-96.488537,272041
1966,17780,55-59,6555,6245,12800,"College Station-Bryan, TX",30.754392,-96.488537,272041
1967,17780,60-64,6508,6137,12645,"College Station-Bryan, TX",30.754392,-96.488537,272041
1968,17780,65+,16751,14427,31178,"College Station-Bryan, TX",30.754392,-96.488537,272041
1969,17820,15-19,23924,26831,50755,"Colorado Springs, CO",38.845507,-104.638728,762793
1970,17820,20-24,25725,33020,58745,"Colorado Springs, CO",38.845507,-104.638728,762793
1971,17820,25-29,28894,33015,61909,"Colorado Springs, CO",38.845507,-104.638728,762793
1972,17820,30-34,28509,30894,59403,"Colorado Springs, CO",38.845507,-104.638728,762793
1973,17820,35-39,26930,28931,55861,"Colorado Springs, CO",38.845507,-104.638728,762793
1974,17820,40-44,23626,24426,48052,"Colorado Springs, CO",38.845507,-104.638728,762793
1975,17820,45-49,20796,21532,42328,"Colorado Springs, CO",38.845507,-104.638728,762793
1976,17820,50-54,21408,21441,42849,"Colorado Springs, CO",38.845507,-104.638728,762793
1977,17820,55-59,23434,22122,45556,"Colorado Springs, CO",38.845507,-104.638728,762793
1978,17820,60-64,22906,21697,44603,"Colorado Springs, CO",38.845507,-104.638728,762793
1979,17820,65+,57543,48433,105976,"Colorado Springs, CO",38.845507,-104.638728,762793
1980,17860,15-19,8990,8306,17296,"Columbia, MO",38.986486,-92.585189,213123
1981,17860,20-24,13736,12689,26425,"Columbia, MO",38.986486,-92.585189,213123
1982,17860,25-29,7953,7842,15795,"Columbia, MO",38.986486,-92.585189,213123
1983,17860,30-34,7481,7318,14799,"Columbia, MO",38.986486,-92.585189,213123
1984,17860,35-39,6858,6859,13717,"Columbia, MO",38.986486,-92.585189,213123
1985,17860,40-44,6433,6304,12737,"Columbia, MO",38.986486,-92.585189,213123
1986,17860,45-49,5494,5464,10958,"Columbia, MO",38.986486,-92.585189,213123
1987,17860,50-54,5610,5477,11087,"Columbia, MO",38.986486,-92.585189,213123
1988,17860,55-59,5915,5676,11591,"Columbia, MO",38.986486,-92.585189,213123
1989,17860,60-64,6197,5698,11895,"Columbia, MO",38.986486,-92.585189,213123
1990,17860,65+,16560,13667,30227,"Columbia, MO",38.986486,-92.585189,213123
1991,17900,15-19,28829,30885,59714,"Columbia, SC",34.077585,-81.037845,838250
1992,17900,20-24,32427,34572,66999,"Columbia, SC",34.077585,-81.037845,838250
1993,17900,25-29,29026,28154,57180,"Columbia, SC",34.077585,-81.037845,838250
1994,17900,30-34,29706,27622,57328,"Columbia, SC",34.077585,-81.037845,838250
1995,17900,35-39,28152,26360,54512,"Columbia, SC",34.077585,-81.037845,838250
1996,17900,40-44,26982,24938,51920,"Columbia, SC",34.077585,-81.037845,838250
1997,17900,45-49,25773,23642,49415,"Columbia, SC",34.077585,-81.037845,838250
1998,17900,50-54,26705,25285,51990,"Columbia, SC",34.077585,-81.037845,838250
1999,17900,55-59,28108,25453,53561,"Columbia, SC",34.077585,-81.037845,838250
2000,17900,60-64,27517,24784,52301,"Columbia, SC",34.077585,-81.037845,838250
2001,17900,65+,73777,58467,132244,"Columbia, SC",34.077585,-81.037845,838250
2002,17980,15-19,9596,11132,20728,"Columbus, GA-AL",32.419377,-84.843709,327536
2003,17980,20-24,10134,12570,22704,"Columbus, GA-AL",32.419377,-84.843709,327536
2004,17980,25-29,12063,13353,25416,"Columbus, GA-AL",32.419377,-84.843709,327536
2005,17980,30-34,12280,12601,24881,"Columbus, GA-AL",32.419377,-84.843709,327536
2006,17980,35-39,11233,11056,22289,"Columbus, GA-AL",32.419377,-84.843709,327536
2007,17980,40-44,10206,9633,19839,"Columbus, GA-AL",32.419377,-84.843709,327536
2008,17980,45-49,9546,8842,18388,"Columbus, GA-AL",32.419377,-84.843709,327536
2009,17980,50-54,9587,9041,18628,"Columbus, GA-AL",32.419377,-84.843709,327536
2010,17980,55-59,10534,9610,20144,"Columbus, GA-AL",32.419377,-84.843709,327536
2011,17980,60-64,10205,9409,19614,"Columbus, GA-AL",32.419377,-84.843709,327536
2012,17980,65+,28088,21088,49176,"Columbus, GA-AL",32.419377,-84.843709,327536
2013,18020,15-19,2645,2498,5143,"Columbus, IN",39.205843,-85.897999,82475
2014,18020,20-24,2290,2472,4762,"Columbus, IN",39.205843,-85.897999,82475
2015,18020,25-29,2719,3219,5938,"Columbus, IN",39.205843,-85.897999,82475
2016,18020,30-34,2688,3044,5732,"Columbus, IN",39.205843,-85.897999,82475
2017,18020,35-39,2610,2912,5522,"Columbus, IN",39.205843,-85.897999,82475
2018,18020,40-44,2449,2624,5073,"Columbus, IN",39.205843,-85.897999,82475
2019,18020,45-49,2473,2585,5058,"Columbus, IN",39.205843,-85.897999,82475
2020,18020,50-54,2434,2674,5108,"Columbus, IN",39.205843,-85.897999,82475
2021,18020,55-59,2505,2544,5049,"Columbus, IN",39.205843,-85.897999,82475
2022,18020,60-64,2524,2423,4947,"Columbus, IN",39.205843,-85.897999,82475
2023,18020,65+,7460,6206,13666,"Columbus, IN",39.205843,-85.897999,82475
2024,18060,15-19,1858,1889,3747,"Columbus, MS",33.471424,-88.439723,58150
2025,18060,20-24,1973,1837,3810,"Columbus, MS",33.471424,-88.439723,58150
2026,18060,25-29,2066,1987,4053,"Columbus, MS",33.471424,-88.439723,58150
2027,18060,30-34,2078,1888,3966,"Columbus, MS",33.471424,-88.439723,58150
2028,18060,35-39,1886,1765,3651,"Columbus, MS",33.471424,-88.439723,58150
2029,18060,40-44,1754,1611,3365,"Columbus, MS",33.471424,-88.439723,58150
2030,18060,45-49,1674,1440,3114,"Columbus, MS",33.471424,-88.439723,58150
2031,18060,50-54,1828,1610,3438,"Columbus, MS",33.471424,-88.439723,58150
2032,18060,55-59,1953,1787,3740,"Columbus, MS",33.471424,-88.439723,58150
2033,18060,60-64,2008,1801,3809,"Columbus, MS",33.471424,-88.439723,58150
2034,18060,65+,5532,4205,9737,"Columbus, MS",33.471424,-88.439723,58150
2035,18100,15-19,1156,1172,2328,"Columbus, NE",41.576866,-97.513467,34241
2036,18100,20-24,899,1011,1910,"Columbus, NE",41.576866,-97.513467,34241
2037,18100,25-29,955,1097,2052,"Columbus, NE",41.576866,-97.513467,34241
2038,18100,30-34,951,1047,1998,"Columbus, NE",41.576866,-97.513467,34241
2039,18100,35-39,991,1167,2158,"Columbus, NE",41.576866,-97.513467,34241
2040,18100,40-44,993,1069,2062,"Columbus, NE",41.576866,-97.513467,34241
2041,18100,45-49,905,961,1866,"Columbus, NE",41.576866,-97.513467,34241
2042,18100,50-54,850,963,1813,"Columbus, NE",41.576866,-97.513467,34241
2043,18100,55-59,1052,1076,2128,"Columbus, NE",41.576866,-97.513467,34241
2044,18100,60-64,1127,1174,2301,"Columbus, NE",41.576866,-97.513467,34241
2045,18100,65+,3227,2876,6103,"Columbus, NE",41.576866,-97.513467,34241
2046,18140,15-19,69076,72323,141399,"Columbus, OH",39.968562,-82.835911,2151017
2047,18140,20-24,67798,68242,136040,"Columbus, OH",39.968562,-82.835911,2151017
2048,18140,25-29,79516,79936,159452,"Columbus, OH",39.968562,-82.835911,2151017
2049,18140,30-34,85033,84885,169918,"Columbus, OH",39.968562,-82.835911,2151017
2050,18140,35-39,78022,78495,156517,"Columbus, OH",39.968562,-82.835911,2151017
2051,18140,40-44,71613,72609,144222,"Columbus, OH",39.968562,-82.835911,2151017
2052,18140,45-49,65023,65965,130988,"Columbus, OH",39.968562,-82.835911,2151017
2053,18140,50-54,67142,68699,135841,"Columbus, OH",39.968562,-82.835911,2151017
2054,18140,55-59,65928,65183,131111,"Columbus, OH",39.968562,-82.835911,2151017
2055,18140,60-64,65052,61489,126541,"Columbus, OH",39.968562,-82.835911,2151017
2056,18140,65+,166410,133723,300133,"Columbus, OH",39.968562,-82.835911,2151017
2057,18180,15-19,4814,4829,9643,"Concord, NH",43.299579,-71.680041,155238
2058,18180,20-24,4578,4832,9410,"Concord, NH",43.299579,-71.680041,155238
2059,18180,25-29,4553,5018,9571,"Concord, NH",43.299579,-71.680041,155238
2060,18180,30-34,4849,5212,10061,"Concord, NH",43.299579,-71.680041,155238
2061,18180,35-39,4796,5286,10082,"Concord, NH",43.299579,-71.680041,155238
2062,18180,40-44,4737,4783,9520,"Concord, NH",43.299579,-71.680041,155238
2063,18180,45-49,4372,4681,9053,"Concord, NH",43.299579,-71.680041,155238
2064,18180,50-54,5364,5262,10626,"Concord, NH",43.299579,-71.680041,155238
2065,18180,55-59,6174,5741,11915,"Concord, NH",43.299579,-71.680041,155238
2066,18180,60-64,6138,5949,12087,"Concord, NH",43.299579,-71.680041,155238
2067,18180,65+,16356,13623,29979,"Concord, NH",43.299579,-71.680041,155238
2068,18220,15-19,739,754,1493,"Connersville, IN",39.639655,-85.185032,23360
2069,18220,20-24,617,655,1272,"Connersville, IN",39.639655,-85.185032,23360
2070,18220,25-29,676,679,1355,"Connersville, IN",39.639655,-85.185032,23360
2071,18220,30-34,664,642,1306,"Connersville, IN",39.639655,-85.185032,23360
2072,18220,35-39,615,591,1206,"Connersville, IN",39.639655,-85.185032,23360
2073,18220,40-44,744,710,1454,"Connersville, IN",39.639655,-85.185032,23360
2074,18220,45-49,745,777,1522,"Connersville, IN",39.639655,-85.185032,23360
2075,18220,50-54,720,800,1520,"Connersville, IN",39.639655,-85.185032,23360
2076,18220,55-59,820,844,1664,"Connersville, IN",39.639655,-85.185032,23360
2077,18220,60-64,826,737,1563,"Connersville, IN",39.639655,-85.185032,23360
2078,18220,65+,2619,2221,4840,"Connersville, IN",39.639655,-85.185032,23360
2079,18260,15-19,3694,4163,7857,"Cookeville, TN",36.277251,-85.468501,115777
2080,18260,20-24,4596,5441,10037,"Cookeville, TN",36.277251,-85.468501,115777
2081,18260,25-29,3772,4116,7888,"Cookeville, TN",36.277251,-85.468501,115777
2082,18260,30-34,3476,3617,7093,"Cookeville, TN",36.277251,-85.468501,115777
2083,18260,35-39,3271,3337,6608,"Cookeville, TN",36.277251,-85.468501,115777
2084,18260,40-44,3230,3370,6600,"Cookeville, TN",36.277251,-85.468501,115777
2085,18260,45-49,3374,3373,6747,"Cookeville, TN",36.277251,-85.468501,115777
2086,18260,50-54,3708,3566,7274,"Cookeville, TN",36.277251,-85.468501,115777
2087,18260,55-59,3850,3645,7495,"Cookeville, TN",36.277251,-85.468501,115777
2088,18260,60-64,3971,3638,7609,"Cookeville, TN",36.277251,-85.468501,115777
2089,18260,65+,11420,9529,20949,"Cookeville, TN",36.277251,-85.468501,115777
2090,18300,15-19,1564,1594,3158,"Coos Bay, OR",43.18591,-124.094133,64999
2091,18300,20-24,1424,1518,2942,"Coos Bay, OR",43.18591,-124.094133,64999
2092,18300,25-29,1641,1674,3315,"Coos Bay, OR",43.18591,-124.094133,64999
2093,18300,30-34,1798,1920,3718,"Coos Bay, OR",43.18591,-124.094133,64999
2094,18300,35-39,1820,1876,3696,"Coos Bay, OR",43.18591,-124.094133,64999
2095,18300,40-44,1835,1823,3658,"Coos Bay, OR",43.18591,-124.094133,64999
2096,18300,45-49,1691,1681,3372,"Coos Bay, OR",43.18591,-124.094133,64999
2097,18300,50-54,1871,1839,3710,"Coos Bay, OR",43.18591,-124.094133,64999
2098,18300,55-59,2310,2182,4492,"Coos Bay, OR",43.18591,-124.094133,64999
2099,18300,60-64,2876,2542,5418,"Coos Bay, OR",43.18591,-124.094133,64999
2100,18300,65+,9261,8542,17803,"Coos Bay, OR",43.18591,-124.094133,64999
2101,18380,15-19,659,669,1328,"Cordele, GA",31.920268,-83.75653,19879
2102,18380,20-24,534,548,1082,"Cordele, GA",31.920268,-83.75653,19879
2103,18380,25-29,607,532,1139,"Cordele, GA",31.920268,-83.75653,19879
2104,18380,30-34,632,522,1154,"Cordele, GA",31.920268,-83.75653,19879
2105,18380,35-39,588,611,1199,"Cordele, GA",31.920268,-83.75653,19879
2106,18380,40-44,632,513,1145,"Cordele, GA",31.920268,-83.75653,19879
2107,18380,45-49,631,490,1121,"Cordele, GA",31.920268,-83.75653,19879
2108,18380,50-54,643,585,1228,"Cordele, GA",31.920268,-83.75653,19879
2109,18380,55-59,680,654,1334,"Cordele, GA",31.920268,-83.75653,19879
2110,18380,60-64,706,626,1332,"Cordele, GA",31.920268,-83.75653,19879
2111,18380,65+,2197,1762,3959,"Cordele, GA",31.920268,-83.75653,19879
2112,18420,15-19,1060,1140,2200,"Corinth, MS",34.886569,-88.581109,34349
2113,18420,20-24,952,1075,2027,"Corinth, MS",34.886569,-88.581109,34349
2114,18420,25-29,1070,1026,2096,"Corinth, MS",34.886569,-88.581109,34349
2115,18420,30-34,1066,1087,2153,"Corinth, MS",34.886569,-88.581109,34349
2116,18420,35-39,1026,1047,2073,"Corinth, MS",34.886569,-88.581109,34349
2117,18420,40-44,1057,1075,2132,"Corinth, MS",34.886569,-88.581109,34349
2118,18420,45-49,1081,1054,2135,"Corinth, MS",34.886569,-88.581109,34349
2119,18420,50-54,1138,1118,2256,"Corinth, MS",34.886569,-88.581109,34349
2120,18420,55-59,1131,1197,2328,"Corinth, MS",34.886569,-88.581109,34349
2121,18420,60-64,1201,1028,2229,"Corinth, MS",34.886569,-88.581109,34349
2122,18420,65+,3686,2776,6462,"Corinth, MS",34.886569,-88.581109,34349
2123,18460,15-19,1587,1557,3144,"Cornelia, GA",34.634392,-83.525875,46774
2124,18460,20-24,1698,1535,3233,"Cornelia, GA",34.634392,-83.525875,46774
2125,18460,25-29,1565,1440,3005,"Cornelia, GA",34.634392,-83.525875,46774
2126,18460,30-34,1542,1356,2898,"Cornelia, GA",34.634392,-83.525875,46774
2127,18460,35-39,1500,1330,2830,"Cornelia, GA",34.634392,-83.525875,46774
2128,18460,40-44,1501,1272,2773,"Cornelia, GA",34.634392,-83.525875,46774
2129,18460,45-49,1478,1251,2729,"Cornelia, GA",34.634392,-83.525875,46774
2130,18460,50-54,1525,1439,2964,"Cornelia, GA",34.634392,-83.525875,46774
2131,18460,55-59,1573,1483,3056,"Cornelia, GA",34.634392,-83.525875,46774
2132,18460,60-64,1583,1468,3051,"Cornelia, GA",34.634392,-83.525875,46774
2133,18460,65+,4586,4005,8591,"Cornelia, GA",34.634392,-83.525875,46774
2134,18500,15-19,2609,2878,5487,"Corning, NY",42.266725,-77.385525,92948
2135,18500,20-24,2407,2511,4918,"Corning, NY",42.266725,-77.385525,92948
2136,18500,25-29,2589,2725,5314,"Corning, NY",42.266725,-77.385525,92948
2137,18500,30-34,2788,2774,5562,"Corning, NY",42.266725,-77.385525,92948
2138,18500,35-39,2695,2755,5450,"Corning, NY",42.266725,-77.385525,92948
2139,18500,40-44,2677,2808,5485,"Corning, NY",42.266725,-77.385525,92948
2140,18500,45-49,2581,2590,5171,"Corning, NY",42.266725,-77.385525,92948
2141,18500,50-54,3096,3143,6239,"Corning, NY",42.266725,-77.385525,92948
2142,18500,55-59,3422,3462,6884,"Corning, NY",42.266725,-77.385525,92948
2143,18500,60-64,3524,3610,7134,"Corning, NY",42.266725,-77.385525,92948
2144,18500,65+,9966,8884,18850,"Corning, NY",42.266725,-77.385525,92948
2145,18580,15-19,14599,15443,30042,"Corpus Christi, TX",27.833597,-97.508958,422778
2146,18580,20-24,14444,14811,29255,"Corpus Christi, TX",27.833597,-97.508958,422778
2147,18580,25-29,13878,14793,28671,"Corpus Christi, TX",27.833597,-97.508958,422778
2148,18580,30-34,14407,15030,29437,"Corpus Christi, TX",27.833597,-97.508958,422778
2149,18580,35-39,14416,14932,29348,"Corpus Christi, TX",27.833597,-97.508958,422778
2150,18580,40-44,13685,13931,27616,"Corpus Christi, TX",27.833597,-97.508958,422778
2151,18580,45-49,12387,12434,24821,"Corpus Christi, TX",27.833597,-97.508958,422778
2152,18580,50-54,12241,11957,24198,"Corpus Christi, TX",27.833597,-97.508958,422778
2153,18580,55-59,12705,12288,24993,"Corpus Christi, TX",27.833597,-97.508958,422778
2154,18580,60-64,12523,11995,24518,"Corpus Christi, TX",27.833597,-97.508958,422778
2155,18580,65+,35111,29295,64406,"Corpus Christi, TX",27.833597,-97.508958,422778
2156,18620,15-19,1831,1976,3807,"Corsicana, TX",32.048448,-96.476909,53591
2157,18620,20-24,1528,1750,3278,"Corsicana, TX",32.048448,-96.476909,53591
2158,18620,25-29,1657,1618,3275,"Corsicana, TX",32.048448,-96.476909,53591
2159,18620,30-34,1593,1548,3141,"Corsicana, TX",32.048448,-96.476909,53591
2160,18620,35-39,1564,1490,3054,"Corsicana, TX",32.048448,-96.476909,53591
2161,18620,40-44,1558,1494,3052,"Corsicana, TX",32.048448,-96.476909,53591
2162,18620,45-49,1567,1426,2993,"Corsicana, TX",32.048448,-96.476909,53591
2163,18620,50-54,1601,1638,3239,"Corsicana, TX",32.048448,-96.476909,53591
2164,18620,55-59,1685,1682,3367,"Corsicana, TX",32.048448,-96.476909,53591
2165,18620,60-64,1763,1672,3435,"Corsicana, TX",32.048448,-96.476909,53591
2166,18620,65+,4902,4169,9071,"Corsicana, TX",32.048448,-96.476909,53591
2167,18660,15-19,2311,2038,4349,"Cortland, NY",42.594039,-76.07624,46311
2168,18660,20-24,2864,2651,5515,"Cortland, NY",42.594039,-76.07624,46311
2169,18660,25-29,1375,1299,2674,"Cortland, NY",42.594039,-76.07624,46311
2170,18660,30-34,1209,1319,2528,"Cortland, NY",42.594039,-76.07624,46311
2171,18660,35-39,1250,1286,2536,"Cortland, NY",42.594039,-76.07624,46311
2172,18660,40-44,1231,1275,2506,"Cortland, NY",42.594039,-76.07624,46311
2173,18660,45-49,1117,1153,2270,"Cortland, NY",42.594039,-76.07624,46311
2174,18660,50-54,1330,1415,2745,"Cortland, NY",42.594039,-76.07624,46311
2175,18660,55-59,1573,1520,3093,"Cortland, NY",42.594039,-76.07624,46311
2176,18660,60-64,1483,1545,3028,"Cortland, NY",42.594039,-76.07624,46311
2177,18660,65+,4279,3644,7923,"Cortland, NY",42.594039,-76.07624,46311
2178,18700,15-19,4497,4502,8999,"Corvallis, OR",44.493882,-123.424664,96017
2179,18700,20-24,7091,8027,15118,"Corvallis, OR",44.493882,-123.424664,96017
2180,18700,25-29,3283,3759,7042,"Corvallis, OR",44.493882,-123.424664,96017
2181,18700,30-34,2731,2872,5603,"Corvallis, OR",44.493882,-123.424664,96017
2182,18700,35-39,2585,2628,5213,"Corvallis, OR",44.493882,-123.424664,96017
2183,18700,40-44,2485,2475,4960,"Corvallis, OR",44.493882,-123.424664,96017
2184,18700,45-49,2353,2284,4637,"Corvallis, OR",44.493882,-123.424664,96017
2185,18700,50-54,2401,2429,4830,"Corvallis, OR",44.493882,-123.424664,96017
2186,18700,55-59,2503,2322,4825,"Corvallis, OR",44.493882,-123.424664,96017
2187,18700,60-64,2978,2600,5578,"Corvallis, OR",44.493882,-123.424664,96017
2188,18700,65+,8897,7965,16862,"Corvallis, OR",44.493882,-123.424664,96017
2189,18740,15-19,1116,1236,2352,"Coshocton, OH",40.29671,-81.930109,36618
2190,18740,20-24,932,957,1889,"Coshocton, OH",40.29671,-81.930109,36618
2191,18740,25-29,1032,1024,2056,"Coshocton, OH",40.29671,-81.930109,36618
2192,18740,30-34,1109,1019,2128,"Coshocton, OH",40.29671,-81.930109,36618
2193,18740,35-39,1040,1077,2117,"Coshocton, OH",40.29671,-81.930109,36618
2194,18740,40-44,1038,1045,2083,"Coshocton, OH",40.29671,-81.930109,36618
2195,18740,45-49,1012,1043,2055,"Coshocton, OH",40.29671,-81.930109,36618
2196,18740,50-54,1135,1158,2293,"Coshocton, OH",40.29671,-81.930109,36618
2197,18740,55-59,1241,1264,2505,"Coshocton, OH",40.29671,-81.930109,36618
2198,18740,60-64,1322,1303,2625,"Coshocton, OH",40.29671,-81.930109,36618
2199,18740,65+,3945,3338,7283,"Coshocton, OH",40.29671,-81.930109,36618
2200,18780,15-19,398,470,868,"Craig, CO",40.610864,-108.217154,13185
2201,18780,20-24,361,388,749,"Craig, CO",40.610864,-108.217154,13185
2202,18780,25-29,376,386,762,"Craig, CO",40.610864,-108.217154,13185
2203,18780,30-34,431,422,853,"Craig, CO",40.610864,-108.217154,13185
2204,18780,35-39,411,507,918,"Craig, CO",40.610864,-108.217154,13185
2205,18780,40-44,367,452,819,"Craig, CO",40.610864,-108.217154,13185
2206,18780,45-49,372,356,728,"Craig, CO",40.610864,-108.217154,13185
2207,18780,50-54,379,408,787,"Craig, CO",40.610864,-108.217154,13185
2208,18780,55-59,412,475,887,"Craig, CO",40.610864,-108.217154,13185
2209,18780,60-64,436,472,908,"Craig, CO",40.610864,-108.217154,13185
2210,18780,65+,1107,1105,2212,"Craig, CO",40.610864,-108.217154,13185
2211,18820,15-19,1110,1471,2581,"Crawfordsville, IN",40.040296,-86.892715,38063
2212,18820,20-24,1029,1436,2465,"Crawfordsville, IN",40.040296,-86.892715,38063
2213,18820,25-29,1118,1136,2254,"Crawfordsville, IN",40.040296,-86.892715,38063
2214,18820,30-34,1095,1177,2272,"Crawfordsville, IN",40.040296,-86.892715,38063
2215,18820,35-39,1071,1157,2228,"Crawfordsville, IN",40.040296,-86.892715,38063
2216,18820,40-44,986,1085,2071,"Crawfordsville, IN",40.040296,-86.892715,38063
2217,18820,45-49,1114,1072,2186,"Crawfordsville, IN",40.040296,-86.892715,38063
2218,18820,50-54,1144,1252,2396,"Crawfordsville, IN",40.040296,-86.892715,38063
2219,18820,55-59,1365,1337,2702,"Crawfordsville, IN",40.040296,-86.892715,38063
2220,18820,60-64,1318,1386,2704,"Crawfordsville, IN",40.040296,-86.892715,38063
2221,18820,65+,3803,3204,7007,"Crawfordsville, IN",40.040296,-86.892715,38063
2222,18860,15-19,692,830,1522,"Crescent City, CA",41.749903,-123.980998,28100
2223,18860,20-24,606,929,1535,"Crescent City, CA",41.749903,-123.980998,28100
2224,18860,25-29,657,1195,1852,"Crescent City, CA",41.749903,-123.980998,28100
2225,18860,30-34,707,1320,2027,"Crescent City, CA",41.749903,-123.980998,28100
2226,18860,35-39,815,1362,2177,"Crescent City, CA",41.749903,-123.980998,28100
2227,18860,40-44,773,1168,1941,"Crescent City, CA",41.749903,-123.980998,28100
2228,18860,45-49,647,922,1569,"Crescent City, CA",41.749903,-123.980998,28100
2229,18860,50-54,674,846,1520,"Crescent City, CA",41.749903,-123.980998,28100
2230,18860,55-59,890,905,1795,"Crescent City, CA",41.749903,-123.980998,28100
2231,18860,60-64,1015,981,1996,"Crescent City, CA",41.749903,-123.980998,28100
2232,18860,65+,2811,2512,5323,"Crescent City, CA",41.749903,-123.980998,28100
2233,18880,15-19,7527,8567,16094,"Crestview-Fort Walton Beach-Destin, FL",30.594941,-86.358164,293324
2234,18880,20-24,7868,10218,18086,"Crestview-Fort Walton Beach-Destin, FL",30.594941,-86.358164,293324
2235,18880,25-29,9217,11226,20443,"Crestview-Fort Walton Beach-Destin, FL",30.594941,-86.358164,293324
2236,18880,30-34,10217,11363,21580,"Crestview-Fort Walton Beach-Destin, FL",30.594941,-86.358164,293324
2237,18880,35-39,9739,10485,20224,"Crestview-Fort Walton Beach-Destin, FL",30.594941,-86.358164,293324
2238,18880,40-44,8687,9417,18104,"Crestview-Fort Walton Beach-Destin, FL",30.594941,-86.358164,293324
2239,18880,45-49,7782,7936,15718,"Crestview-Fort Walton Beach-Destin, FL",30.594941,-86.358164,293324
2240,18880,50-54,8482,8342,16824,"Crestview-Fort Walton Beach-Destin, FL",30.594941,-86.358164,293324
2241,18880,55-59,10237,9964,20201,"Crestview-Fort Walton Beach-Destin, FL",30.594941,-86.358164,293324
2242,18880,60-64,10783,10409,21192,"Crestview-Fort Walton Beach-Destin, FL",30.594941,-86.358164,293324
2243,18880,65+,27018,23951,50969,"Crestview-Fort Walton Beach-Destin, FL",30.594941,-86.358164,293324
2244,18900,15-19,1355,1500,2855,"Crossville, TN",35.952398,-84.994761,62451
2245,18900,20-24,1250,1379,2629,"Crossville, TN",35.952398,-84.994761,62451
2246,18900,25-29,1419,1577,2996,"Crossville, TN",35.952398,-84.994761,62451
2247,18900,30-34,1512,1484,2996,"Crossville, TN",35.952398,-84.994761,62451
2248,18900,35-39,1432,1359,2791,"Crossville, TN",35.952398,-84.994761,62451
2249,18900,40-44,1452,1333,2785,"Crossville, TN",35.952398,-84.994761,62451
2250,18900,45-49,1574,1462,3036,"Crossville, TN",35.952398,-84.994761,62451
2251,18900,50-54,1789,1815,3604,"Crossville, TN",35.952398,-84.994761,62451
2252,18900,55-59,2350,2119,4469,"Crossville, TN",35.952398,-84.994761,62451
2253,18900,60-64,2991,2525,5516,"Crossville, TN",35.952398,-84.994761,62451
2254,18900,65+,10392,9628,20020,"Crossville, TN",35.952398,-84.994761,62451
2255,18980,15-19,2561,2745,5306,"Cullman, AL",34.131923,-86.869267,89496
2256,18980,20-24,2463,2545,5008,"Cullman, AL",34.131923,-86.869267,89496
2257,18980,25-29,2718,2826,5544,"Cullman, AL",34.131923,-86.869267,89496
2258,18980,30-34,2985,3011,5996,"Cullman, AL",34.131923,-86.869267,89496
2259,18980,35-39,2625,2720,5345,"Cullman, AL",34.131923,-86.869267,89496
2260,18980,40-44,2705,2720,5425,"Cullman, AL",34.131923,-86.869267,89496
2261,18980,45-49,2765,2787,5552,"Cullman, AL",34.131923,-86.869267,89496
2262,18980,50-54,2811,2926,5737,"Cullman, AL",34.131923,-86.869267,89496
2263,18980,55-59,3101,3137,6238,"Cullman, AL",34.131923,-86.869267,89496
2264,18980,60-64,3042,3012,6054,"Cullman, AL",34.131923,-86.869267,89496
2265,18980,65+,9169,7580,16749,"Cullman, AL",34.131923,-86.869267,89496
2266,19000,15-19,2564,2405,4969,"Cullowhee, NC",35.389045,-83.322832,57546
2267,19000,20-24,2979,2928,5907,"Cullowhee, NC",35.389045,-83.322832,57546
2268,19000,25-29,1605,1573,3178,"Cullowhee, NC",35.389045,-83.322832,57546
2269,19000,30-34,1648,1685,3333,"Cullowhee, NC",35.389045,-83.322832,57546
2270,19000,35-39,1500,1585,3085,"Cullowhee, NC",35.389045,-83.322832,57546
2271,19000,40-44,1600,1489,3089,"Cullowhee, NC",35.389045,-83.322832,57546
2272,19000,45-49,1510,1532,3042,"Cullowhee, NC",35.389045,-83.322832,57546
2273,19000,50-54,1688,1682,3370,"Cullowhee, NC",35.389045,-83.322832,57546
2274,19000,55-59,1857,1738,3595,"Cullowhee, NC",35.389045,-83.322832,57546
2275,19000,60-64,2000,1870,3870,"Cullowhee, NC",35.389045,-83.322832,57546
2276,19000,65+,6303,5264,11567,"Cullowhee, NC",35.389045,-83.322832,57546
2277,19060,15-19,3049,3299,6348,"Cumberland, MD-WV",39.532185,-78.807082,94586
2278,19060,20-24,3304,3874,7178,"Cumberland, MD-WV",39.532185,-78.807082,94586
2279,19060,25-29,2499,3312,5811,"Cumberland, MD-WV",39.532185,-78.807082,94586
2280,19060,30-34,2456,3491,5947,"Cumberland, MD-WV",39.532185,-78.807082,94586
2281,19060,35-39,2428,3187,5615,"Cumberland, MD-WV",39.532185,-78.807082,94586
2282,19060,40-44,2381,3057,5438,"Cumberland, MD-WV",39.532185,-78.807082,94586
2283,19060,45-49,2492,2880,5372,"Cumberland, MD-WV",39.532185,-78.807082,94586
2284,19060,50-54,2894,3249,6143,"Cumberland, MD-WV",39.532185,-78.807082,94586
2285,19060,55-59,3118,3143,6261,"Cumberland, MD-WV",39.532185,-78.807082,94586
2286,19060,60-64,3294,3235,6529,"Cumberland, MD-WV",39.532185,-78.807082,94586
2287,19060,65+,10781,9064,19845,"Cumberland, MD-WV",39.532185,-78.807082,94586
2288,19100,15-19,272767,281760,554527,"Dallas-Fort Worth-Arlington, TX",32.849171,-96.970489,7759615
2289,19100,20-24,252010,251229,503239,"Dallas-Fort Worth-Arlington, TX",32.849171,-96.970489,7759615
2290,19100,25-29,282403,280544,562947,"Dallas-Fort Worth-Arlington, TX",32.849171,-96.970489,7759615
2291,19100,30-34,292288,285782,578070,"Dallas-Fort Worth-Arlington, TX",32.849171,-96.970489,7759615
2292,19100,35-39,288032,284526,572558,"Dallas-Fort Worth-Arlington, TX",32.849171,-96.970489,7759615
2293,19100,40-44,274852,269053,543905,"Dallas-Fort Worth-Arlington, TX",32.849171,-96.970489,7759615
2294,19100,45-49,258837,251871,510708,"Dallas-Fort Worth-Arlington, TX",32.849171,-96.970489,7759615
2295,19100,50-54,249774,250970,500744,"Dallas-Fort Worth-Arlington, TX",32.849171,-96.970489,7759615
2296,19100,55-59,235774,235870,471644,"Dallas-Fort Worth-Arlington, TX",32.849171,-96.970489,7759615
2297,19100,60-64,213585,208353,421938,"Dallas-Fort Worth-Arlington, TX",32.849171,-96.970489,7759615
2298,19100,65+,509068,411432,920500,"Dallas-Fort Worth-Arlington, TX",32.849171,-96.970489,7759615
2299,19140,15-19,5149,5384,10533,"Dalton, GA",34.796956,-84.856279,142799
2300,19140,20-24,4659,4855,9514,"Dalton, GA",34.796956,-84.856279,142799
2301,19140,25-29,4510,4771,9281,"Dalton, GA",34.796956,-84.856279,142799
2302,19140,30-34,4548,4775,9323,"Dalton, GA",34.796956,-84.856279,142799
2303,19140,35-39,4501,4494,8995,"Dalton, GA",34.796956,-84.856279,142799
2304,19140,40-44,4467,4535,9002,"Dalton, GA",34.796956,-84.856279,142799
2305,19140,45-49,4542,4473,9015,"Dalton, GA",34.796956,-84.856279,142799
2306,19140,50-54,4770,4876,9646,"Dalton, GA",34.796956,-84.856279,142799
2307,19140,55-59,4645,4639,9284,"Dalton, GA",34.796956,-84.856279,142799
2308,19140,60-64,4106,4125,8231,"Dalton, GA",34.796956,-84.856279,142799
2309,19140,65+,11546,9546,21092,"Dalton, GA",34.796956,-84.856279,142799
2310,19180,15-19,2143,2404,4547,"Danville, IL",40.186754,-87.726778,73095
2311,19180,20-24,1941,2165,4106,"Danville, IL",40.186754,-87.726778,73095
2312,19180,25-29,2040,2310,4350,"Danville, IL",40.186754,-87.726778,73095
2313,19180,30-34,1999,2198,4197,"Danville, IL",40.186754,-87.726778,73095
2314,19180,35-39,2141,2254,4395,"Danville, IL",40.186754,-87.726778,73095
2315,19180,40-44,2065,2265,4330,"Danville, IL",40.186754,-87.726778,73095
2316,19180,45-49,1943,2153,4096,"Danville, IL",40.186754,-87.726778,73095
2317,19180,50-54,2137,2163,4300,"Danville, IL",40.186754,-87.726778,73095
2318,19180,55-59,2470,2379,4849,"Danville, IL",40.186754,-87.726778,73095
2319,19180,60-64,2584,2575,5159,"Danville, IL",40.186754,-87.726778,73095
2320,19180,65+,7972,6665,14637,"Danville, IL",40.186754,-87.726778,73095
2321,19220,15-19,1843,1858,3701,"Danville, KY",37.507848,-84.735684,54990
2322,19220,20-24,1873,1905,3778,"Danville, KY",37.507848,-84.735684,54990
2323,19220,25-29,1564,1782,3346,"Danville, KY",37.507848,-84.735684,54990
2324,19220,30-34,1533,1733,3266,"Danville, KY",37.507848,-84.735684,54990
2325,19220,35-39,1449,1610,3059,"Danville, KY",37.507848,-84.735684,54990
2326,19220,40-44,1649,1608,3257,"Danville, KY",37.507848,-84.735684,54990
2327,19220,45-49,1564,1650,3214,"Danville, KY",37.507848,-84.735684,54990
2328,19220,50-54,1852,1768,3620,"Danville, KY",37.507848,-84.735684,54990
2329,19220,55-59,1888,1847,3735,"Danville, KY",37.507848,-84.735684,54990
2330,19220,60-64,1800,1747,3547,"Danville, KY",37.507848,-84.735684,54990
2331,19220,65+,5841,4604,10445,"Danville, KY",37.507848,-84.735684,54990
2332,19260,15-19,2928,3155,6083,"Danville, VA",36.811853,-79.400122,102187
2333,19260,20-24,2806,3048,5854,"Danville, VA",36.811853,-79.400122,102187
2334,19260,25-29,2789,2719,5508,"Danville, VA",36.811853,-79.400122,102187
2335,19260,30-34,2885,2940,5825,"Danville, VA",36.811853,-79.400122,102187
2336,19260,35-39,2798,2751,5549,"Danville, VA",36.811853,-79.400122,102187
2337,19260,40-44,2836,2614,5450,"Danville, VA",36.811853,-79.400122,102187
2338,19260,45-49,2871,2868,5739,"Danville, VA",36.811853,-79.400122,102187
2339,19260,50-54,3361,3261,6622,"Danville, VA",36.811853,-79.400122,102187
2340,19260,55-59,4092,3636,7728,"Danville, VA",36.811853,-79.400122,102187
2341,19260,60-64,4225,3823,8048,"Danville, VA",36.811853,-79.400122,102187
2342,19260,65+,13157,10122,23279,"Danville, VA",36.811853,-79.400122,102187
2343,19300,15-19,7116,7202,14318,"Daphne-Fairhope-Foley, AL",30.659218,-87.746067,239294
2344,19300,20-24,5967,5867,11834,"Daphne-Fairhope-Foley, AL",30.659218,-87.746067,239294
2345,19300,25-29,6245,6252,12497,"Daphne-Fairhope-Foley, AL",30.659218,-87.746067,239294
2346,19300,30-34,7100,6624,13724,"Daphne-Fairhope-Foley, AL",30.659218,-87.746067,239294
2347,19300,35-39,7182,6930,14112,"Daphne-Fairhope-Foley, AL",30.659218,-87.746067,239294
2348,19300,40-44,7674,7182,14856,"Daphne-Fairhope-Foley, AL",30.659218,-87.746067,239294
2349,19300,45-49,7444,7059,14503,"Daphne-Fairhope-Foley, AL",30.659218,-87.746067,239294
2350,19300,50-54,8135,7674,15809,"Daphne-Fairhope-Foley, AL",30.659218,-87.746067,239294
2351,19300,55-59,8877,8054,16931,"Daphne-Fairhope-Foley, AL",30.659218,-87.746067,239294
2352,19300,60-64,9544,8428,17972,"Daphne-Fairhope-Foley, AL",30.659218,-87.746067,239294
2353,19300,65+,27462,23914,51376,"Daphne-Fairhope-Foley, AL",30.659218,-87.746067,239294
2354,19340,15-19,12052,12790,24842,"Davenport-Moline-Rock Island, IA-IL",41.39168,-90.460076,381568
2355,19340,20-24,10761,11153,21914,"Davenport-Moline-Rock Island, IA-IL",41.39168,-90.460076,381568
2356,19340,25-29,11189,11372,22561,"Davenport-Moline-Rock Island, IA-IL",41.39168,-90.460076,381568
2357,19340,30-34,11840,11617,23457,"Davenport-Moline-Rock Island, IA-IL",41.39168,-90.460076,381568
2358,19340,35-39,12086,12455,24541,"Davenport-Moline-Rock Island, IA-IL",41.39168,-90.460076,381568
2359,19340,40-44,11965,12533,24498,"Davenport-Moline-Rock Island, IA-IL",41.39168,-90.460076,381568
2360,19340,45-49,10795,11241,22036,"Davenport-Moline-Rock Island, IA-IL",41.39168,-90.460076,381568
2361,19340,50-54,11555,11706,23261,"Davenport-Moline-Rock Island, IA-IL",41.39168,-90.460076,381568
2362,19340,55-59,12297,12175,24472,"Davenport-Moline-Rock Island, IA-IL",41.39168,-90.460076,381568
2363,19340,60-64,13326,12733,26059,"Davenport-Moline-Rock Island, IA-IL",41.39168,-90.460076,381568
2364,19340,65+,39371,33003,72374,"Davenport-Moline-Rock Island, IA-IL",41.39168,-90.460076,381568
2365,19420,15-19,1107,1150,2257,"Dayton, TN",35.60059,-84.949548,33136
2366,19420,20-24,1008,1086,2094,"Dayton, TN",35.60059,-84.949548,33136
2367,19420,25-29,935,1016,1951,"Dayton, TN",35.60059,-84.949548,33136
2368,19420,30-34,962,944,1906,"Dayton, TN",35.60059,-84.949548,33136
2369,19420,35-39,915,931,1846,"Dayton, TN",35.60059,-84.949548,33136
2370,19420,40-44,951,951,1902,"Dayton, TN",35.60059,-84.949548,33136
2371,19420,45-49,998,970,1968,"Dayton, TN",35.60059,-84.949548,33136
2372,19420,50-54,1150,1099,2249,"Dayton, TN",35.60059,-84.949548,33136
2373,19420,55-59,1158,1161,2319,"Dayton, TN",35.60059,-84.949548,33136
2374,19420,60-64,1157,1172,2329,"Dayton, TN",35.60059,-84.949548,33136
2375,19420,65+,3434,2935,6369,"Dayton, TN",35.60059,-84.949548,33136
2376,19430,15-19,26016,26986,53002,"Dayton-Kettering, OH",39.829746,-84.140992,813516
2377,19430,20-24,27137,27465,54602,"Dayton-Kettering, OH",39.829746,-84.140992,813516
2378,19430,25-29,26933,27146,54079,"Dayton-Kettering, OH",39.829746,-84.140992,813516
2379,19430,30-34,27520,27128,54648,"Dayton-Kettering, OH",39.829746,-84.140992,813516
2380,19430,35-39,25679,25456,51135,"Dayton-Kettering, OH",39.829746,-84.140992,813516
2381,19430,40-44,24091,23396,47487,"Dayton-Kettering, OH",39.829746,-84.140992,813516
2382,19430,45-49,22437,21588,44025,"Dayton-Kettering, OH",39.829746,-84.140992,813516
2383,19430,50-54,25251,24276,49527,"Dayton-Kettering, OH",39.829746,-84.140992,813516
2384,19430,55-59,27138,26174,53312,"Dayton-Kettering, OH",39.829746,-84.140992,813516
2385,19430,60-64,28417,26381,54798,"Dayton-Kettering, OH",39.829746,-84.140992,813516
2386,19430,65+,83582,65725,149307,"Dayton-Kettering, OH",39.829746,-84.140992,813516
2387,19460,15-19,4683,5123,9806,"Decatur, AL",34.489361,-87.097147,156758
2388,19460,20-24,4216,4461,8677,"Decatur, AL",34.489361,-87.097147,156758
2389,19460,25-29,4673,4660,9333,"Decatur, AL",34.489361,-87.097147,156758
2390,19460,30-34,4749,4808,9557,"Decatur, AL",34.489361,-87.097147,156758
2391,19460,35-39,4748,4650,9398,"Decatur, AL",34.489361,-87.097147,156758
2392,19460,40-44,4762,4848,9610,"Decatur, AL",34.489361,-87.097147,156758
2393,19460,45-49,4667,4821,9488,"Decatur, AL",34.489361,-87.097147,156758
2394,19460,50-54,5365,5227,10592,"Decatur, AL",34.489361,-87.097147,156758
2395,19460,55-59,5763,5720,11483,"Decatur, AL",34.489361,-87.097147,156758
2396,19460,60-64,5476,5297,10773,"Decatur, AL",34.489361,-87.097147,156758
2397,19460,65+,15879,12741,28620,"Decatur, AL",34.489361,-87.097147,156758
2398,19500,15-19,3286,3317,6603,"Decatur, IL",39.860237,-88.961529,102432
2399,19500,20-24,3207,2960,6167,"Decatur, IL",39.860237,-88.961529,102432
2400,19500,25-29,3176,2857,6033,"Decatur, IL",39.860237,-88.961529,102432
2401,19500,30-34,3163,2920,6083,"Decatur, IL",39.860237,-88.961529,102432
2402,19500,35-39,3048,2774,5822,"Decatur, IL",39.860237,-88.961529,102432
2403,19500,40-44,3184,2884,6068,"Decatur, IL",39.860237,-88.961529,102432
2404,19500,45-49,3023,2791,5814,"Decatur, IL",39.860237,-88.961529,102432
2405,19500,50-54,2879,2847,5726,"Decatur, IL",39.860237,-88.961529,102432
2406,19500,55-59,3408,3186,6594,"Decatur, IL",39.860237,-88.961529,102432
2407,19500,60-64,3696,3479,7175,"Decatur, IL",39.860237,-88.961529,102432
2408,19500,65+,11863,9422,21285,"Decatur, IL",39.860237,-88.961529,102432
2409,19540,15-19,1308,1375,2683,"Decatur, IN",40.745733,-84.93613,35961
2410,19540,20-24,1074,1108,2182,"Decatur, IN",40.745733,-84.93613,35961
2411,19540,25-29,1002,1131,2133,"Decatur, IN",40.745733,-84.93613,35961
2412,19540,30-34,979,1055,2034,"Decatur, IN",40.745733,-84.93613,35961
2413,19540,35-39,943,964,1907,"Decatur, IN",40.745733,-84.93613,35961
2414,19540,40-44,939,953,1892,"Decatur, IN",40.745733,-84.93613,35961
2415,19540,45-49,877,958,1835,"Decatur, IN",40.745733,-84.93613,35961
2416,19540,50-54,951,1011,1962,"Decatur, IN",40.745733,-84.93613,35961
2417,19540,55-59,999,1019,2018,"Decatur, IN",40.745733,-84.93613,35961
2418,19540,60-64,1041,1013,2054,"Decatur, IN",40.745733,-84.93613,35961
2419,19540,65+,3218,2549,5767,"Decatur, IN",40.745733,-84.93613,35961
2420,19580,15-19,1292,1385,2677,"Defiance, OH",41.321679,-84.486433,38144
2421,19580,20-24,1110,1186,2296,"Defiance, OH",41.321679,-84.486433,38144
2422,19580,25-29,1029,1107,2136,"Defiance, OH",41.321679,-84.486433,38144
2423,19580,30-34,1119,1127,2246,"Defiance, OH",41.321679,-84.486433,38144
2424,19580,35-39,1165,1187,2352,"Defiance, OH",41.321679,-84.486433,38144
2425,19580,40-44,1182,1198,2380,"Defiance, OH",41.321679,-84.486433,38144
2426,19580,45-49,1068,1099,2167,"Defiance, OH",41.321679,-84.486433,38144
2427,19580,50-54,1151,1192,2343,"Defiance, OH",41.321679,-84.486433,38144
2428,19580,55-59,1191,1171,2362,"Defiance, OH",41.321679,-84.486433,38144
2429,19580,60-64,1378,1313,2691,"Defiance, OH",41.321679,-84.486433,38144
2430,19580,65+,3949,3480,7429,"Defiance, OH",41.321679,-84.486433,38144
2431,19620,15-19,1731,1827,3558,"Del Rio, TX",29.875285,-101.143324,47564
2432,19620,20-24,1638,2197,3835,"Del Rio, TX",29.875285,-101.143324,47564
2433,19620,25-29,1613,2049,3662,"Del Rio, TX",29.875285,-101.143324,47564
2434,19620,30-34,1504,1837,3341,"Del Rio, TX",29.875285,-101.143324,47564
2435,19620,35-39,1367,1656,3023,"Del Rio, TX",29.875285,-101.143324,47564
2436,19620,40-44,1307,1404,2711,"Del Rio, TX",29.875285,-101.143324,47564
2437,19620,45-49,1287,1311,2598,"Del Rio, TX",29.875285,-101.143324,47564
2438,19620,50-54,1242,1218,2460,"Del Rio, TX",29.875285,-101.143324,47564
2439,19620,55-59,1171,1257,2428,"Del Rio, TX",29.875285,-101.143324,47564
2440,19620,60-64,1083,952,2035,"Del Rio, TX",29.875285,-101.143324,47564
2441,19620,65+,3573,2958,6531,"Del Rio, TX",29.875285,-101.143324,47564
2442,19660,15-19,17252,19058,36310,"Deltona-Daytona Beach-Ormond Beach, FL",29.1789,-81.189023,685344
2443,19660,20-24,17586,18599,36185,"Deltona-Daytona Beach-Ormond Beach, FL",29.1789,-81.189023,685344
2444,19660,25-29,18063,18851,36914,"Deltona-Daytona Beach-Ormond Beach, FL",29.1789,-81.189023,685344
2445,19660,30-34,19679,19880,39559,"Deltona-Daytona Beach-Ormond Beach, FL",29.1789,-81.189023,685344
2446,19660,35-39,18497,18739,37236,"Deltona-Daytona Beach-Ormond Beach, FL",29.1789,-81.189023,685344
2447,19660,40-44,18315,18064,36379,"Deltona-Daytona Beach-Ormond Beach, FL",29.1789,-81.189023,685344
2448,19660,45-49,18883,18001,36884,"Deltona-Daytona Beach-Ormond Beach, FL",29.1789,-81.189023,685344
2449,19660,50-54,22120,20997,43117,"Deltona-Daytona Beach-Ormond Beach, FL",29.1789,-81.189023,685344
2450,19660,55-59,26439,23896,50335,"Deltona-Daytona Beach-Ormond Beach, FL",29.1789,-81.189023,685344
2451,19660,60-64,29677,26104,55781,"Deltona-Daytona Beach-Ormond Beach, FL",29.1789,-81.189023,685344
2452,19660,65+,95708,83239,178947,"Deltona-Daytona Beach-Ormond Beach, FL",29.1789,-81.189023,685344
2453,19700,15-19,851,935,1786,"Deming, NM",32.184523,-107.747191,25532
2454,19700,20-24,742,855,1597,"Deming, NM",32.184523,-107.747191,25532
2455,19700,25-29,769,891,1660,"Deming, NM",32.184523,-107.747191,25532
2456,19700,30-34,696,755,1451,"Deming, NM",32.184523,-107.747191,25532
2457,19700,35-39,667,816,1483,"Deming, NM",32.184523,-107.747191,25532
2458,19700,40-44,642,603,1245,"Deming, NM",32.184523,-107.747191,25532
2459,19700,45-49,604,604,1208,"Deming, NM",32.184523,-107.747191,25532
2460,19700,50-54,666,656,1322,"Deming, NM",32.184523,-107.747191,25532
2461,19700,55-59,707,722,1429,"Deming, NM",32.184523,-107.747191,25532
2462,19700,60-64,777,689,1466,"Deming, NM",32.184523,-107.747191,25532
2463,19700,65+,2650,2574,5224,"Deming, NM",32.184523,-107.747191,25532
2464,19740,15-19,87825,93500,181325,"Denver-Aurora-Lakewood, CO",39.434789,-104.901073,2972566
2465,19740,20-24,84800,86771,171571,"Denver-Aurora-Lakewood, CO",39.434789,-104.901073,2972566
2466,19740,25-29,117806,122992,240798,"Denver-Aurora-Lakewood, CO",39.434789,-104.901073,2972566
2467,19740,30-34,125451,135014,260465,"Denver-Aurora-Lakewood, CO",39.434789,-104.901073,2972566
2468,19740,35-39,117226,126834,244060,"Denver-Aurora-Lakewood, CO",39.434789,-104.901073,2972566
2469,19740,40-44,104471,110655,215126,"Denver-Aurora-Lakewood, CO",39.434789,-104.901073,2972566
2470,19740,45-49,92784,98709,191493,"Denver-Aurora-Lakewood, CO",39.434789,-104.901073,2972566
2471,19740,50-54,91506,96423,187929,"Denver-Aurora-Lakewood, CO",39.434789,-104.901073,2972566
2472,19740,55-59,87900,88736,176636,"Denver-Aurora-Lakewood, CO",39.434789,-104.901073,2972566
2473,19740,60-64,87150,83955,171105,"Denver-Aurora-Lakewood, CO",39.434789,-104.901073,2972566
2474,19740,65+,222583,186414,408997,"Denver-Aurora-Lakewood, CO",39.434789,-104.901073,2972566
2475,19760,15-19,1071,1256,2327,"DeRidder, LA",30.645018,-93.340253,36584
2476,19760,20-24,961,1195,2156,"DeRidder, LA",30.645018,-93.340253,36584
2477,19760,25-29,1099,1308,2407,"DeRidder, LA",30.645018,-93.340253,36584
2478,19760,30-34,1109,1432,2541,"DeRidder, LA",30.645018,-93.340253,36584
2479,19760,35-39,1124,1249,2373,"DeRidder, LA",30.645018,-93.340253,36584
2480,19760,40-44,1108,1147,2255,"DeRidder, LA",30.645018,-93.340253,36584
2481,19760,45-49,1080,1150,2230,"DeRidder, LA",30.645018,-93.340253,36584
2482,19760,50-54,1123,1130,2253,"DeRidder, LA",30.645018,-93.340253,36584
2483,19760,55-59,1151,1097,2248,"DeRidder, LA",30.645018,-93.340253,36584
2484,19760,60-64,1172,1139,2311,"DeRidder, LA",30.645018,-93.340253,36584
2485,19760,65+,3161,2664,5825,"DeRidder, LA",30.645018,-93.340253,36584
2486,19780,15-19,23184,23886,47070,"Des Moines-West Des Moines, IA",41.57705,-93.759712,719146
2487,19780,20-24,21968,21671,43639,"Des Moines-West Des Moines, IA",41.57705,-93.759712,719146
2488,19780,25-29,25390,26259,51649,"Des Moines-West Des Moines, IA",41.57705,-93.759712,719146
2489,19780,30-34,25411,26380,51791,"Des Moines-West Des Moines, IA",41.57705,-93.759712,719146
2490,19780,35-39,26160,27590,53750,"Des Moines-West Des Moines, IA",41.57705,-93.759712,719146
2491,19780,40-44,24398,25719,50117,"Des Moines-West Des Moines, IA",41.57705,-93.759712,719146
2492,19780,45-49,21006,22040,43046,"Des Moines-West Des Moines, IA",41.57705,-93.759712,719146
2493,19780,50-54,21886,22671,44557,"Des Moines-West Des Moines, IA",41.57705,-93.759712,719146
2494,19780,55-59,21529,21513,43042,"Des Moines-West Des Moines, IA",41.57705,-93.759712,719146
2495,19780,60-64,21171,20246,41417,"Des Moines-West Des Moines, IA",41.57705,-93.759712,719146
2496,19780,65+,56468,45627,102095,"Des Moines-West Des Moines, IA",41.57705,-93.759712,719146
2497,19820,15-19,129464,137016,266480,"Detroit-Warren-Dearborn, MI",42.721848,-83.200846,4365205
2498,19820,20-24,126565,128795,255360,"Detroit-Warren-Dearborn, MI",42.721848,-83.200846,4365205
2499,19820,25-29,147703,150586,298289,"Detroit-Warren-Dearborn, MI",42.721848,-83.200846,4365205
2500,19820,30-34,149918,149924,299842,"Detroit-Warren-Dearborn, MI",42.721848,-83.200846,4365205
2501,19820,35-39,135222,133757,268979,"Detroit-Warren-Dearborn, MI",42.721848,-83.200846,4365205
2502,19820,40-44,134182,128844,263026,"Detroit-Warren-Dearborn, MI",42.721848,-83.200846,4365205
2503,19820,45-49,135866,128728,264594,"Detroit-Warren-Dearborn, MI",42.721848,-83.200846,4365205
2504,19820,50-54,151310,147450,298760,"Detroit-Warren-Dearborn, MI",42.721848,-83.200846,4365205
2505,19820,55-59,156320,152275,308595,"Detroit-Warren-Dearborn, MI",42.721848,-83.200846,4365205
2506,19820,60-64,155914,147404,303318,"Detroit-Warren-Dearborn, MI",42.721848,-83.200846,4365205
2507,19820,65+,421468,335399,756867,"Detroit-Warren-Dearborn, MI",42.721848,-83.200846,4365205
2508,19860,15-19,977,1062,2039,"Dickinson, ND",46.912583,-102.988487,34001
2509,19860,20-24,946,944,1890,"Dickinson, ND",46.912583,-102.988487,34001
2510,19860,25-29,1143,1215,2358,"Dickinson, ND",46.912583,-102.988487,34001
2511,19860,30-34,1360,1573,2933,"Dickinson, ND",46.912583,-102.988487,34001
2512,19860,35-39,1170,1456,2626,"Dickinson, ND",46.912583,-102.988487,34001
2513,19860,40-44,943,1126,2069,"Dickinson, ND",46.912583,-102.988487,34001
2514,19860,45-49,721,879,1600,"Dickinson, ND",46.912583,-102.988487,34001
2515,19860,50-54,750,941,1691,"Dickinson, ND",46.912583,-102.988487,34001
2516,19860,55-59,963,985,1948,"Dickinson, ND",46.912583,-102.988487,34001
2517,19860,60-64,974,1033,2007,"Dickinson, ND",46.912583,-102.988487,34001
2518,19860,65+,2527,2271,4798,"Dickinson, ND",46.912583,-102.988487,34001
2519,19940,15-19,915,968,1883,"Dixon, IL",41.747447,-89.299362,34049
2520,19940,20-24,785,980,1765,"Dixon, IL",41.747447,-89.299362,34049
2521,19940,25-29,911,1244,2155,"Dixon, IL",41.747447,-89.299362,34049
2522,19940,30-34,876,1298,2174,"Dixon, IL",41.747447,-89.299362,34049
2523,19940,35-39,819,1272,2091,"Dixon, IL",41.747447,-89.299362,34049
2524,19940,40-44,899,1326,2225,"Dixon, IL",41.747447,-89.299362,34049
2525,19940,45-49,869,1158,2027,"Dixon, IL",41.747447,-89.299362,34049
2526,19940,50-54,1019,1240,2259,"Dixon, IL",41.747447,-89.299362,34049
2527,19940,55-59,1112,1308,2420,"Dixon, IL",41.747447,-89.299362,34049
2528,19940,60-64,1191,1417,2608,"Dixon, IL",41.747447,-89.299362,34049
2529,19940,65+,3663,3302,6965,"Dixon, IL",41.747447,-89.299362,34049
2530,19980,15-19,1245,1459,2704,"Dodge City, KS",37.688416,-99.884748,34159
2531,19980,20-24,1080,1348,2428,"Dodge City, KS",37.688416,-99.884748,34159
2532,19980,25-29,1148,1295,2443,"Dodge City, KS",37.688416,-99.884748,34159
2533,19980,30-34,997,1217,2214,"Dodge City, KS",37.688416,-99.884748,34159
2534,19980,35-39,950,1156,2106,"Dodge City, KS",37.688416,-99.884748,34159
2535,19980,40-44,903,1122,2025,"Dodge City, KS",37.688416,-99.884748,34159
2536,19980,45-49,991,956,1947,"Dodge City, KS",37.688416,-99.884748,34159
2537,19980,50-54,930,1024,1954,"Dodge City, KS",37.688416,-99.884748,34159
2538,19980,55-59,922,975,1897,"Dodge City, KS",37.688416,-99.884748,34159
2539,19980,60-64,890,941,1831,"Dodge City, KS",37.688416,-99.884748,34159
2540,19980,65+,2091,1913,4004,"Dodge City, KS",37.688416,-99.884748,34159
2541,20020,15-19,4364,4856,9220,"Dothan, AL",31.245528,-85.46919,151618
2542,20020,20-24,4143,4066,8209,"Dothan, AL",31.245528,-85.46919,151618
2543,20020,25-29,4597,4429,9026,"Dothan, AL",31.245528,-85.46919,151618
2544,20020,30-34,5029,4406,9435,"Dothan, AL",31.245528,-85.46919,151618
2545,20020,35-39,4917,4461,9378,"Dothan, AL",31.245528,-85.46919,151618
2546,20020,40-44,4780,4488,9268,"Dothan, AL",31.245528,-85.46919,151618
2547,20020,45-49,4824,4383,9207,"Dothan, AL",31.245528,-85.46919,151618
2548,20020,50-54,4968,4803,9771,"Dothan, AL",31.245528,-85.46919,151618
2549,20020,55-59,5303,4957,10260,"Dothan, AL",31.245528,-85.46919,151618
2550,20020,60-64,5436,4878,10314,"Dothan, AL",31.245528,-85.46919,151618
2551,20020,65+,16547,13064,29611,"Dothan, AL",31.245528,-85.46919,151618
2552,20060,15-19,1685,1802,3487,"Douglas, GA",31.459541,-82.867327,51777
2553,20060,20-24,1588,2013,3601,"Douglas, GA",31.459541,-82.867327,51777
2554,20060,25-29,1694,2019,3713,"Douglas, GA",31.459541,-82.867327,51777
2555,20060,30-34,1650,2051,3701,"Douglas, GA",31.459541,-82.867327,51777
2556,20060,35-39,1510,1864,3374,"Douglas, GA",31.459541,-82.867327,51777
2557,20060,40-44,1550,1760,3310,"Douglas, GA",31.459541,-82.867327,51777
2558,20060,45-49,1507,1707,3214,"Douglas, GA",31.459541,-82.867327,51777
2559,20060,50-54,1601,1714,3315,"Douglas, GA",31.459541,-82.867327,51777
2560,20060,55-59,1597,1665,3262,"Douglas, GA",31.459541,-82.867327,51777
2561,20060,60-64,1497,1442,2939,"Douglas, GA",31.459541,-82.867327,51777
2562,20060,65+,4049,3237,7286,"Douglas, GA",31.459541,-82.867327,51777
2563,20100,15-19,6382,6242,12624,"Dover, DE",39.097088,-75.502982,184149
2564,20100,20-24,6191,6254,12445,"Dover, DE",39.097088,-75.502982,184149
2565,20100,25-29,5898,6006,11904,"Dover, DE",39.097088,-75.502982,184149
2566,20100,30-34,6308,6127,12435,"Dover, DE",39.097088,-75.502982,184149
2567,20100,35-39,6077,5651,11728,"Dover, DE",39.097088,-75.502982,184149
2568,20100,40-44,5678,5120,10798,"Dover, DE",39.097088,-75.502982,184149
2569,20100,45-49,5219,4555,9774,"Dover, DE",39.097088,-75.502982,184149
2570,20100,50-54,5557,5136,10693,"Dover, DE",39.097088,-75.502982,184149
2571,20100,55-59,6377,5688,12065,"Dover, DE",39.097088,-75.502982,184149
2572,20100,60-64,6305,5549,11854,"Dover, DE",39.097088,-75.502982,184149
2573,20100,65+,18266,14767,33033,"Dover, DE",39.097088,-75.502982,184149
2574,20140,15-19,2067,2115,4182,"Dublin, GA",32.50894,-82.810013,65013
2575,20140,20-24,1793,2024,3817,"Dublin, GA",32.50894,-82.810013,65013
2576,20140,25-29,1858,2139,3997,"Dublin, GA",32.50894,-82.810013,65013
2577,20140,30-34,2038,2070,4108,"Dublin, GA",32.50894,-82.810013,65013
2578,20140,35-39,2031,1845,3876,"Dublin, GA",32.50894,-82.810013,65013
2579,20140,40-44,2023,2044,4067,"Dublin, GA",32.50894,-82.810013,65013
2580,20140,45-49,1885,1980,3865,"Dublin, GA",32.50894,-82.810013,65013
2581,20140,50-54,2010,2151,4161,"Dublin, GA",32.50894,-82.810013,65013
2582,20140,55-59,2073,2099,4172,"Dublin, GA",32.50894,-82.810013,65013
2583,20140,60-64,2161,2035,4196,"Dublin, GA",32.50894,-82.810013,65013
2584,20140,65+,6793,5169,11962,"Dublin, GA",32.50894,-82.810013,65013
2585,20180,15-19,2030,2138,4168,"DuBois, PA",41.006862,-78.477724,80082
2586,20180,20-24,1787,2737,4524,"DuBois, PA",41.006862,-78.477724,80082
2587,20180,25-29,2019,2920,4939,"DuBois, PA",41.006862,-78.477724,80082
2588,20180,30-34,2031,2857,4888,"DuBois, PA",41.006862,-78.477724,80082
2589,20180,35-39,1972,2845,4817,"DuBois, PA",41.006862,-78.477724,80082
2590,20180,40-44,2178,2719,4897,"DuBois, PA",41.006862,-78.477724,80082
2591,20180,45-49,2227,2890,5117,"DuBois, PA",41.006862,-78.477724,80082
2592,20180,50-54,2669,3163,5832,"DuBois, PA",41.006862,-78.477724,80082
2593,20180,55-59,2881,3221,6102,"DuBois, PA",41.006862,-78.477724,80082
2594,20180,60-64,2906,3139,6045,"DuBois, PA",41.006862,-78.477724,80082
2595,20180,65+,9143,7851,16994,"DuBois, PA",41.006862,-78.477724,80082
2596,20220,15-19,3329,3473,6802,"Dubuque, IA",42.463481,-90.878771,98718
2597,20220,20-24,3291,3470,6761,"Dubuque, IA",42.463481,-90.878771,98718
2598,20220,25-29,3132,3351,6483,"Dubuque, IA",42.463481,-90.878771,98718
2599,20220,30-34,3001,3116,6117,"Dubuque, IA",42.463481,-90.878771,98718
2600,20220,35-39,3002,3142,6144,"Dubuque, IA",42.463481,-90.878771,98718
2601,20220,40-44,2741,2782,5523,"Dubuque, IA",42.463481,-90.878771,98718
2602,20220,45-49,2433,2492,4925,"Dubuque, IA",42.463481,-90.878771,98718
2603,20220,50-54,2819,2935,5754,"Dubuque, IA",42.463481,-90.878771,98718
2604,20220,55-59,3239,3252,6491,"Dubuque, IA",42.463481,-90.878771,98718
2605,20220,60-64,3341,3353,6694,"Dubuque, IA",42.463481,-90.878771,98718
2606,20220,65+,10242,8201,18443,"Dubuque, IA",42.463481,-90.878771,98718
2607,20260,15-19,9521,10017,19538,"Duluth, MN-WI",47.347503,-92.155335,290780
2608,20260,20-24,11018,11525,22543,"Duluth, MN-WI",47.347503,-92.155335,290780
2609,20260,25-29,8119,8722,16841,"Duluth, MN-WI",47.347503,-92.155335,290780
2610,20260,30-34,7934,8849,16783,"Duluth, MN-WI",47.347503,-92.155335,290780
2611,20260,35-39,8574,9370,17944,"Duluth, MN-WI",47.347503,-92.155335,290780
2612,20260,40-44,8338,9217,17555,"Duluth, MN-WI",47.347503,-92.155335,290780
2613,20260,45-49,7374,8082,15456,"Duluth, MN-WI",47.347503,-92.155335,290780
2614,20260,50-54,8123,8774,16897,"Duluth, MN-WI",47.347503,-92.155335,290780
2615,20260,55-59,9810,9796,19606,"Duluth, MN-WI",47.347503,-92.155335,290780
2616,20260,60-64,11110,11060,22170,"Duluth, MN-WI",47.347503,-92.155335,290780
2617,20260,65+,31102,28320,59422,"Duluth, MN-WI",47.347503,-92.155335,290780
2618,20300,15-19,814,864,1678,"Dumas, TX",35.835676,-101.890502,21118
2619,20300,20-24,631,737,1368,"Dumas, TX",35.835676,-101.890502,21118
2620,20300,25-29,677,757,1434,"Dumas, TX",35.835676,-101.890502,21118
2621,20300,30-34,632,774,1406,"Dumas, TX",35.835676,-101.890502,21118
2622,20300,35-39,605,752,1357,"Dumas, TX",35.835676,-101.890502,21118
2623,20300,40-44,619,739,1358,"Dumas, TX",35.835676,-101.890502,21118
2624,20300,45-49,544,601,1145,"Dumas, TX",35.835676,-101.890502,21118
2625,20300,50-54,537,640,1177,"Dumas, TX",35.835676,-101.890502,21118
2626,20300,55-59,521,609,1130,"Dumas, TX",35.835676,-101.890502,21118
2627,20300,60-64,477,535,1012,"Dumas, TX",35.835676,-101.890502,21118
2628,20300,65+,1329,1199,2528,"Dumas, TX",35.835676,-101.890502,21118
2629,20340,15-19,1369,1428,2797,"Duncan, OK",34.481361,-97.855607,43129
2630,20340,20-24,1108,1146,2254,"Duncan, OK",34.481361,-97.855607,43129
2631,20340,25-29,1204,1185,2389,"Duncan, OK",34.481361,-97.855607,43129
2632,20340,30-34,1312,1251,2563,"Duncan, OK",34.481361,-97.855607,43129
2633,20340,35-39,1310,1309,2619,"Duncan, OK",34.481361,-97.855607,43129
2634,20340,40-44,1337,1297,2634,"Duncan, OK",34.481361,-97.855607,43129
2635,20340,45-49,1218,1222,2440,"Duncan, OK",34.481361,-97.855607,43129
2636,20340,50-54,1215,1215,2430,"Duncan, OK",34.481361,-97.855607,43129
2637,20340,55-59,1517,1400,2917,"Duncan, OK",34.481361,-97.855607,43129
2638,20340,60-64,1624,1529,3153,"Duncan, OK",34.481361,-97.855607,43129
2639,20340,65+,4873,3951,8824,"Duncan, OK",34.481361,-97.855607,43129
2640,20420,15-19,1748,1906,3654,"Durango, CO",37.287367,-107.839718,56250
2641,20420,20-24,1549,1611,3160,"Durango, CO",37.287367,-107.839718,56250
2642,20420,25-29,1637,1808,3445,"Durango, CO",37.287367,-107.839718,56250
2643,20420,30-34,1844,1905,3749,"Durango, CO",37.287367,-107.839718,56250
2644,20420,35-39,1946,2083,4029,"Durango, CO",37.287367,-107.839718,56250
2645,20420,40-44,1845,1907,3752,"Durango, CO",37.287367,-107.839718,56250
2646,20420,45-49,1674,1800,3474,"Durango, CO",37.287367,-107.839718,56250
2647,20420,50-54,1702,1749,3451,"Durango, CO",37.287367,-107.839718,56250
2648,20420,55-59,1948,1757,3705,"Durango, CO",37.287367,-107.839718,56250
2649,20420,60-64,2277,2161,4438,"Durango, CO",37.287367,-107.839718,56250
2650,20420,65+,5628,5551,11179,"Durango, CO",37.287367,-107.839718,56250
2651,20460,15-19,1534,1529,3063,"Durant, OK",33.964004,-96.265135,47105
2652,20460,20-24,1608,1599,3207,"Durant, OK",33.964004,-96.265135,47105
2653,20460,25-29,1610,1597,3207,"Durant, OK",33.964004,-96.265135,47105
2654,20460,30-34,1711,1771,3482,"Durant, OK",33.964004,-96.265135,47105
2655,20460,35-39,1510,1500,3010,"Durant, OK",33.964004,-96.265135,47105
2656,20460,40-44,1419,1359,2778,"Durant, OK",33.964004,-96.265135,47105
2657,20460,45-49,1297,1307,2604,"Durant, OK",33.964004,-96.265135,47105
2658,20460,50-54,1417,1352,2769,"Durant, OK",33.964004,-96.265135,47105
2659,20460,55-59,1412,1345,2757,"Durant, OK",33.964004,-96.265135,47105
2660,20460,60-64,1447,1278,2725,"Durant, OK",33.964004,-96.265135,47105
2661,20460,65+,4557,3673,8230,"Durant, OK",33.964004,-96.265135,47105
2662,20500,15-19,23622,22842,46464,"Durham-Chapel Hill, NC",36.060589,-78.989787,654012
2663,20500,20-24,25679,23539,49218,"Durham-Chapel Hill, NC",36.060589,-78.989787,654012
2664,20500,25-29,24295,22658,46953,"Durham-Chapel Hill, NC",36.060589,-78.989787,654012
2665,20500,30-34,24598,23787,48385,"Durham-Chapel Hill, NC",36.060589,-78.989787,654012
2666,20500,35-39,21792,21073,42865,"Durham-Chapel Hill, NC",36.060589,-78.989787,654012
2667,20500,40-44,21026,20239,41265,"Durham-Chapel Hill, NC",36.060589,-78.989787,654012
2668,20500,45-49,20288,19407,39695,"Durham-Chapel Hill, NC",36.060589,-78.989787,654012
2669,20500,50-54,21218,20550,41768,"Durham-Chapel Hill, NC",36.060589,-78.989787,654012
2670,20500,55-59,21582,20010,41592,"Durham-Chapel Hill, NC",36.060589,-78.989787,654012
2671,20500,60-64,21845,19123,40968,"Durham-Chapel Hill, NC",36.060589,-78.989787,654012
2672,20500,65+,61046,48005,109051,"Durham-Chapel Hill, NC",36.060589,-78.989787,654012
2673,20540,15-19,1116,1258,2374,"Dyersburg, TN",36.054196,-89.398306,36615
2674,20540,20-24,1057,1050,2107,"Dyersburg, TN",36.054196,-89.398306,36615
2675,20540,25-29,1216,1099,2315,"Dyersburg, TN",36.054196,-89.398306,36615
2676,20540,30-34,1210,1131,2341,"Dyersburg, TN",36.054196,-89.398306,36615
2677,20540,35-39,1116,1012,2128,"Dyersburg, TN",36.054196,-89.398306,36615
2678,20540,40-44,1147,1034,2181,"Dyersburg, TN",36.054196,-89.398306,36615
2679,20540,45-49,1131,1091,2222,"Dyersburg, TN",36.054196,-89.398306,36615
2680,20540,50-54,1233,1169,2402,"Dyersburg, TN",36.054196,-89.398306,36615
2681,20540,55-59,1304,1266,2570,"Dyersburg, TN",36.054196,-89.398306,36615
2682,20540,60-64,1146,1157,2303,"Dyersburg, TN",36.054196,-89.398306,36615
2683,20540,65+,3661,2852,6513,"Dyersburg, TN",36.054196,-89.398306,36615
2684,20580,15-19,2411,2464,4875,"Eagle Pass, TX",28.729787,-100.316678,58056
2685,20580,20-24,2166,2581,4747,"Eagle Pass, TX",28.729787,-100.316678,58056
2686,20580,25-29,1990,2402,4392,"Eagle Pass, TX",28.729787,-100.316678,58056
2687,20580,30-34,1781,1976,3757,"Eagle Pass, TX",28.729787,-100.316678,58056
2688,20580,35-39,1704,1788,3492,"Eagle Pass, TX",28.729787,-100.316678,58056
2689,20580,40-44,1620,1584,3204,"Eagle Pass, TX",28.729787,-100.316678,58056
2690,20580,45-49,1741,1612,3353,"Eagle Pass, TX",28.729787,-100.316678,58056
2691,20580,50-54,1643,1522,3165,"Eagle Pass, TX",28.729787,-100.316678,58056
2692,20580,55-59,1438,1339,2777,"Eagle Pass, TX",28.729787,-100.316678,58056
2693,20580,60-64,1299,1170,2469,"Eagle Pass, TX",28.729787,-100.316678,58056
2694,20580,65+,3767,3099,6866,"Eagle Pass, TX",28.729787,-100.316678,58056
2695,20660,15-19,928,959,1887,"Easton, MD",38.748349,-76.178476,37626
2696,20660,20-24,831,860,1691,"Easton, MD",38.748349,-76.178476,37626
2697,20660,25-29,853,845,1698,"Easton, MD",38.748349,-76.178476,37626
2698,20660,30-34,1011,926,1937,"Easton, MD",38.748349,-76.178476,37626
2699,20660,35-39,937,915,1852,"Easton, MD",38.748349,-76.178476,37626
2700,20660,40-44,899,864,1763,"Easton, MD",38.748349,-76.178476,37626
2701,20660,45-49,1005,857,1862,"Easton, MD",38.748349,-76.178476,37626
2702,20660,50-54,1204,1078,2282,"Easton, MD",38.748349,-76.178476,37626
2703,20660,55-59,1528,1288,2816,"Easton, MD",38.748349,-76.178476,37626
2704,20660,60-64,1591,1422,3013,"Easton, MD",38.748349,-76.178476,37626
2705,20660,65+,6194,5054,11248,"Easton, MD",38.748349,-76.178476,37626
2706,20700,15-19,5898,5912,11810,"East Stroudsburg, PA",41.05624,-75.329065,169273
2707,20700,20-24,5614,5800,11414,"East Stroudsburg, PA",41.05624,-75.329065,169273
2708,20700,25-29,4600,5219,9819,"East Stroudsburg, PA",41.05624,-75.329065,169273
2709,20700,30-34,4629,5130,9759,"East Stroudsburg, PA",41.05624,-75.329065,169273
2710,20700,35-39,4684,4815,9499,"East Stroudsburg, PA",41.05624,-75.329065,169273
2711,20700,40-44,5015,4633,9648,"East Stroudsburg, PA",41.05624,-75.329065,169273
2712,20700,45-49,5174,4814,9988,"East Stroudsburg, PA",41.05624,-75.329065,169273
2713,20700,50-54,6156,6076,12232,"East Stroudsburg, PA",41.05624,-75.329065,169273
2714,20700,55-59,6956,7081,14037,"East Stroudsburg, PA",41.05624,-75.329065,169273
2715,20700,60-64,6700,6770,13470,"East Stroudsburg, PA",41.05624,-75.329065,169273
2716,20700,65+,16251,14983,31234,"East Stroudsburg, PA",41.05624,-75.329065,169273
2717,20740,15-19,6139,6043,12182,"Eau Claire, WI",44.938672,-91.284322,173317
2718,20740,20-24,8051,7793,15844,"Eau Claire, WI",44.938672,-91.284322,173317
2719,20740,25-29,5316,6024,11340,"Eau Claire, WI",44.938672,-91.284322,173317
2720,20740,30-34,5186,5892,11078,"Eau Claire, WI",44.938672,-91.284322,173317
2721,20740,35-39,5435,6186,11621,"Eau Claire, WI",44.938672,-91.284322,173317
2722,20740,40-44,4901,5664,10565,"Eau Claire, WI",44.938672,-91.284322,173317
2723,20740,45-49,4302,4738,9040,"Eau Claire, WI",44.938672,-91.284322,173317
2724,20740,50-54,4838,5174,10012,"Eau Claire, WI",44.938672,-91.284322,173317
2725,20740,55-59,5254,5647,10901,"Eau Claire, WI",44.938672,-91.284322,173317
2726,20740,60-64,5641,5626,11267,"Eau Claire, WI",44.938672,-91.284322,173317
2727,20740,65+,15987,14001,29988,"Eau Claire, WI",44.938672,-91.284322,173317
2728,20780,15-19,1654,1833,3487,"Edwards, CO",39.626992,-106.695169,55727
2729,20780,20-24,1327,1423,2750,"Edwards, CO",39.626992,-106.695169,55727
2730,20780,25-29,1772,2077,3849,"Edwards, CO",39.626992,-106.695169,55727
2731,20780,30-34,1918,2418,4336,"Edwards, CO",39.626992,-106.695169,55727
2732,20780,35-39,2009,2322,4331,"Edwards, CO",39.626992,-106.695169,55727
2733,20780,40-44,2084,2281,4365,"Edwards, CO",39.626992,-106.695169,55727
2734,20780,45-49,1910,2227,4137,"Edwards, CO",39.626992,-106.695169,55727
2735,20780,50-54,1944,2271,4215,"Edwards, CO",39.626992,-106.695169,55727
2736,20780,55-59,1771,1941,3712,"Edwards, CO",39.626992,-106.695169,55727
2737,20780,60-64,1682,1867,3549,"Edwards, CO",39.626992,-106.695169,55727
2738,20780,65+,3638,4053,7691,"Edwards, CO",39.626992,-106.695169,55727
2739,20820,15-19,997,1106,2103,"Effingham, IL",39.047945,-88.592849,34430
2740,20820,20-24,897,975,1872,"Effingham, IL",39.047945,-88.592849,34430
2741,20820,25-29,1002,1121,2123,"Effingham, IL",39.047945,-88.592849,34430
2742,20820,30-34,1061,1117,2178,"Effingham, IL",39.047945,-88.592849,34430
2743,20820,35-39,1019,1174,2193,"Effingham, IL",39.047945,-88.592849,34430
2744,20820,40-44,988,1032,2020,"Effingham, IL",39.047945,-88.592849,34430
2745,20820,45-49,883,922,1805,"Effingham, IL",39.047945,-88.592849,34430
2746,20820,50-54,974,1012,1986,"Effingham, IL",39.047945,-88.592849,34430
2747,20820,55-59,1213,1210,2423,"Effingham, IL",39.047945,-88.592849,34430
2748,20820,60-64,1254,1262,2516,"Effingham, IL",39.047945,-88.592849,34430
2749,20820,65+,3454,2942,6396,"Effingham, IL",39.047945,-88.592849,34430
2750,20900,15-19,1484,1566,3050,"El Campo, TX",29.27848,-96.229674,41721
2751,20900,20-24,1345,1294,2639,"El Campo, TX",29.27848,-96.229674,41721
2752,20900,25-29,1204,1339,2543,"El Campo, TX",29.27848,-96.229674,41721
2753,20900,30-34,1215,1232,2447,"El Campo, TX",29.27848,-96.229674,41721
2754,20900,35-39,1361,1298,2659,"El Campo, TX",29.27848,-96.229674,41721
2755,20900,40-44,1238,1187,2425,"El Campo, TX",29.27848,-96.229674,41721
2756,20900,45-49,1086,1058,2144,"El Campo, TX",29.27848,-96.229674,41721
2757,20900,50-54,1163,1174,2337,"El Campo, TX",29.27848,-96.229674,41721
2758,20900,55-59,1324,1300,2624,"El Campo, TX",29.27848,-96.229674,41721
2759,20900,60-64,1316,1288,2604,"El Campo, TX",29.27848,-96.229674,41721
2760,20900,65+,3998,3396,7394,"El Campo, TX",29.27848,-96.229674,41721
2761,20940,15-19,6743,6981,13724,"El Centro, CA",33.040814,-115.3554,179851
2762,20940,20-24,5638,6936,12574,"El Centro, CA",33.040814,-115.3554,179851
2763,20940,25-29,5843,7308,13151,"El Centro, CA",33.040814,-115.3554,179851
2764,20940,30-34,5744,7594,13338,"El Centro, CA",33.040814,-115.3554,179851
2765,20940,35-39,5419,6786,12205,"El Centro, CA",33.040814,-115.3554,179851
2766,20940,40-44,4881,5844,10725,"El Centro, CA",33.040814,-115.3554,179851
2767,20940,45-49,4655,4924,9579,"El Centro, CA",33.040814,-115.3554,179851
2768,20940,50-54,4805,4880,9685,"El Centro, CA",33.040814,-115.3554,179851
2769,20940,55-59,4772,4554,9326,"El Centro, CA",33.040814,-115.3554,179851
2770,20940,60-64,4543,4360,8903,"El Centro, CA",33.040814,-115.3554,179851
2771,20940,65+,13208,10825,24033,"El Centro, CA",33.040814,-115.3554,179851
2772,20980,15-19,1197,1252,2449,"El Dorado, AR",33.168219,-92.598145,38340
2773,20980,20-24,1050,1113,2163,"El Dorado, AR",33.168219,-92.598145,38340
2774,20980,25-29,1135,1119,2254,"El Dorado, AR",33.168219,-92.598145,38340
2775,20980,30-34,1153,1083,2236,"El Dorado, AR",33.168219,-92.598145,38340
2776,20980,35-39,1161,1107,2268,"El Dorado, AR",33.168219,-92.598145,38340
2777,20980,40-44,1199,1182,2381,"El Dorado, AR",33.168219,-92.598145,38340
2778,20980,45-49,1153,1049,2202,"El Dorado, AR",33.168219,-92.598145,38340
2779,20980,50-54,1206,1121,2327,"El Dorado, AR",33.168219,-92.598145,38340
2780,20980,55-59,1275,1294,2569,"El Dorado, AR",33.168219,-92.598145,38340
2781,20980,60-64,1408,1286,2694,"El Dorado, AR",33.168219,-92.598145,38340
2782,20980,65+,3961,3269,7230,"El Dorado, AR",33.168219,-92.598145,38340
2783,21020,15-19,1677,1720,3397,"Elizabeth City, NC",36.197118,-76.34244,53951
2784,21020,20-24,1636,1724,3360,"Elizabeth City, NC",36.197118,-76.34244,53951
2785,21020,25-29,1569,1712,3281,"Elizabeth City, NC",36.197118,-76.34244,53951
2786,21020,30-34,1737,1821,3558,"Elizabeth City, NC",36.197118,-76.34244,53951
2787,21020,35-39,1677,1656,3333,"Elizabeth City, NC",36.197118,-76.34244,53951
2788,21020,40-44,1619,1502,3121,"Elizabeth City, NC",36.197118,-76.34244,53951
2789,21020,45-49,1401,1419,2820,"Elizabeth City, NC",36.197118,-76.34244,53951
2790,21020,50-54,1619,1575,3194,"Elizabeth City, NC",36.197118,-76.34244,53951
2791,21020,55-59,1942,1774,3716,"Elizabeth City, NC",36.197118,-76.34244,53951
2792,21020,60-64,2088,1878,3966,"Elizabeth City, NC",36.197118,-76.34244,53951
2793,21020,65+,6090,4846,10936,"Elizabeth City, NC",36.197118,-76.34244,53951
2794,21060,15-19,4738,5349,10087,"Elizabethtown-Fort Knox, KY",37.73298,-85.972171,156766
2795,21060,20-24,4348,5518,9866,"Elizabethtown-Fort Knox, KY",37.73298,-85.972171,156766
2796,21060,25-29,4785,5313,10098,"Elizabethtown-Fort Knox, KY",37.73298,-85.972171,156766
2797,21060,30-34,5237,5249,10486,"Elizabethtown-Fort Knox, KY",37.73298,-85.972171,156766
2798,21060,35-39,5485,5384,10869,"Elizabethtown-Fort Knox, KY",37.73298,-85.972171,156766
2799,21060,40-44,5153,5272,10425,"Elizabethtown-Fort Knox, KY",37.73298,-85.972171,156766
2800,21060,45-49,4672,4879,9551,"Elizabethtown-Fort Knox, KY",37.73298,-85.972171,156766
2801,21060,50-54,4841,4859,9700,"Elizabethtown-Fort Knox, KY",37.73298,-85.972171,156766
2802,21060,55-59,5364,5317,10681,"Elizabethtown-Fort Knox, KY",37.73298,-85.972171,156766
2803,21060,60-64,5179,4927,10106,"Elizabethtown-Fort Knox, KY",37.73298,-85.972171,156766
2804,21060,65+,13019,10758,23777,"Elizabethtown-Fort Knox, KY",37.73298,-85.972171,156766
2805,21120,15-19,645,754,1399,"Elk City, OK",35.270601,-99.690057,22046
2806,21120,20-24,492,842,1334,"Elk City, OK",35.270601,-99.690057,22046
2807,21120,25-29,599,954,1553,"Elk City, OK",35.270601,-99.690057,22046
2808,21120,30-34,687,966,1653,"Elk City, OK",35.270601,-99.690057,22046
2809,21120,35-39,665,968,1633,"Elk City, OK",35.270601,-99.690057,22046
2810,21120,40-44,606,846,1452,"Elk City, OK",35.270601,-99.690057,22046
2811,21120,45-49,559,720,1279,"Elk City, OK",35.270601,-99.690057,22046
2812,21120,50-54,538,669,1207,"Elk City, OK",35.270601,-99.690057,22046
2813,21120,55-59,590,637,1227,"Elk City, OK",35.270601,-99.690057,22046
2814,21120,60-64,658,648,1306,"Elk City, OK",35.270601,-99.690057,22046
2815,21120,65+,1846,1523,3369,"Elk City, OK",35.270601,-99.690057,22046
2816,21140,15-19,7415,7748,15163,"Elkhart-Goshen, IN",41.600693,-85.863986,206921
2817,21140,20-24,6581,7008,13589,"Elkhart-Goshen, IN",41.600693,-85.863986,206921
2818,21140,25-29,6585,6841,13426,"Elkhart-Goshen, IN",41.600693,-85.863986,206921
2819,21140,30-34,6551,6561,13112,"Elkhart-Goshen, IN",41.600693,-85.863986,206921
2820,21140,35-39,6230,6376,12606,"Elkhart-Goshen, IN",41.600693,-85.863986,206921
2821,21140,40-44,6256,6226,12482,"Elkhart-Goshen, IN",41.600693,-85.863986,206921
2822,21140,45-49,5923,5893,11816,"Elkhart-Goshen, IN",41.600693,-85.863986,206921
2823,21140,50-54,6091,6259,12350,"Elkhart-Goshen, IN",41.600693,-85.863986,206921
2824,21140,55-59,6113,6291,12404,"Elkhart-Goshen, IN",41.600693,-85.863986,206921
2825,21140,60-64,5908,5806,11714,"Elkhart-Goshen, IN",41.600693,-85.863986,206921
2826,21140,65+,17440,14120,31560,"Elkhart-Goshen, IN",41.600693,-85.863986,206921
2827,21180,15-19,729,859,1588,"Elkins, WV",38.781095,-79.867788,27806
2828,21180,20-24,674,937,1611,"Elkins, WV",38.781095,-79.867788,27806
2829,21180,25-29,727,1024,1751,"Elkins, WV",38.781095,-79.867788,27806
2830,21180,30-34,739,966,1705,"Elkins, WV",38.781095,-79.867788,27806
2831,21180,35-39,671,881,1552,"Elkins, WV",38.781095,-79.867788,27806
2832,21180,40-44,742,931,1673,"Elkins, WV",38.781095,-79.867788,27806
2833,21180,45-49,755,862,1617,"Elkins, WV",38.781095,-79.867788,27806
2834,21180,50-54,834,963,1797,"Elkins, WV",38.781095,-79.867788,27806
2835,21180,55-59,945,1045,1990,"Elkins, WV",38.781095,-79.867788,27806
2836,21180,60-64,980,1011,1991,"Elkins, WV",38.781095,-79.867788,27806
2837,21180,65+,3301,2964,6265,"Elkins, WV",38.781095,-79.867788,27806
2838,21220,15-19,1812,2093,3905,"Elko, NV",40.906086,-115.554577,55818
2839,21220,20-24,1488,1641,3129,"Elko, NV",40.906086,-115.554577,55818
2840,21220,25-29,1834,1998,3832,"Elko, NV",40.906086,-115.554577,55818
2841,21220,30-34,2100,2270,4370,"Elko, NV",40.906086,-115.554577,55818
2842,21220,35-39,1878,2179,4057,"Elko, NV",40.906086,-115.554577,55818
2843,21220,40-44,1661,1924,3585,"Elko, NV",40.906086,-115.554577,55818
2844,21220,45-49,1534,1653,3187,"Elko, NV",40.906086,-115.554577,55818
2845,21220,50-54,1619,1745,3364,"Elko, NV",40.906086,-115.554577,55818
2846,21220,55-59,1670,1882,3552,"Elko, NV",40.906086,-115.554577,55818
2847,21220,60-64,1570,1800,3370,"Elko, NV",40.906086,-115.554577,55818
2848,21220,65+,3545,3635,7180,"Elko, NV",40.906086,-115.554577,55818
2849,21260,15-19,1968,1790,3758,"Ellensburg, WA",47.124441,-120.676709,45499
2850,21260,20-24,3498,3423,6921,"Ellensburg, WA",47.124441,-120.676709,45499
2851,21260,25-29,1291,1611,2902,"Ellensburg, WA",47.124441,-120.676709,45499
2852,21260,30-34,1254,1390,2644,"Ellensburg, WA",47.124441,-120.676709,45499
2853,21260,35-39,1264,1312,2576,"Ellensburg, WA",47.124441,-120.676709,45499
2854,21260,40-44,1196,1244,2440,"Ellensburg, WA",47.124441,-120.676709,45499
2855,21260,45-49,1004,1140,2144,"Ellensburg, WA",47.124441,-120.676709,45499
2856,21260,50-54,1146,1212,2358,"Ellensburg, WA",47.124441,-120.676709,45499
2857,21260,55-59,1325,1272,2597,"Ellensburg, WA",47.124441,-120.676709,45499
2858,21260,60-64,1563,1470,3033,"Ellensburg, WA",47.124441,-120.676709,45499
2859,21260,65+,3897,3859,7756,"Ellensburg, WA",47.124441,-120.676709,45499
2860,21300,15-19,2460,2505,4965,"Elmira, NY",42.148697,-76.752471,83045
2861,21300,20-24,2328,2531,4859,"Elmira, NY",42.148697,-76.752471,83045
2862,21300,25-29,2287,2633,4920,"Elmira, NY",42.148697,-76.752471,83045
2863,21300,30-34,2461,2796,5257,"Elmira, NY",42.148697,-76.752471,83045
2864,21300,35-39,2527,2672,5199,"Elmira, NY",42.148697,-76.752471,83045
2865,21300,40-44,2438,2584,5022,"Elmira, NY",42.148697,-76.752471,83045
2866,21300,45-49,2239,2473,4712,"Elmira, NY",42.148697,-76.752471,83045
2867,21300,50-54,2608,2658,5266,"Elmira, NY",42.148697,-76.752471,83045
2868,21300,55-59,2993,2905,5898,"Elmira, NY",42.148697,-76.752471,83045
2869,21300,60-64,3140,2947,6087,"Elmira, NY",42.148697,-76.752471,83045
2870,21300,65+,9048,7418,16466,"Elmira, NY",42.148697,-76.752471,83045
2871,21340,15-19,31800,33993,65793,"El Paso, TX",31.527394,-105.521333,871234
2872,21340,20-24,32205,37627,69832,"El Paso, TX",31.527394,-105.521333,871234
2873,21340,25-29,32634,36418,69052,"El Paso, TX",31.527394,-105.521333,871234
2874,21340,30-34,30295,33157,63452,"El Paso, TX",31.527394,-105.521333,871234
2875,21340,35-39,28661,30819,59480,"El Paso, TX",31.527394,-105.521333,871234
2876,21340,40-44,25751,26328,52079,"El Paso, TX",31.527394,-105.521333,871234
2877,21340,45-49,26360,24985,51345,"El Paso, TX",31.527394,-105.521333,871234
2878,21340,50-54,24841,22929,47770,"El Paso, TX",31.527394,-105.521333,871234
2879,21340,55-59,24417,22057,46474,"El Paso, TX",31.527394,-105.521333,871234
2880,21340,60-64,23753,20417,44170,"El Paso, TX",31.527394,-105.521333,871234
2881,21340,65+,63102,48204,111306,"El Paso, TX",31.527394,-105.521333,871234
2882,21380,15-19,1477,1286,2763,"Emporia, KS",38.382134,-96.359301,34596
2883,21380,20-24,2325,1926,4251,"Emporia, KS",38.382134,-96.359301,34596
2884,21380,25-29,1069,1210,2279,"Emporia, KS",38.382134,-96.359301,34596
2885,21380,30-34,913,1007,1920,"Emporia, KS",38.382134,-96.359301,34596
2886,21380,35-39,983,966,1949,"Emporia, KS",38.382134,-96.359301,34596
2887,21380,40-44,884,938,1822,"Emporia, KS",38.382134,-96.359301,34596
2888,21380,45-49,811,847,1658,"Emporia, KS",38.382134,-96.359301,34596
2889,21380,50-54,856,898,1754,"Emporia, KS",38.382134,-96.359301,34596
2890,21380,55-59,951,974,1925,"Emporia, KS",38.382134,-96.359301,34596
2891,21380,60-64,1085,1037,2122,"Emporia, KS",38.382134,-96.359301,34596
2892,21380,65+,3149,2692,5841,"Emporia, KS",38.382134,-96.359301,34596
2893,21420,15-19,2016,2173,4189,"Enid, OK",36.378132,-97.788741,61926
2894,21420,20-24,1743,2161,3904,"Enid, OK",36.378132,-97.788741,61926
2895,21420,25-29,1915,2181,4096,"Enid, OK",36.378132,-97.788741,61926
2896,21420,30-34,1962,2094,4056,"Enid, OK",36.378132,-97.788741,61926
2897,21420,35-39,2054,2183,4237,"Enid, OK",36.378132,-97.788741,61926
2898,21420,40-44,1913,1956,3869,"Enid, OK",36.378132,-97.788741,61926
2899,21420,45-49,1453,1604,3057,"Enid, OK",36.378132,-97.788741,61926
2900,21420,50-54,1614,1679,3293,"Enid, OK",36.378132,-97.788741,61926
2901,21420,55-59,1835,1953,3788,"Enid, OK",36.378132,-97.788741,61926
2902,21420,60-64,1945,1886,3831,"Enid, OK",36.378132,-97.788741,61926
2903,21420,65+,5663,4633,10296,"Enid, OK",36.378132,-97.788741,61926
2904,21460,15-19,1696,1788,3484,"Enterprise, AL",31.402258,-85.989602,54174
2905,21460,20-24,1485,1618,3103,"Enterprise, AL",31.402258,-85.989602,54174
2906,21460,25-29,1624,1697,3321,"Enterprise, AL",31.402258,-85.989602,54174
2907,21460,30-34,1714,1792,3506,"Enterprise, AL",31.402258,-85.989602,54174
2908,21460,35-39,1757,1784,3541,"Enterprise, AL",31.402258,-85.989602,54174
2909,21460,40-44,1711,1740,3451,"Enterprise, AL",31.402258,-85.989602,54174
2910,21460,45-49,1820,1770,3590,"Enterprise, AL",31.402258,-85.989602,54174
2911,21460,50-54,1749,1771,3520,"Enterprise, AL",31.402258,-85.989602,54174
2912,21460,55-59,1651,1702,3353,"Enterprise, AL",31.402258,-85.989602,54174
2913,21460,60-64,1749,1633,3382,"Enterprise, AL",31.402258,-85.989602,54174
2914,21460,65+,5185,4087,9272,"Enterprise, AL",31.402258,-85.989602,54174
2915,21500,15-19,9187,9493,18680,"Erie, PA",42.117952,-80.096386,269011
2916,21500,20-24,8500,9071,17571,"Erie, PA",42.117952,-80.096386,269011
2917,21500,25-29,7871,8549,16420,"Erie, PA",42.117952,-80.096386,269011
2918,21500,30-34,8848,9159,18007,"Erie, PA",42.117952,-80.096386,269011
2919,21500,35-39,8193,8380,16573,"Erie, PA",42.117952,-80.096386,269011
2920,21500,40-44,7643,7837,15480,"Erie, PA",42.117952,-80.096386,269011
2921,21500,45-49,7310,7397,14707,"Erie, PA",42.117952,-80.096386,269011
2922,21500,50-54,8430,8511,16941,"Erie, PA",42.117952,-80.096386,269011
2923,21500,55-59,8927,8803,17730,"Erie, PA",42.117952,-80.096386,269011
2924,21500,60-64,9730,9569,19299,"Erie, PA",42.117952,-80.096386,269011
2925,21500,65+,27980,23414,51394,"Erie, PA",42.117952,-80.096386,269011
2926,21540,15-19,1019,1093,2112,"Escanaba, MI",45.805229,-86.901938,36826
2927,21540,20-24,877,958,1835,"Escanaba, MI",45.805229,-86.901938,36826
2928,21540,25-29,887,938,1825,"Escanaba, MI",45.805229,-86.901938,36826
2929,21540,30-34,896,925,1821,"Escanaba, MI",45.805229,-86.901938,36826
2930,21540,35-39,958,997,1955,"Escanaba, MI",45.805229,-86.901938,36826
2931,21540,40-44,997,1103,2100,"Escanaba, MI",45.805229,-86.901938,36826
2932,21540,45-49,983,1025,2008,"Escanaba, MI",45.805229,-86.901938,36826
2933,21540,50-54,1114,1181,2295,"Escanaba, MI",45.805229,-86.901938,36826
2934,21540,55-59,1330,1332,2662,"Escanaba, MI",45.805229,-86.901938,36826
2935,21540,60-64,1537,1565,3102,"Escanaba, MI",45.805229,-86.901938,36826
2936,21540,65+,4940,4391,9331,"Escanaba, MI",45.805229,-86.901938,36826
2937,21580,15-19,1256,1289,2545,"Española, NM",36.509669,-106.693983,40179
2938,21580,20-24,1109,1124,2233,"Española, NM",36.509669,-106.693983,40179
2939,21580,25-29,1091,1096,2187,"Española, NM",36.509669,-106.693983,40179
2940,21580,30-34,1162,1200,2362,"Española, NM",36.509669,-106.693983,40179
2941,21580,35-39,1160,1162,2322,"Española, NM",36.509669,-106.693983,40179
2942,21580,40-44,1115,1158,2273,"Española, NM",36.509669,-106.693983,40179
2943,21580,45-49,1127,1100,2227,"Española, NM",36.509669,-106.693983,40179
2944,21580,50-54,1207,1176,2383,"Española, NM",36.509669,-106.693983,40179
2945,21580,55-59,1366,1354,2720,"Española, NM",36.509669,-106.693983,40179
2946,21580,60-64,1503,1476,2979,"Española, NM",36.509669,-106.693983,40179
2947,21580,65+,4508,3873,8381,"Española, NM",36.509669,-106.693983,40179
2948,21640,15-19,738,782,1520,"Eufaula, AL-GA",31.867281,-85.335032,27207
2949,21640,20-24,633,936,1569,"Eufaula, AL-GA",31.867281,-85.335032,27207
2950,21640,25-29,682,1127,1809,"Eufaula, AL-GA",31.867281,-85.335032,27207
2951,21640,30-34,664,1114,1778,"Eufaula, AL-GA",31.867281,-85.335032,27207
2952,21640,35-39,725,974,1699,"Eufaula, AL-GA",31.867281,-85.335032,27207
2953,21640,40-44,664,1015,1679,"Eufaula, AL-GA",31.867281,-85.335032,27207
2954,21640,45-49,698,930,1628,"Eufaula, AL-GA",31.867281,-85.335032,27207
2955,21640,50-54,761,885,1646,"Eufaula, AL-GA",31.867281,-85.335032,27207
2956,21640,55-59,927,946,1873,"Eufaula, AL-GA",31.867281,-85.335032,27207
2957,21640,60-64,875,861,1736,"Eufaula, AL-GA",31.867281,-85.335032,27207
2958,21640,65+,3173,2536,5709,"Eufaula, AL-GA",31.867281,-85.335032,27207
2959,21660,15-19,12065,12236,24301,"Eugene-Springfield, OR",43.928334,-122.897581,383189
2960,21660,20-24,17516,17037,34553,"Eugene-Springfield, OR",43.928334,-122.897581,383189
2961,21660,25-29,12474,13198,25672,"Eugene-Springfield, OR",43.928334,-122.897581,383189
2962,21660,30-34,12158,12589,24747,"Eugene-Springfield, OR",43.928334,-122.897581,383189
2963,21660,35-39,11960,12216,24176,"Eugene-Springfield, OR",43.928334,-122.897581,383189
2964,21660,40-44,12069,12279,24348,"Eugene-Springfield, OR",43.928334,-122.897581,383189
2965,21660,45-49,10466,10633,21099,"Eugene-Springfield, OR",43.928334,-122.897581,383189
2966,21660,50-54,10677,10900,21577,"Eugene-Springfield, OR",43.928334,-122.897581,383189
2967,21660,55-59,11732,10973,22705,"Eugene-Springfield, OR",43.928334,-122.897581,383189
2968,21660,60-64,13320,11892,25212,"Eugene-Springfield, OR",43.928334,-122.897581,383189
2969,21660,65+,42498,36063,78561,"Eugene-Springfield, OR",43.928334,-122.897581,383189
2970,21700,15-19,4473,4526,8999,"Eureka-Arcata, CA",40.706655,-123.926176,136310
2971,21700,20-24,6311,6073,12384,"Eureka-Arcata, CA",40.706655,-123.926176,136310
2972,21700,25-29,4461,4630,9091,"Eureka-Arcata, CA",40.706655,-123.926176,136310
2973,21700,30-34,4220,4356,8576,"Eureka-Arcata, CA",40.706655,-123.926176,136310
2974,21700,35-39,4365,4563,8928,"Eureka-Arcata, CA",40.706655,-123.926176,136310
2975,21700,40-44,4451,4815,9266,"Eureka-Arcata, CA",40.706655,-123.926176,136310
2976,21700,45-49,3635,4127,7762,"Eureka-Arcata, CA",40.706655,-123.926176,136310
2977,21700,50-54,3436,3841,7277,"Eureka-Arcata, CA",40.706655,-123.926176,136310
2978,21700,55-59,3930,3752,7682,"Eureka-Arcata, CA",40.706655,-123.926176,136310
2979,21700,60-64,4717,4285,9002,"Eureka-Arcata, CA",40.706655,-123.926176,136310
2980,21700,65+,14067,12038,26105,"Eureka-Arcata, CA",40.706655,-123.926176,136310
2981,21740,15-19,767,820,1587,"Evanston, WY",41.284726,-110.558947,20635
2982,21740,20-24,501,563,1064,"Evanston, WY",41.284726,-110.558947,20635
2983,21740,25-29,588,546,1134,"Evanston, WY",41.284726,-110.558947,20635
2984,21740,30-34,632,612,1244,"Evanston, WY",41.284726,-110.558947,20635
2985,21740,35-39,674,717,1391,"Evanston, WY",41.284726,-110.558947,20635
2986,21740,40-44,709,688,1397,"Evanston, WY",41.284726,-110.558947,20635
2987,21740,45-49,567,667,1234,"Evanston, WY",41.284726,-110.558947,20635
2988,21740,50-54,523,551,1074,"Evanston, WY",41.284726,-110.558947,20635
2989,21740,55-59,583,558,1141,"Evanston, WY",41.284726,-110.558947,20635
2990,21740,60-64,689,754,1443,"Evanston, WY",41.284726,-110.558947,20635
2991,21740,65+,1636,1644,3280,"Evanston, WY",41.284726,-110.558947,20635
2992,21780,15-19,10141,10149,20290,"Evansville, IN-KY",38.02007,-87.586166,313946
2993,21780,20-24,9726,9655,19381,"Evansville, IN-KY",38.02007,-87.586166,313946
2994,21780,25-29,10041,10182,20223,"Evansville, IN-KY",38.02007,-87.586166,313946
2995,21780,30-34,10456,10189,20645,"Evansville, IN-KY",38.02007,-87.586166,313946
2996,21780,35-39,10123,10004,20127,"Evansville, IN-KY",38.02007,-87.586166,313946
2997,21780,40-44,9609,9813,19422,"Evansville, IN-KY",38.02007,-87.586166,313946
2998,21780,45-49,8957,8993,17950,"Evansville, IN-KY",38.02007,-87.586166,313946
2999,21780,50-54,9459,9498,18957,"Evansville, IN-KY",38.02007,-87.586166,313946
3000,21780,55-59,10616,10077,20693,"Evansville, IN-KY",38.02007,-87.586166,313946
3001,21780,60-64,11404,10815,22219,"Evansville, IN-KY",38.02007,-87.586166,313946
3002,21780,65+,31396,25327,56723,"Evansville, IN-KY",38.02007,-87.586166,313946
3003,21820,15-19,2680,2992,5672,"Fairbanks, AK",64.676044,-146.548159,95593
3004,21820,20-24,3408,6259,9667,"Fairbanks, AK",64.676044,-146.548159,95593
3005,21820,25-29,3898,5360,9258,"Fairbanks, AK",64.676044,-146.548159,95593
3006,21820,30-34,3767,4351,8118,"Fairbanks, AK",64.676044,-146.548159,95593
3007,21820,35-39,3350,3997,7347,"Fairbanks, AK",64.676044,-146.548159,95593
3008,21820,40-44,2586,3087,5673,"Fairbanks, AK",64.676044,-146.548159,95593
3009,21820,45-49,2232,2455,4687,"Fairbanks, AK",64.676044,-146.548159,95593
3010,21820,50-54,2181,2434,4615,"Fairbanks, AK",64.676044,-146.548159,95593
3011,21820,55-59,2452,2523,4975,"Fairbanks, AK",64.676044,-146.548159,95593
3012,21820,60-64,2415,2548,4963,"Fairbanks, AK",64.676044,-146.548159,95593
3013,21820,65+,5559,5807,11366,"Fairbanks, AK",64.676044,-146.548159,95593
3014,21840,15-19,331,375,706,"Fairfield, IA",41.006376,-91.966628,15647
3015,21840,20-24,370,1028,1398,"Fairfield, IA",41.006376,-91.966628,15647
3016,21840,25-29,395,764,1159,"Fairfield, IA",41.006376,-91.966628,15647
3017,21840,30-34,413,570,983,"Fairfield, IA",41.006376,-91.966628,15647
3018,21840,35-39,408,534,942,"Fairfield, IA",41.006376,-91.966628,15647
3019,21840,40-44,424,449,873,"Fairfield, IA",41.006376,-91.966628,15647
3020,21840,45-49,397,412,809,"Fairfield, IA",41.006376,-91.966628,15647
3021,21840,50-54,423,425,848,"Fairfield, IA",41.006376,-91.966628,15647
3022,21840,55-59,459,451,910,"Fairfield, IA",41.006376,-91.966628,15647
3023,21840,60-64,580,570,1150,"Fairfield, IA",41.006376,-91.966628,15647
3024,21840,65+,1962,1857,3819,"Fairfield, IA",41.006376,-91.966628,15647
3025,21860,15-19,602,604,1206,"Fairmont, MN",43.677173,-94.547096,19915
3026,21860,20-24,481,490,971,"Fairmont, MN",43.677173,-94.547096,19915
3027,21860,25-29,504,503,1007,"Fairmont, MN",43.677173,-94.547096,19915
3028,21860,30-34,449,504,953,"Fairmont, MN",43.677173,-94.547096,19915
3029,21860,35-39,578,606,1184,"Fairmont, MN",43.677173,-94.547096,19915
3030,21860,40-44,482,567,1049,"Fairmont, MN",43.677173,-94.547096,19915
3031,21860,45-49,495,501,996,"Fairmont, MN",43.677173,-94.547096,19915
3032,21860,50-54,537,547,1084,"Fairmont, MN",43.677173,-94.547096,19915
3033,21860,55-59,660,671,1331,"Fairmont, MN",43.677173,-94.547096,19915
3034,21860,60-64,780,799,1579,"Fairmont, MN",43.677173,-94.547096,19915
3035,21860,65+,2573,2290,4863,"Fairmont, MN",43.677173,-94.547096,19915
3036,21900,15-19,1753,1978,3731,"Fairmont, WV",39.505839,-80.243402,56001
3037,21900,20-24,2262,2344,4606,"Fairmont, WV",39.505839,-80.243402,56001
3038,21900,25-29,1737,1790,3527,"Fairmont, WV",39.505839,-80.243402,56001
3039,21900,30-34,1606,1648,3254,"Fairmont, WV",39.505839,-80.243402,56001
3040,21900,35-39,1565,1695,3260,"Fairmont, WV",39.505839,-80.243402,56001
3041,21900,40-44,1673,1674,3347,"Fairmont, WV",39.505839,-80.243402,56001
3042,21900,45-49,1613,1653,3266,"Fairmont, WV",39.505839,-80.243402,56001
3043,21900,50-54,1802,1806,3608,"Fairmont, WV",39.505839,-80.243402,56001
3044,21900,55-59,1693,1693,3386,"Fairmont, WV",39.505839,-80.243402,56001
3045,21900,60-64,1893,1843,3736,"Fairmont, WV",39.505839,-80.243402,56001
3046,21900,65+,5953,5047,11000,"Fairmont, WV",39.505839,-80.243402,56001
3047,21980,15-19,680,755,1435,"Fallon, NV",39.53771,-118.264166,25723
3048,21980,20-24,678,764,1442,"Fallon, NV",39.53771,-118.264166,25723
3049,21980,25-29,844,954,1798,"Fallon, NV",39.53771,-118.264166,25723
3050,21980,30-34,918,987,1905,"Fallon, NV",39.53771,-118.264166,25723
3051,21980,35-39,764,858,1622,"Fallon, NV",39.53771,-118.264166,25723
3052,21980,40-44,669,784,1453,"Fallon, NV",39.53771,-118.264166,25723
3053,21980,45-49,615,656,1271,"Fallon, NV",39.53771,-118.264166,25723
3054,21980,50-54,733,683,1416,"Fallon, NV",39.53771,-118.264166,25723
3055,21980,55-59,808,894,1702,"Fallon, NV",39.53771,-118.264166,25723
3056,21980,60-64,909,874,1783,"Fallon, NV",39.53771,-118.264166,25723
3057,21980,65+,2564,2352,4916,"Fallon, NV",39.53771,-118.264166,25723
3058,22020,15-19,8926,8811,17737,"Fargo, ND-MN",46.914859,-96.960183,252136
3059,22020,20-24,13150,12723,25873,"Fargo, ND-MN",46.914859,-96.960183,252136
3060,22020,25-29,9833,10236,20069,"Fargo, ND-MN",46.914859,-96.960183,252136
3061,22020,30-34,9265,10263,19528,"Fargo, ND-MN",46.914859,-96.960183,252136
3062,22020,35-39,8925,9886,18811,"Fargo, ND-MN",46.914859,-96.960183,252136
3063,22020,40-44,7807,8675,16482,"Fargo, ND-MN",46.914859,-96.960183,252136
3064,22020,45-49,6158,6835,12993,"Fargo, ND-MN",46.914859,-96.960183,252136
3065,22020,50-54,6124,6607,12731,"Fargo, ND-MN",46.914859,-96.960183,252136
3066,22020,55-59,6232,6490,12722,"Fargo, ND-MN",46.914859,-96.960183,252136
3067,22020,60-64,6493,6229,12722,"Fargo, ND-MN",46.914859,-96.960183,252136
3068,22020,65+,17765,15120,32885,"Fargo, ND-MN",46.914859,-96.960183,252136
3069,22060,15-19,2979,2813,5792,"Faribault-Northfield, MN",44.350775,-93.298513,67262
3070,22060,20-24,3092,3372,6464,"Faribault-Northfield, MN",44.350775,-93.298513,67262
3071,22060,25-29,1628,2063,3691,"Faribault-Northfield, MN",44.350775,-93.298513,67262
3072,22060,30-34,1775,2206,3981,"Faribault-Northfield, MN",44.350775,-93.298513,67262
3073,22060,35-39,1819,2359,4178,"Faribault-Northfield, MN",44.350775,-93.298513,67262
3074,22060,40-44,1862,2216,4078,"Faribault-Northfield, MN",44.350775,-93.298513,67262
3075,22060,45-49,1673,2010,3683,"Faribault-Northfield, MN",44.350775,-93.298513,67262
3076,22060,50-54,1928,2165,4093,"Faribault-Northfield, MN",44.350775,-93.298513,67262
3077,22060,55-59,2036,2236,4272,"Faribault-Northfield, MN",44.350775,-93.298513,67262
3078,22060,60-64,2143,2183,4326,"Faribault-Northfield, MN",44.350775,-93.298513,67262
3079,22060,65+,5780,5130,10910,"Faribault-Northfield, MN",44.350775,-93.298513,67262
3080,22100,15-19,1916,2038,3954,"Farmington, MO",37.810707,-90.473868,67541
3081,22100,20-24,1726,2407,4133,"Farmington, MO",37.810707,-90.473868,67541
3082,22100,25-29,1893,2842,4735,"Farmington, MO",37.810707,-90.473868,67541
3083,22100,30-34,2034,2806,4840,"Farmington, MO",37.810707,-90.473868,67541
3084,22100,35-39,2019,2684,4703,"Farmington, MO",37.810707,-90.473868,67541
3085,22100,40-44,2002,2615,4617,"Farmington, MO",37.810707,-90.473868,67541
3086,22100,45-49,1873,2418,4291,"Farmington, MO",37.810707,-90.473868,67541
3087,22100,50-54,1980,2386,4366,"Farmington, MO",37.810707,-90.473868,67541
3088,22100,55-59,2087,2353,4440,"Farmington, MO",37.810707,-90.473868,67541
3089,22100,60-64,2155,2215,4370,"Farmington, MO",37.810707,-90.473868,67541
3090,22100,65+,6183,5224,11407,"Farmington, MO",37.810707,-90.473868,67541
3091,22140,15-19,4469,4554,9023,"Farmington, NM",36.511624,-108.324578,120993
3092,22140,20-24,3519,3662,7181,"Farmington, NM",36.511624,-108.324578,120993
3093,22140,25-29,3712,3811,7523,"Farmington, NM",36.511624,-108.324578,120993
3094,22140,30-34,4055,4150,8205,"Farmington, NM",36.511624,-108.324578,120993
3095,22140,35-39,4047,4190,8237,"Farmington, NM",36.511624,-108.324578,120993
3096,22140,40-44,3851,3920,7771,"Farmington, NM",36.511624,-108.324578,120993
3097,22140,45-49,3291,3258,6549,"Farmington, NM",36.511624,-108.324578,120993
3098,22140,50-54,3349,3197,6546,"Farmington, NM",36.511624,-108.324578,120993
3099,22140,55-59,3737,3641,7378,"Farmington, NM",36.511624,-108.324578,120993
3100,22140,60-64,3964,4032,7996,"Farmington, NM",36.511624,-108.324578,120993
3101,22140,65+,10647,8867,19514,"Farmington, NM",36.511624,-108.324578,120993
3102,22180,15-19,16688,18516,35204,"Fayetteville, NC",35.155986,-78.93185,524588
3103,22180,20-24,18952,25078,44030,"Fayetteville, NC",35.155986,-78.93185,524588
3104,22180,25-29,20835,23511,44346,"Fayetteville, NC",35.155986,-78.93185,524588
3105,22180,30-34,20629,20812,41441,"Fayetteville, NC",35.155986,-78.93185,524588
3106,22180,35-39,18615,18037,36652,"Fayetteville, NC",35.155986,-78.93185,524588
3107,22180,40-44,16318,15099,31417,"Fayetteville, NC",35.155986,-78.93185,524588
3108,22180,45-49,14614,13232,27846,"Fayetteville, NC",35.155986,-78.93185,524588
3109,22180,50-54,14734,13375,28109,"Fayetteville, NC",35.155986,-78.93185,524588
3110,22180,55-59,15410,13539,28949,"Fayetteville, NC",35.155986,-78.93185,524588
3111,22180,60-64,14571,12955,27526,"Fayetteville, NC",35.155986,-78.93185,524588
3112,22180,65+,37696,28544,66240,"Fayetteville, NC",35.155986,-78.93185,524588
3113,22220,15-19,20223,20888,41111,"Fayetteville-Springdale-Rogers, AR",36.116394,-94.079545,560709
3114,22220,20-24,21423,22198,43621,"Fayetteville-Springdale-Rogers, AR",36.116394,-94.079545,560709
3115,22220,25-29,20163,20853,41016,"Fayetteville-Springdale-Rogers, AR",36.116394,-94.079545,560709
3116,22220,30-34,20327,21140,41467,"Fayetteville-Springdale-Rogers, AR",36.116394,-94.079545,560709
3117,22220,35-39,19805,21200,41005,"Fayetteville-Springdale-Rogers, AR",36.116394,-94.079545,560709
3118,22220,40-44,18739,19689,38428,"Fayetteville-Springdale-Rogers, AR",36.116394,-94.079545,560709
3119,22220,45-49,16371,16792,33163,"Fayetteville-Springdale-Rogers, AR",36.116394,-94.079545,560709
3120,22220,50-54,15728,16305,32033,"Fayetteville-Springdale-Rogers, AR",36.116394,-94.079545,560709
3121,22220,55-59,15438,15467,30905,"Fayetteville-Springdale-Rogers, AR",36.116394,-94.079545,560709
3122,22220,60-64,14747,14115,28862,"Fayetteville-Springdale-Rogers, AR",36.116394,-94.079545,560709
3123,22220,65+,40494,33500,73994,"Fayetteville-Springdale-Rogers, AR",36.116394,-94.079545,560709
3124,22260,15-19,1654,1767,3421,"Fergus Falls, MN",46.405727,-95.714581,60046
3125,22260,20-24,1341,1456,2797,"Fergus Falls, MN",46.405727,-95.714581,60046
3126,22260,25-29,1412,1447,2859,"Fergus Falls, MN",46.405727,-95.714581,60046
3127,22260,30-34,1349,1508,2857,"Fergus Falls, MN",46.405727,-95.714581,60046
3128,22260,35-39,1650,1671,3321,"Fergus Falls, MN",46.405727,-95.714581,60046
3129,22260,40-44,1589,1776,3365,"Fergus Falls, MN",46.405727,-95.714581,60046
3130,22260,45-49,1389,1411,2800,"Fergus Falls, MN",46.405727,-95.714581,60046
3131,22260,50-54,1679,1724,3403,"Fergus Falls, MN",46.405727,-95.714581,60046
3132,22260,55-59,2134,2143,4277,"Fergus Falls, MN",46.405727,-95.714581,60046
3133,22260,60-64,2556,2613,5169,"Fergus Falls, MN",46.405727,-95.714581,60046
3134,22260,65+,7677,7206,14883,"Fergus Falls, MN",46.405727,-95.714581,60046
3135,22280,15-19,1571,1879,3450,"Fernley, NV",39.022213,-119.197425,60903
3136,22280,20-24,1363,1442,2805,"Fernley, NV",39.022213,-119.197425,60903
3137,22280,25-29,1818,2019,3837,"Fernley, NV",39.022213,-119.197425,60903
3138,22280,30-34,1958,2343,4301,"Fernley, NV",39.022213,-119.197425,60903
3139,22280,35-39,1851,2129,3980,"Fernley, NV",39.022213,-119.197425,60903
3140,22280,40-44,1685,1877,3562,"Fernley, NV",39.022213,-119.197425,60903
3141,22280,45-49,1561,1646,3207,"Fernley, NV",39.022213,-119.197425,60903
3142,22280,50-54,1717,1871,3588,"Fernley, NV",39.022213,-119.197425,60903
3143,22280,55-59,2072,2130,4202,"Fernley, NV",39.022213,-119.197425,60903
3144,22280,60-64,2180,2348,4528,"Fernley, NV",39.022213,-119.197425,60903
3145,22280,65+,6530,6496,13026,"Fernley, NV",39.022213,-119.197425,60903
3146,22300,15-19,2386,2401,4787,"Findlay, OH",41.000217,-83.665947,74656
3147,22300,20-24,2292,2363,4655,"Findlay, OH",41.000217,-83.665947,74656
3148,22300,25-29,2338,2550,4888,"Findlay, OH",41.000217,-83.665947,74656
3149,22300,30-34,2451,2584,5035,"Findlay, OH",41.000217,-83.665947,74656
3150,22300,35-39,2241,2473,4714,"Findlay, OH",41.000217,-83.665947,74656
3151,22300,40-44,2152,2222,4374,"Findlay, OH",41.000217,-83.665947,74656
3152,22300,45-49,2170,2172,4342,"Findlay, OH",41.000217,-83.665947,74656
3153,22300,50-54,2254,2404,4658,"Findlay, OH",41.000217,-83.665947,74656
3154,22300,55-59,2482,2567,5049,"Findlay, OH",41.000217,-83.665947,74656
3155,22300,60-64,2574,2556,5130,"Findlay, OH",41.000217,-83.665947,74656
3156,22300,65+,7449,6059,13508,"Findlay, OH",41.000217,-83.665947,74656
3157,22340,15-19,591,554,1145,"Fitzgerald, GA",31.740772,-83.147197,17158
3158,22340,20-24,472,504,976,"Fitzgerald, GA",31.740772,-83.147197,17158
3159,22340,25-29,496,463,959,"Fitzgerald, GA",31.740772,-83.147197,17158
3160,22340,30-34,554,506,1060,"Fitzgerald, GA",31.740772,-83.147197,17158
3161,22340,35-39,584,441,1025,"Fitzgerald, GA",31.740772,-83.147197,17158
3162,22340,40-44,524,501,1025,"Fitzgerald, GA",31.740772,-83.147197,17158
3163,22340,45-49,484,477,961,"Fitzgerald, GA",31.740772,-83.147197,17158
3164,22340,50-54,529,540,1069,"Fitzgerald, GA",31.740772,-83.147197,17158
3165,22340,55-59,586,546,1132,"Fitzgerald, GA",31.740772,-83.147197,17158
3166,22340,60-64,634,537,1171,"Fitzgerald, GA",31.740772,-83.147197,17158
3167,22340,65+,1852,1277,3129,"Fitzgerald, GA",31.740772,-83.147197,17158
3168,22380,15-19,7591,6578,14169,"Flagstaff, AZ",35.829692,-111.773728,145052
3169,22380,20-24,10509,9061,19570,"Flagstaff, AZ",35.829692,-111.773728,145052
3170,22380,25-29,5096,5513,10609,"Flagstaff, AZ",35.829692,-111.773728,145052
3171,22380,30-34,4634,4940,9574,"Flagstaff, AZ",35.829692,-111.773728,145052
3172,22380,35-39,4195,4491,8686,"Flagstaff, AZ",35.829692,-111.773728,145052
3173,22380,40-44,3946,3960,7906,"Flagstaff, AZ",35.829692,-111.773728,145052
3174,22380,45-49,3432,3786,7218,"Flagstaff, AZ",35.829692,-111.773728,145052
3175,22380,50-54,3552,3616,7168,"Flagstaff, AZ",35.829692,-111.773728,145052
3176,22380,55-59,3838,3809,7647,"Flagstaff, AZ",35.829692,-111.773728,145052
3177,22380,60-64,4411,4028,8439,"Flagstaff, AZ",35.829692,-111.773728,145052
3178,22380,65+,10606,9784,20390,"Flagstaff, AZ",35.829692,-111.773728,145052
3179,22420,15-19,12307,13131,25438,"Flint, MI",43.021077,-83.706372,404208
3180,22420,20-24,12132,12350,24482,"Flint, MI",43.021077,-83.706372,404208
3181,22420,25-29,13453,13055,26508,"Flint, MI",43.021077,-83.706372,404208
3182,22420,30-34,12918,12143,25061,"Flint, MI",43.021077,-83.706372,404208
3183,22420,35-39,11889,11110,22999,"Flint, MI",43.021077,-83.706372,404208
3184,22420,40-44,12618,11652,24270,"Flint, MI",43.021077,-83.706372,404208
3185,22420,45-49,12395,11576,23971,"Flint, MI",43.021077,-83.706372,404208
3186,22420,50-54,13671,13025,26696,"Flint, MI",43.021077,-83.706372,404208
3187,22420,55-59,14572,13639,28211,"Flint, MI",43.021077,-83.706372,404208
3188,22420,60-64,15128,13725,28853,"Flint, MI",43.021077,-83.706372,404208
3189,22420,65+,41120,32630,73750,"Flint, MI",43.021077,-83.706372,404208
3190,22500,15-19,6485,6576,13061,"Florence, SC",34.153574,-79.806164,199259
3191,22500,20-24,6544,5900,12444,"Florence, SC",34.153574,-79.806164,199259
3192,22500,25-29,6489,5776,12265,"Florence, SC",34.153574,-79.806164,199259
3193,22500,30-34,6614,5846,12460,"Florence, SC",34.153574,-79.806164,199259
3194,22500,35-39,6112,5401,11513,"Florence, SC",34.153574,-79.806164,199259
3195,22500,40-44,6417,5697,12114,"Florence, SC",34.153574,-79.806164,199259
3196,22500,45-49,6551,5441,11992,"Florence, SC",34.153574,-79.806164,199259
3197,22500,50-54,6663,6027,12690,"Florence, SC",34.153574,-79.806164,199259
3198,22500,55-59,7125,6195,13320,"Florence, SC",34.153574,-79.806164,199259
3199,22500,60-64,6923,5949,12872,"Florence, SC",34.153574,-79.806164,199259
3200,22500,65+,20895,15793,36688,"Florence, SC",34.153574,-79.806164,199259
3201,22520,15-19,4720,4683,9403,"Florence-Muscle Shoals, AL",34.799254,-87.719388,151517
3202,22520,20-24,5666,5245,10911,"Florence-Muscle Shoals, AL",34.799254,-87.719388,151517
3203,22520,25-29,4752,4715,9467,"Florence-Muscle Shoals, AL",34.799254,-87.719388,151517
3204,22520,30-34,4687,4559,9246,"Florence-Muscle Shoals, AL",34.799254,-87.719388,151517
3205,22520,35-39,4374,4355,8729,"Florence-Muscle Shoals, AL",34.799254,-87.719388,151517
3206,22520,40-44,4275,4061,8336,"Florence-Muscle Shoals, AL",34.799254,-87.719388,151517
3207,22520,45-49,4404,4175,8579,"Florence-Muscle Shoals, AL",34.799254,-87.719388,151517
3208,22520,50-54,4943,4792,9735,"Florence-Muscle Shoals, AL",34.799254,-87.719388,151517
3209,22520,55-59,5302,5031,10333,"Florence-Muscle Shoals, AL",34.799254,-87.719388,151517
3210,22520,60-64,5604,4868,10472,"Florence-Muscle Shoals, AL",34.799254,-87.719388,151517
3211,22520,65+,17265,13681,30946,"Florence-Muscle Shoals, AL",34.799254,-87.719388,151517
3212,22540,15-19,3370,3431,6801,"Fond du Lac, WI",43.754722,-88.493284,104362
3213,22540,20-24,3084,3145,6229,"Fond du Lac, WI",43.754722,-88.493284,104362
3214,22540,25-29,3078,3052,6130,"Fond du Lac, WI",43.754722,-88.493284,104362
3215,22540,30-34,3017,2992,6009,"Fond du Lac, WI",43.754722,-88.493284,104362
3216,22540,35-39,3280,3446,6726,"Fond du Lac, WI",43.754722,-88.493284,104362
3217,22540,40-44,3251,3309,6560,"Fond du Lac, WI",43.754722,-88.493284,104362
3218,22540,45-49,2879,2970,5849,"Fond du Lac, WI",43.754722,-88.493284,104362
3219,22540,50-54,3294,3433,6727,"Fond du Lac, WI",43.754722,-88.493284,104362
3220,22540,55-59,3785,3797,7582,"Fond du Lac, WI",43.754722,-88.493284,104362
3221,22540,60-64,3859,3864,7723,"Fond du Lac, WI",43.754722,-88.493284,104362
3222,22540,65+,10822,9284,20106,"Fond du Lac, WI",43.754722,-88.493284,104362
3223,22580,15-19,1848,1858,3706,"Forest City, NC",35.402747,-81.919582,64586
3224,22580,20-24,1707,1742,3449,"Forest City, NC",35.402747,-81.919582,64586
3225,22580,25-29,1822,1745,3567,"Forest City, NC",35.402747,-81.919582,64586
3226,22580,30-34,1826,1724,3550,"Forest City, NC",35.402747,-81.919582,64586
3227,22580,35-39,1708,1636,3344,"Forest City, NC",35.402747,-81.919582,64586
3228,22580,40-44,1847,1817,3664,"Forest City, NC",35.402747,-81.919582,64586
3229,22580,45-49,2010,1941,3951,"Forest City, NC",35.402747,-81.919582,64586
3230,22580,50-54,2401,2301,4702,"Forest City, NC",35.402747,-81.919582,64586
3231,22580,55-59,2420,2377,4797,"Forest City, NC",35.402747,-81.919582,64586
3232,22580,60-64,2567,2338,4905,"Forest City, NC",35.402747,-81.919582,64586
3233,22580,65+,7874,6462,14336,"Forest City, NC",35.402747,-81.919582,64586
3234,22620,15-19,586,628,1214,"Forrest City, AR",35.022838,-90.751506,22739
3235,22620,20-24,598,718,1316,"Forrest City, AR",35.022838,-90.751506,22739
3236,22620,25-29,569,1029,1598,"Forrest City, AR",35.022838,-90.751506,22739
3237,22620,30-34,603,1212,1815,"Forrest City, AR",35.022838,-90.751506,22739
3238,22620,35-39,524,1182,1706,"Forrest City, AR",35.022838,-90.751506,22739
3239,22620,40-44,519,1023,1542,"Forrest City, AR",35.022838,-90.751506,22739
3240,22620,45-49,573,868,1441,"Forrest City, AR",35.022838,-90.751506,22739
3241,22620,50-54,574,801,1375,"Forrest City, AR",35.022838,-90.751506,22739
3242,22620,55-59,670,723,1393,"Forrest City, AR",35.022838,-90.751506,22739
3243,22620,60-64,740,722,1462,"Forrest City, AR",35.022838,-90.751506,22739
3244,22620,65+,2047,1787,3834,"Forrest City, AR",35.022838,-90.751506,22739
3245,22660,15-19,13223,12870,26093,"Fort Collins, CO",40.658093,-105.486764,362533
3246,22660,20-24,18075,18539,36614,"Fort Collins, CO",40.658093,-105.486764,362533
3247,22660,25-29,13496,14730,28226,"Fort Collins, CO",40.658093,-105.486764,362533
3248,22660,30-34,12119,13369,25488,"Fort Collins, CO",40.658093,-105.486764,362533
3249,22660,35-39,11499,12435,23934,"Fort Collins, CO",40.658093,-105.486764,362533
3250,22660,40-44,11221,11804,23025,"Fort Collins, CO",40.658093,-105.486764,362533
3251,22660,45-49,9687,10444,20131,"Fort Collins, CO",40.658093,-105.486764,362533
3252,22660,50-54,9662,9964,19626,"Fort Collins, CO",40.658093,-105.486764,362533
3253,22660,55-59,10601,9745,20346,"Fort Collins, CO",40.658093,-105.486764,362533
3254,22660,60-64,11576,10880,22456,"Fort Collins, CO",40.658093,-105.486764,362533
3255,22660,65+,32933,28446,61379,"Fort Collins, CO",40.658093,-105.486764,362533
3256,22700,15-19,1166,1623,2789,"Fort Dodge, IA",42.433579,-94.175831,37147
3257,22700,20-24,1134,1776,2910,"Fort Dodge, IA",42.433579,-94.175831,37147
3258,22700,25-29,995,1493,2488,"Fort Dodge, IA",42.433579,-94.175831,37147
3259,22700,30-34,995,1222,2217,"Fort Dodge, IA",42.433579,-94.175831,37147
3260,22700,35-39,994,1098,2092,"Fort Dodge, IA",42.433579,-94.175831,37147
3261,22700,40-44,1019,1168,2187,"Fort Dodge, IA",42.433579,-94.175831,37147
3262,22700,45-49,829,973,1802,"Fort Dodge, IA",42.433579,-94.175831,37147
3263,22700,50-54,989,1082,2071,"Fort Dodge, IA",42.433579,-94.175831,37147
3264,22700,55-59,1167,1188,2355,"Fort Dodge, IA",42.433579,-94.175831,37147
3265,22700,60-64,1344,1369,2713,"Fort Dodge, IA",42.433579,-94.175831,37147
3266,22700,65+,3690,3203,6893,"Fort Dodge, IA",42.433579,-94.175831,37147
3267,22780,15-19,1745,4247,5992,"Fort Leonard Wood, MO",37.824835,-92.207022,53816
3268,22780,20-24,2060,5106,7166,"Fort Leonard Wood, MO",37.824835,-92.207022,53816
3269,22780,25-29,1999,2839,4838,"Fort Leonard Wood, MO",37.824835,-92.207022,53816
3270,22780,30-34,2139,2489,4628,"Fort Leonard Wood, MO",37.824835,-92.207022,53816
3271,22780,35-39,1718,2080,3798,"Fort Leonard Wood, MO",37.824835,-92.207022,53816
3272,22780,40-44,1437,1605,3042,"Fort Leonard Wood, MO",37.824835,-92.207022,53816
3273,22780,45-49,1148,1165,2313,"Fort Leonard Wood, MO",37.824835,-92.207022,53816
3274,22780,50-54,1101,1097,2198,"Fort Leonard Wood, MO",37.824835,-92.207022,53816
3275,22780,55-59,1196,1162,2358,"Fort Leonard Wood, MO",37.824835,-92.207022,53816
3276,22780,60-64,1109,1072,2181,"Fort Leonard Wood, MO",37.824835,-92.207022,53816
3277,22780,65+,2738,2345,5083,"Fort Leonard Wood, MO",37.824835,-92.207022,53816
3278,22800,15-19,1578,1655,3233,"Fort Madison-Keokuk, IA-IL-MO",40.478345,-91.409363,57351
3279,22800,20-24,1355,1537,2892,"Fort Madison-Keokuk, IA-IL-MO",40.478345,-91.409363,57351
3280,22800,25-29,1500,1684,3184,"Fort Madison-Keokuk, IA-IL-MO",40.478345,-91.409363,57351
3281,22800,30-34,1513,1629,3142,"Fort Madison-Keokuk, IA-IL-MO",40.478345,-91.409363,57351
3282,22800,35-39,1606,1732,3338,"Fort Madison-Keokuk, IA-IL-MO",40.478345,-91.409363,57351
3283,22800,40-44,1631,1766,3397,"Fort Madison-Keokuk, IA-IL-MO",40.478345,-91.409363,57351
3284,22800,45-49,1520,1641,3161,"Fort Madison-Keokuk, IA-IL-MO",40.478345,-91.409363,57351
3285,22800,50-54,1698,1798,3496,"Fort Madison-Keokuk, IA-IL-MO",40.478345,-91.409363,57351
3286,22800,55-59,2062,2119,4181,"Fort Madison-Keokuk, IA-IL-MO",40.478345,-91.409363,57351
3287,22800,60-64,2157,2255,4412,"Fort Madison-Keokuk, IA-IL-MO",40.478345,-91.409363,57351
3288,22800,65+,6842,5896,12738,"Fort Madison-Keokuk, IA-IL-MO",40.478345,-91.409363,57351
3289,22820,15-19,912,978,1890,"Fort Morgan, CO",40.263159,-103.81221,29008
3290,22820,20-24,804,891,1695,"Fort Morgan, CO",40.263159,-103.81221,29008
3291,22820,25-29,967,1021,1988,"Fort Morgan, CO",40.263159,-103.81221,29008
3292,22820,30-34,962,1131,2093,"Fort Morgan, CO",40.263159,-103.81221,29008
3293,22820,35-39,869,1081,1950,"Fort Morgan, CO",40.263159,-103.81221,29008
3294,22820,40-44,818,906,1724,"Fort Morgan, CO",40.263159,-103.81221,29008
3295,22820,45-49,731,791,1522,"Fort Morgan, CO",40.263159,-103.81221,29008
3296,22820,50-54,779,901,1680,"Fort Morgan, CO",40.263159,-103.81221,29008
3297,22820,55-59,818,872,1690,"Fort Morgan, CO",40.263159,-103.81221,29008
3298,22820,60-64,863,932,1795,"Fort Morgan, CO",40.263159,-103.81221,29008
3299,22820,65+,2479,2175,4654,"Fort Morgan, CO",40.263159,-103.81221,29008
3300,22840,15-19,2372,2522,4894,"Fort Payne, AL",34.460915,-85.804021,71813
3301,22840,20-24,2072,2170,4242,"Fort Payne, AL",34.460915,-85.804021,71813
3302,22840,25-29,2107,2217,4324,"Fort Payne, AL",34.460915,-85.804021,71813
3303,22840,30-34,2078,2122,4200,"Fort Payne, AL",34.460915,-85.804021,71813
3304,22840,35-39,2025,1992,4017,"Fort Payne, AL",34.460915,-85.804021,71813
3305,22840,40-44,2273,2246,4519,"Fort Payne, AL",34.460915,-85.804021,71813
3306,22840,45-49,2235,2321,4556,"Fort Payne, AL",34.460915,-85.804021,71813
3307,22840,50-54,2371,2474,4845,"Fort Payne, AL",34.460915,-85.804021,71813
3308,22840,55-59,2379,2355,4734,"Fort Payne, AL",34.460915,-85.804021,71813
3309,22840,60-64,2356,2365,4721,"Fort Payne, AL",34.460915,-85.804021,71813
3310,22840,65+,6924,5770,12694,"Fort Payne, AL",34.460915,-85.804021,71813
3311,22860,15-19,1344,1644,2988,"Fort Polk South, LA",31.102841,-93.18833,48027
3312,22860,20-24,1861,3504,5365,"Fort Polk South, LA",31.102841,-93.18833,48027
3313,22860,25-29,1877,2682,4559,"Fort Polk South, LA",31.102841,-93.18833,48027
3314,22860,30-34,1739,2149,3888,"Fort Polk South, LA",31.102841,-93.18833,48027
3315,22860,35-39,1616,1698,3314,"Fort Polk South, LA",31.102841,-93.18833,48027
3316,22860,40-44,1232,1408,2640,"Fort Polk South, LA",31.102841,-93.18833,48027
3317,22860,45-49,1123,1186,2309,"Fort Polk South, LA",31.102841,-93.18833,48027
3318,22860,50-54,1072,1146,2218,"Fort Polk South, LA",31.102841,-93.18833,48027
3319,22860,55-59,1122,1133,2255,"Fort Polk South, LA",31.102841,-93.18833,48027
3320,22860,60-64,1082,1059,2141,"Fort Polk South, LA",31.102841,-93.18833,48027
3321,22860,65+,3427,2819,6246,"Fort Polk South, LA",31.102841,-93.18833,48027
3322,22900,15-19,7797,8283,16080,"Fort Smith, AR-OK",35.463119,-94.299741,245459
3323,22900,20-24,7286,7607,14893,"Fort Smith, AR-OK",35.463119,-94.299741,245459
3324,22900,25-29,7791,7847,15638,"Fort Smith, AR-OK",35.463119,-94.299741,245459
3325,22900,30-34,7804,7807,15611,"Fort Smith, AR-OK",35.463119,-94.299741,245459
3326,22900,35-39,7575,7498,15073,"Fort Smith, AR-OK",35.463119,-94.299741,245459
3327,22900,40-44,7444,7310,14754,"Fort Smith, AR-OK",35.463119,-94.299741,245459
3328,22900,45-49,7345,7271,14616,"Fort Smith, AR-OK",35.463119,-94.299741,245459
3329,22900,50-54,7732,7645,15377,"Fort Smith, AR-OK",35.463119,-94.299741,245459
3330,22900,55-59,8210,8233,16443,"Fort Smith, AR-OK",35.463119,-94.299741,245459
3331,22900,60-64,8027,7889,15916,"Fort Smith, AR-OK",35.463119,-94.299741,245459
3332,22900,65+,23562,19303,42865,"Fort Smith, AR-OK",35.463119,-94.299741,245459
3333,23060,15-19,13970,14681,28651,"Fort Wayne, IN",41.113116,-85.217705,423038
3334,23060,20-24,13690,13561,27251,"Fort Wayne, IN",41.113116,-85.217705,423038
3335,23060,25-29,15135,15107,30242,"Fort Wayne, IN",41.113116,-85.217705,423038
3336,23060,30-34,14652,14193,28845,"Fort Wayne, IN",41.113116,-85.217705,423038
3337,23060,35-39,13818,13566,27384,"Fort Wayne, IN",41.113116,-85.217705,423038
3338,23060,40-44,13090,12917,26007,"Fort Wayne, IN",41.113116,-85.217705,423038
3339,23060,45-49,12104,12225,24329,"Fort Wayne, IN",41.113116,-85.217705,423038
3340,23060,50-54,12612,12716,25328,"Fort Wayne, IN",41.113116,-85.217705,423038
3341,23060,55-59,12693,12556,25249,"Fort Wayne, IN",41.113116,-85.217705,423038
3342,23060,60-64,13192,12319,25511,"Fort Wayne, IN",41.113116,-85.217705,423038
3343,23060,65+,36151,29401,65552,"Fort Wayne, IN",41.113116,-85.217705,423038
3344,23140,15-19,1134,1234,2368,"Frankfort, IN",40.305944,-86.477567,33065
3345,23140,20-24,915,990,1905,"Frankfort, IN",40.305944,-86.477567,33065
3346,23140,25-29,975,996,1971,"Frankfort, IN",40.305944,-86.477567,33065
3347,23140,30-34,987,1022,2009,"Frankfort, IN",40.305944,-86.477567,33065
3348,23140,35-39,971,1039,2010,"Frankfort, IN",40.305944,-86.477567,33065
3349,23140,40-44,940,982,1922,"Frankfort, IN",40.305944,-86.477567,33065
3350,23140,45-49,930,980,1910,"Frankfort, IN",40.305944,-86.477567,33065
3351,23140,50-54,913,1049,1962,"Frankfort, IN",40.305944,-86.477567,33065
3352,23140,55-59,1044,1034,2078,"Frankfort, IN",40.305944,-86.477567,33065
3353,23140,60-64,1117,1017,2134,"Frankfort, IN",40.305944,-86.477567,33065
3354,23140,65+,3081,2547,5628,"Frankfort, IN",40.305944,-86.477567,33065
3355,23180,15-19,2470,2518,4988,"Frankfort, KY",38.121449,-84.933167,75717
3356,23180,20-24,2206,2151,4357,"Frankfort, KY",38.121449,-84.933167,75717
3357,23180,25-29,2362,2465,4827,"Frankfort, KY",38.121449,-84.933167,75717
3358,23180,30-34,2424,2270,4694,"Frankfort, KY",38.121449,-84.933167,75717
3359,23180,35-39,2332,2264,4596,"Frankfort, KY",38.121449,-84.933167,75717
3360,23180,40-44,2390,2316,4706,"Frankfort, KY",38.121449,-84.933167,75717
3361,23180,45-49,2518,2442,4960,"Frankfort, KY",38.121449,-84.933167,75717
3362,23180,50-54,2553,2644,5197,"Frankfort, KY",38.121449,-84.933167,75717
3363,23180,55-59,2836,2580,5416,"Frankfort, KY",38.121449,-84.933167,75717
3364,23180,60-64,2644,2406,5050,"Frankfort, KY",38.121449,-84.933167,75717
3365,23180,65+,7463,6042,13505,"Frankfort, KY",38.121449,-84.933167,75717
3366,23240,15-19,709,819,1528,"Fredericksburg, TX",30.325093,-98.94185,27297
3367,23240,20-24,625,693,1318,"Fredericksburg, TX",30.325093,-98.94185,27297
3368,23240,25-29,632,630,1262,"Fredericksburg, TX",30.325093,-98.94185,27297
3369,23240,30-34,589,582,1171,"Fredericksburg, TX",30.325093,-98.94185,27297
3370,23240,35-39,684,668,1352,"Fredericksburg, TX",30.325093,-98.94185,27297
3371,23240,40-44,713,653,1366,"Fredericksburg, TX",30.325093,-98.94185,27297
3372,23240,45-49,678,646,1324,"Fredericksburg, TX",30.325093,-98.94185,27297
3373,23240,50-54,792,687,1479,"Fredericksburg, TX",30.325093,-98.94185,27297
3374,23240,55-59,954,891,1845,"Fredericksburg, TX",30.325093,-98.94185,27297
3375,23240,60-64,1173,1058,2231,"Fredericksburg, TX",30.325093,-98.94185,27297
3376,23240,65+,4261,3746,8007,"Fredericksburg, TX",30.325093,-98.94185,27297
3377,23300,15-19,1260,1356,2616,"Freeport, IL",42.349726,-89.665994,44021
3378,23300,20-24,1139,1171,2310,"Freeport, IL",42.349726,-89.665994,44021
3379,23300,25-29,1166,1140,2306,"Freeport, IL",42.349726,-89.665994,44021
3380,23300,30-34,1140,1137,2277,"Freeport, IL",42.349726,-89.665994,44021
3381,23300,35-39,1217,1170,2387,"Freeport, IL",42.349726,-89.665994,44021
3382,23300,40-44,1165,1178,2343,"Freeport, IL",42.349726,-89.665994,44021
3383,23300,45-49,1155,1147,2302,"Freeport, IL",42.349726,-89.665994,44021
3384,23300,50-54,1379,1393,2772,"Freeport, IL",42.349726,-89.665994,44021
3385,23300,55-59,1621,1571,3192,"Freeport, IL",42.349726,-89.665994,44021
3386,23300,60-64,1723,1705,3428,"Freeport, IL",42.349726,-89.665994,44021
3387,23300,65+,5735,4679,10414,"Freeport, IL",42.349726,-89.665994,44021
3388,23340,15-19,1307,1370,2677,"Fremont, NE",41.577008,-96.645852,37103
3389,23340,20-24,1165,1250,2415,"Fremont, NE",41.577008,-96.645852,37103
3390,23340,25-29,1015,1080,2095,"Fremont, NE",41.577008,-96.645852,37103
3391,23340,30-34,971,1071,2042,"Fremont, NE",41.577008,-96.645852,37103
3392,23340,35-39,1061,1111,2172,"Fremont, NE",41.577008,-96.645852,37103
3393,23340,40-44,1053,1160,2213,"Fremont, NE",41.577008,-96.645852,37103
3394,23340,45-49,947,980,1927,"Fremont, NE",41.577008,-96.645852,37103
3395,23340,50-54,1004,1107,2111,"Fremont, NE",41.577008,-96.645852,37103
3396,23340,55-59,1209,1200,2409,"Fremont, NE",41.577008,-96.645852,37103
3397,23340,60-64,1244,1226,2470,"Fremont, NE",41.577008,-96.645852,37103
3398,23340,65+,3860,3184,7044,"Fremont, NE",41.577008,-96.645852,37103
3399,23380,15-19,1733,1910,3643,"Fremont, OH",41.355319,-83.142776,58715
3400,23380,20-24,1550,1660,3210,"Fremont, OH",41.355319,-83.142776,58715
3401,23380,25-29,1696,1667,3363,"Fremont, OH",41.355319,-83.142776,58715
3402,23380,30-34,1698,1742,3440,"Fremont, OH",41.355319,-83.142776,58715
3403,23380,35-39,1754,1797,3551,"Fremont, OH",41.355319,-83.142776,58715
3404,23380,40-44,1742,1850,3592,"Fremont, OH",41.355319,-83.142776,58715
3405,23380,45-49,1671,1733,3404,"Fremont, OH",41.355319,-83.142776,58715
3406,23380,50-54,1834,1940,3774,"Fremont, OH",41.355319,-83.142776,58715
3407,23380,55-59,2063,2095,4158,"Fremont, OH",41.355319,-83.142776,58715
3408,23380,60-64,2192,2238,4430,"Fremont, OH",41.355319,-83.142776,58715
3409,23380,65+,6315,5297,11612,"Fremont, OH",41.355319,-83.142776,58715
3410,23420,15-19,37438,39172,76610,"Fresno, CA",36.761006,-119.655019,1013581
3411,23420,20-24,34064,35010,69074,"Fresno, CA",36.761006,-119.655019,1013581
3412,23420,25-29,36735,38231,74966,"Fresno, CA",36.761006,-119.655019,1013581
3413,23420,30-34,37810,39503,77313,"Fresno, CA",36.761006,-119.655019,1013581
3414,23420,35-39,34446,36528,70974,"Fresno, CA",36.761006,-119.655019,1013581
3415,23420,40-44,31424,32546,63970,"Fresno, CA",36.761006,-119.655019,1013581
3416,23420,45-49,27536,28666,56202,"Fresno, CA",36.761006,-119.655019,1013581
3417,23420,50-54,27024,27824,54848,"Fresno, CA",36.761006,-119.655019,1013581
3418,23420,55-59,27107,26944,54051,"Fresno, CA",36.761006,-119.655019,1013581
3419,23420,60-64,25813,25032,50845,"Fresno, CA",36.761006,-119.655019,1013581
3420,23420,65+,69832,57953,127785,"Fresno, CA",36.761006,-119.655019,1013581
3421,23460,15-19,2934,3200,6134,"Gadsden, AL",34.047641,-86.034263,103162
3422,23460,20-24,2984,3059,6043,"Gadsden, AL",34.047641,-86.034263,103162
3423,23460,25-29,3223,3163,6386,"Gadsden, AL",34.047641,-86.034263,103162
3424,23460,30-34,3278,2995,6273,"Gadsden, AL",34.047641,-86.034263,103162
3425,23460,35-39,3149,2957,6106,"Gadsden, AL",34.047641,-86.034263,103162
3426,23460,40-44,3238,2950,6188,"Gadsden, AL",34.047641,-86.034263,103162
3427,23460,45-49,3340,3248,6588,"Gadsden, AL",34.047641,-86.034263,103162
3428,23460,50-54,3559,3523,7082,"Gadsden, AL",34.047641,-86.034263,103162
3429,23460,55-59,3487,3328,6815,"Gadsden, AL",34.047641,-86.034263,103162
3430,23460,60-64,3708,3460,7168,"Gadsden, AL",34.047641,-86.034263,103162
3431,23460,65+,11177,8780,19957,"Gadsden, AL",34.047641,-86.034263,103162
3432,23500,15-19,1812,1975,3787,"Gaffney, SC",35.049796,-81.607647,56052
3433,23500,20-24,1688,1759,3447,"Gaffney, SC",35.049796,-81.607647,56052
3434,23500,25-29,1837,1740,3577,"Gaffney, SC",35.049796,-81.607647,56052
3435,23500,30-34,1903,1811,3714,"Gaffney, SC",35.049796,-81.607647,56052
3436,23500,35-39,1596,1504,3100,"Gaffney, SC",35.049796,-81.607647,56052
3437,23500,40-44,1719,1527,3246,"Gaffney, SC",35.049796,-81.607647,56052
3438,23500,45-49,1837,1708,3545,"Gaffney, SC",35.049796,-81.607647,56052
3439,23500,50-54,1937,1959,3896,"Gaffney, SC",35.049796,-81.607647,56052
3440,23500,55-59,1903,1947,3850,"Gaffney, SC",35.049796,-81.607647,56052
3441,23500,60-64,1850,1789,3639,"Gaffney, SC",35.049796,-81.607647,56052
3442,23500,65+,5379,4351,9730,"Gaffney, SC",35.049796,-81.607647,56052
3443,23540,15-19,13380,12615,25995,"Gainesville, FL",29.453355,-82.666257,341756
3444,23540,20-24,22864,22045,44909,"Gainesville, FL",29.453355,-82.666257,341756
3445,23540,25-29,12456,12458,24914,"Gainesville, FL",29.453355,-82.666257,341756
3446,23540,30-34,11864,11558,23422,"Gainesville, FL",29.453355,-82.666257,341756
3447,23540,35-39,10352,10128,20480,"Gainesville, FL",29.453355,-82.666257,341756
3448,23540,40-44,9595,9263,18858,"Gainesville, FL",29.453355,-82.666257,341756
3449,23540,45-49,8485,8314,16799,"Gainesville, FL",29.453355,-82.666257,341756
3450,23540,50-54,8830,8578,17408,"Gainesville, FL",29.453355,-82.666257,341756
3451,23540,55-59,9785,9011,18796,"Gainesville, FL",29.453355,-82.666257,341756
3452,23540,60-64,10732,9229,19961,"Gainesville, FL",29.453355,-82.666257,341756
3453,23540,65+,31437,26114,57551,"Gainesville, FL",29.453355,-82.666257,341756
3454,23580,15-19,7150,7694,14844,"Gainesville, GA",34.317569,-83.8185,207369
3455,23580,20-24,6884,6939,13823,"Gainesville, GA",34.317569,-83.8185,207369
3456,23580,25-29,6637,6791,13428,"Gainesville, GA",34.317569,-83.8185,207369
3457,23580,30-34,6439,6785,13224,"Gainesville, GA",34.317569,-83.8185,207369
3458,23580,35-39,6306,6551,12857,"Gainesville, GA",34.317569,-83.8185,207369
3459,23580,40-44,6453,6471,12924,"Gainesville, GA",34.317569,-83.8185,207369
3460,23580,45-49,6462,6587,13049,"Gainesville, GA",34.317569,-83.8185,207369
3461,23580,50-54,6932,7184,14116,"Gainesville, GA",34.317569,-83.8185,207369
3462,23580,55-59,6687,6937,13624,"Gainesville, GA",34.317569,-83.8185,207369
3463,23580,60-64,6117,5823,11940,"Gainesville, GA",34.317569,-83.8185,207369
3464,23580,65+,17862,15011,32873,"Gainesville, GA",34.317569,-83.8185,207369
3465,23620,15-19,1220,1569,2789,"Gainesville, TX",33.639196,-97.210343,42244
3466,23620,20-24,1186,1175,2361,"Gainesville, TX",33.639196,-97.210343,42244
3467,23620,25-29,1229,1299,2528,"Gainesville, TX",33.639196,-97.210343,42244
3468,23620,30-34,1327,1277,2604,"Gainesville, TX",33.639196,-97.210343,42244
3469,23620,35-39,1266,1243,2509,"Gainesville, TX",33.639196,-97.210343,42244
3470,23620,40-44,1230,1229,2459,"Gainesville, TX",33.639196,-97.210343,42244
3471,23620,45-49,1143,1109,2252,"Gainesville, TX",33.639196,-97.210343,42244
3472,23620,50-54,1301,1233,2534,"Gainesville, TX",33.639196,-97.210343,42244
3473,23620,55-59,1471,1450,2921,"Gainesville, TX",33.639196,-97.210343,42244
3474,23620,60-64,1582,1485,3067,"Gainesville, TX",33.639196,-97.210343,42244
3475,23620,65+,4291,3810,8101,"Gainesville, TX",33.639196,-97.210343,42244
3476,23660,15-19,1559,1573,3132,"Galesburg, IL",40.930945,-90.213792,49268
3477,23660,20-24,1517,1786,3303,"Galesburg, IL",40.930945,-90.213792,49268
3478,23660,25-29,1211,1632,2843,"Galesburg, IL",40.930945,-90.213792,49268
3479,23660,30-34,1278,1629,2907,"Galesburg, IL",40.930945,-90.213792,49268
3480,23660,35-39,1263,1565,2828,"Galesburg, IL",40.930945,-90.213792,49268
3481,23660,40-44,1332,1601,2933,"Galesburg, IL",40.930945,-90.213792,49268
3482,23660,45-49,1246,1460,2706,"Galesburg, IL",40.930945,-90.213792,49268
3483,23660,50-54,1367,1475,2842,"Galesburg, IL",40.930945,-90.213792,49268
3484,23660,55-59,1651,1607,3258,"Galesburg, IL",40.930945,-90.213792,49268
3485,23660,60-64,1750,1709,3459,"Galesburg, IL",40.930945,-90.213792,49268
3486,23660,65+,5969,4961,10930,"Galesburg, IL",40.930945,-90.213792,49268
3487,23700,15-19,2814,2897,5711,"Gallup, NM",35.584062,-108.253294,71780
3488,23700,20-24,2326,2240,4566,"Gallup, NM",35.584062,-108.253294,71780
3489,23700,25-29,2557,2500,5057,"Gallup, NM",35.584062,-108.253294,71780
3490,23700,30-34,2742,2751,5493,"Gallup, NM",35.584062,-108.253294,71780
3491,23700,35-39,2347,2320,4667,"Gallup, NM",35.584062,-108.253294,71780
3492,23700,40-44,2150,2121,4271,"Gallup, NM",35.584062,-108.253294,71780
3493,23700,45-49,2070,1853,3923,"Gallup, NM",35.584062,-108.253294,71780
3494,23700,50-54,2021,1854,3875,"Gallup, NM",35.584062,-108.253294,71780
3495,23700,55-59,2268,1960,4228,"Gallup, NM",35.584062,-108.253294,71780
3496,23700,60-64,2155,1896,4051,"Gallup, NM",35.584062,-108.253294,71780
3497,23700,65+,5612,3912,9524,"Gallup, NM",35.584062,-108.253294,71780
3498,23780,15-19,1583,1831,3414,"Garden City, KS",38.025453,-100.970695,41998
3499,23780,20-24,1429,1590,3019,"Garden City, KS",38.025453,-100.970695,41998
3500,23780,25-29,1377,1557,2934,"Garden City, KS",38.025453,-100.970695,41998
3501,23780,30-34,1333,1509,2842,"Garden City, KS",38.025453,-100.970695,41998
3502,23780,35-39,1235,1405,2640,"Garden City, KS",38.025453,-100.970695,41998
3503,23780,40-44,1144,1334,2478,"Garden City, KS",38.025453,-100.970695,41998
3504,23780,45-49,1105,1135,2240,"Garden City, KS",38.025453,-100.970695,41998
3505,23780,50-54,1118,1172,2290,"Garden City, KS",38.025453,-100.970695,41998
3506,23780,55-59,1178,1217,2395,"Garden City, KS",38.025453,-100.970695,41998
3507,23780,60-64,1057,1111,2168,"Garden City, KS",38.025453,-100.970695,41998
3508,23780,65+,2697,2425,5122,"Garden City, KS",38.025453,-100.970695,41998
3509,23820,15-19,1116,1252,2368,"Gardnerville Ranchos, NV",38.905129,-119.609019,49870
3510,23820,20-24,855,1012,1867,"Gardnerville Ranchos, NV",38.905129,-119.609019,49870
3511,23820,25-29,973,1129,2102,"Gardnerville Ranchos, NV",38.905129,-119.609019,49870
3512,23820,30-34,1215,1305,2520,"Gardnerville Ranchos, NV",38.905129,-119.609019,49870
3513,23820,35-39,1249,1397,2646,"Gardnerville Ranchos, NV",38.905129,-119.609019,49870
3514,23820,40-44,1243,1299,2542,"Gardnerville Ranchos, NV",38.905129,-119.609019,49870
3515,23820,45-49,1181,1236,2417,"Gardnerville Ranchos, NV",38.905129,-119.609019,49870
3516,23820,50-54,1466,1422,2888,"Gardnerville Ranchos, NV",38.905129,-119.609019,49870
3517,23820,55-59,1968,1841,3809,"Gardnerville Ranchos, NV",38.905129,-119.609019,49870
3518,23820,60-64,2560,2376,4936,"Gardnerville Ranchos, NV",38.905129,-119.609019,49870
3519,23820,65+,7876,7736,15612,"Gardnerville Ranchos, NV",38.905129,-119.609019,49870
3520,23860,15-19,1604,1686,3290,"Georgetown, SC",33.417531,-79.296333,63921
3521,23860,20-24,1463,1612,3075,"Georgetown, SC",33.417531,-79.296333,63921
3522,23860,25-29,1437,1495,2932,"Georgetown, SC",33.417531,-79.296333,63921
3523,23860,30-34,1540,1451,2991,"Georgetown, SC",33.417531,-79.296333,63921
3524,23860,35-39,1483,1385,2868,"Georgetown, SC",33.417531,-79.296333,63921
3525,23860,40-44,1722,1410,3132,"Georgetown, SC",33.417531,-79.296333,63921
3526,23860,45-49,1762,1510,3272,"Georgetown, SC",33.417531,-79.296333,63921
3527,23860,50-54,2137,1898,4035,"Georgetown, SC",33.417531,-79.296333,63921
3528,23860,55-59,2615,2145,4760,"Georgetown, SC",33.417531,-79.296333,63921
3529,23860,60-64,3077,2556,5633,"Georgetown, SC",33.417531,-79.296333,63921
3530,23860,65+,10371,8729,19100,"Georgetown, SC",33.417531,-79.296333,63921
3531,23900,15-19,3347,3495,6842,"Gettysburg, PA",39.869471,-77.21773,104127
3532,23900,20-24,3233,3275,6508,"Gettysburg, PA",39.869471,-77.21773,104127
3533,23900,25-29,2713,2798,5511,"Gettysburg, PA",39.869471,-77.21773,104127
3534,23900,30-34,2932,2969,5901,"Gettysburg, PA",39.869471,-77.21773,104127
3535,23900,35-39,2834,2916,5750,"Gettysburg, PA",39.869471,-77.21773,104127
3536,23900,40-44,2737,2865,5602,"Gettysburg, PA",39.869471,-77.21773,104127
3537,23900,45-49,2896,2858,5754,"Gettysburg, PA",39.869471,-77.21773,104127
3538,23900,50-54,3576,3583,7159,"Gettysburg, PA",39.869471,-77.21773,104127
3539,23900,55-59,4030,3954,7984,"Gettysburg, PA",39.869471,-77.21773,104127
3540,23900,60-64,4057,4004,8061,"Gettysburg, PA",39.869471,-77.21773,104127
3541,23900,65+,12046,10344,22390,"Gettysburg, PA",39.869471,-77.21773,104127
3542,23940,15-19,1998,2144,4142,"Gillette, WY",44.2321,-105.034342,60461
3543,23940,20-24,1493,1681,3174,"Gillette, WY",44.2321,-105.034342,60461
3544,23940,25-29,1687,1833,3520,"Gillette, WY",44.2321,-105.034342,60461
3545,23940,30-34,2065,2085,4150,"Gillette, WY",44.2321,-105.034342,60461
3546,23940,35-39,2139,2464,4603,"Gillette, WY",44.2321,-105.034342,60461
3547,23940,40-44,1904,2195,4099,"Gillette, WY",44.2321,-105.034342,60461
3548,23940,45-49,1649,1727,3376,"Gillette, WY",44.2321,-105.034342,60461
3549,23940,50-54,1580,1748,3328,"Gillette, WY",44.2321,-105.034342,60461
3550,23940,55-59,1890,1934,3824,"Gillette, WY",44.2321,-105.034342,60461
3551,23940,60-64,2151,2359,4510,"Gillette, WY",44.2321,-105.034342,60461
3552,23940,65+,4446,4337,8783,"Gillette, WY",44.2321,-105.034342,60461
3553,23980,15-19,1647,1736,3383,"Glasgow, KY",36.967571,-85.815497,54893
3554,23980,20-24,1409,1492,2901,"Glasgow, KY",36.967571,-85.815497,54893
3555,23980,25-29,1632,1678,3310,"Glasgow, KY",36.967571,-85.815497,54893
3556,23980,30-34,1644,1637,3281,"Glasgow, KY",36.967571,-85.815497,54893
3557,23980,35-39,1675,1604,3279,"Glasgow, KY",36.967571,-85.815497,54893
3558,23980,40-44,1723,1700,3423,"Glasgow, KY",36.967571,-85.815497,54893
3559,23980,45-49,1670,1670,3340,"Glasgow, KY",36.967571,-85.815497,54893
3560,23980,50-54,1814,1718,3532,"Glasgow, KY",36.967571,-85.815497,54893
3561,23980,55-59,1947,1895,3842,"Glasgow, KY",36.967571,-85.815497,54893
3562,23980,60-64,1992,1829,3821,"Glasgow, KY",36.967571,-85.815497,54893
3563,23980,65+,5632,4403,10035,"Glasgow, KY",36.967571,-85.815497,54893
3564,24020,15-19,3044,3711,6755,"Glens Falls, NY",43.44045,-73.636757,126574
3565,24020,20-24,2953,3630,6583,"Glens Falls, NY",43.44045,-73.636757,126574
3566,24020,25-29,3474,3947,7421,"Glens Falls, NY",43.44045,-73.636757,126574
3567,24020,30-34,3741,4077,7818,"Glens Falls, NY",43.44045,-73.636757,126574
3568,24020,35-39,3731,3983,7714,"Glens Falls, NY",43.44045,-73.636757,126574
3569,24020,40-44,3392,3858,7250,"Glens Falls, NY",43.44045,-73.636757,126574
3570,24020,45-49,3429,3749,7178,"Glens Falls, NY",43.44045,-73.636757,126574
3571,24020,50-54,4420,4494,8914,"Glens Falls, NY",43.44045,-73.636757,126574
3572,24020,55-59,5181,4950,10131,"Glens Falls, NY",43.44045,-73.636757,126574
3573,24020,60-64,5201,5038,10239,"Glens Falls, NY",43.44045,-73.636757,126574
3574,24020,65+,14684,13290,27974,"Glens Falls, NY",43.44045,-73.636757,126574
3575,24060,15-19,2299,2601,4900,"Glenwood Springs, CO",39.509542,-107.667311,79509
3576,24060,20-24,2020,2162,4182,"Glenwood Springs, CO",39.509542,-107.667311,79509
3577,24060,25-29,2487,2813,5300,"Glenwood Springs, CO",39.509542,-107.667311,79509
3578,24060,30-34,2680,2915,5595,"Glenwood Springs, CO",39.509542,-107.667311,79509
3579,24060,35-39,2724,3046,5770,"Glenwood Springs, CO",39.509542,-107.667311,79509
3580,24060,40-44,2642,2838,5480,"Glenwood Springs, CO",39.509542,-107.667311,79509
3581,24060,45-49,2397,2617,5014,"Glenwood Springs, CO",39.509542,-107.667311,79509
3582,24060,50-54,2528,2791,5319,"Glenwood Springs, CO",39.509542,-107.667311,79509
3583,24060,55-59,2444,2606,5050,"Glenwood Springs, CO",39.509542,-107.667311,79509
3584,24060,60-64,2695,2702,5397,"Glenwood Springs, CO",39.509542,-107.667311,79509
3585,24060,65+,6356,6417,12773,"Glenwood Springs, CO",39.509542,-107.667311,79509
3586,24100,15-19,1444,1520,2964,"Gloversville, NY",43.115609,-74.423678,53116
3587,24100,20-24,1349,1455,2804,"Gloversville, NY",43.115609,-74.423678,53116
3588,24100,25-29,1426,1604,3030,"Gloversville, NY",43.115609,-74.423678,53116
3589,24100,30-34,1547,1661,3208,"Gloversville, NY",43.115609,-74.423678,53116
3590,24100,35-39,1647,1648,3295,"Gloversville, NY",43.115609,-74.423678,53116
3591,24100,40-44,1586,1641,3227,"Gloversville, NY",43.115609,-74.423678,53116
3592,24100,45-49,1521,1574,3095,"Gloversville, NY",43.115609,-74.423678,53116
3593,24100,50-54,1805,1915,3720,"Gloversville, NY",43.115609,-74.423678,53116
3594,24100,55-59,2021,2083,4104,"Gloversville, NY",43.115609,-74.423678,53116
3595,24100,60-64,2062,2038,4100,"Gloversville, NY",43.115609,-74.423678,53116
3596,24100,65+,5898,4961,10859,"Gloversville, NY",43.115609,-74.423678,53116
3597,24140,15-19,3772,3953,7725,"Goldsboro, NC",35.35419,-78.00867,116835
3598,24140,20-24,3764,4542,8306,"Goldsboro, NC",35.35419,-78.00867,116835
3599,24140,25-29,3860,4200,8060,"Goldsboro, NC",35.35419,-78.00867,116835
3600,24140,30-34,3853,3814,7667,"Goldsboro, NC",35.35419,-78.00867,116835
3601,24140,35-39,3520,3432,6952,"Goldsboro, NC",35.35419,-78.00867,116835
3602,24140,40-44,3337,3170,6507,"Goldsboro, NC",35.35419,-78.00867,116835
3603,24140,45-49,3433,3102,6535,"Goldsboro, NC",35.35419,-78.00867,116835
3604,24140,50-54,3602,3365,6967,"Goldsboro, NC",35.35419,-78.00867,116835
3605,24140,55-59,3779,3792,7571,"Goldsboro, NC",35.35419,-78.00867,116835
3606,24140,60-64,3943,3500,7443,"Goldsboro, NC",35.35419,-78.00867,116835
3607,24140,65+,11237,8764,20001,"Goldsboro, NC",35.35419,-78.00867,116835
3608,24180,15-19,1796,1892,3688,"Granbury, TX",32.430149,-97.831677,64222
3609,24180,20-24,1478,1506,2984,"Granbury, TX",32.430149,-97.831677,64222
3610,24180,25-29,1633,1582,3215,"Granbury, TX",32.430149,-97.831677,64222
3611,24180,30-34,1755,1670,3425,"Granbury, TX",32.430149,-97.831677,64222
3612,24180,35-39,1834,1817,3651,"Granbury, TX",32.430149,-97.831677,64222
3613,24180,40-44,1727,1763,3490,"Granbury, TX",32.430149,-97.831677,64222
3614,24180,45-49,1636,1594,3230,"Granbury, TX",32.430149,-97.831677,64222
3615,24180,50-54,1960,1839,3799,"Granbury, TX",32.430149,-97.831677,64222
3616,24180,55-59,2351,2166,4517,"Granbury, TX",32.430149,-97.831677,64222
3617,24180,60-64,2712,2484,5196,"Granbury, TX",32.430149,-97.831677,64222
3618,24180,65+,8577,7681,16258,"Granbury, TX",32.430149,-97.831677,64222
3619,24220,15-19,3582,3871,7453,"Grand Forks, ND-MN",47.835929,-96.842681,103462
3620,24220,20-24,5935,6567,12502,"Grand Forks, ND-MN",47.835929,-96.842681,103462
3621,24220,25-29,3380,4183,7563,"Grand Forks, ND-MN",47.835929,-96.842681,103462
3622,24220,30-34,3254,3820,7074,"Grand Forks, ND-MN",47.835929,-96.842681,103462
3623,24220,35-39,3151,3526,6677,"Grand Forks, ND-MN",47.835929,-96.842681,103462
3624,24220,40-44,2601,2990,5591,"Grand Forks, ND-MN",47.835929,-96.842681,103462
3625,24220,45-49,2240,2483,4723,"Grand Forks, ND-MN",47.835929,-96.842681,103462
3626,24220,50-54,2383,2484,4867,"Grand Forks, ND-MN",47.835929,-96.842681,103462
3627,24220,55-59,2765,2831,5596,"Grand Forks, ND-MN",47.835929,-96.842681,103462
3628,24220,60-64,2985,2976,5961,"Grand Forks, ND-MN",47.835929,-96.842681,103462
3629,24220,65+,8548,7222,15770,"Grand Forks, ND-MN",47.835929,-96.842681,103462
3630,24260,15-19,2546,2833,5379,"Grand Island, NE",41.083926,-98.374218,76175
3631,24260,20-24,2046,2116,4162,"Grand Island, NE",41.083926,-98.374218,76175
3632,24260,25-29,2222,2392,4614,"Grand Island, NE",41.083926,-98.374218,76175
3633,24260,30-34,2241,2466,4707,"Grand Island, NE",41.083926,-98.374218,76175
3634,24260,35-39,2425,2528,4953,"Grand Island, NE",41.083926,-98.374218,76175
3635,24260,40-44,2271,2411,4682,"Grand Island, NE",41.083926,-98.374218,76175
3636,24260,45-49,2082,2238,4320,"Grand Island, NE",41.083926,-98.374218,76175
3637,24260,50-54,2100,2272,4372,"Grand Island, NE",41.083926,-98.374218,76175
3638,24260,55-59,2393,2486,4879,"Grand Island, NE",41.083926,-98.374218,76175
3639,24260,60-64,2315,2429,4744,"Grand Island, NE",41.083926,-98.374218,76175
3640,24260,65+,6737,5844,12581,"Grand Island, NE",41.083926,-98.374218,76175
3641,24300,15-19,5045,5440,10485,"Grand Junction, CO",39.019524,-108.460571,157335
3642,24300,20-24,4464,4598,9062,"Grand Junction, CO",39.019524,-108.460571,157335
3643,24300,25-29,4828,5074,9902,"Grand Junction, CO",39.019524,-108.460571,157335
3644,24300,30-34,5201,5196,10397,"Grand Junction, CO",39.019524,-108.460571,157335
3645,24300,35-39,5047,5448,10495,"Grand Junction, CO",39.019524,-108.460571,157335
3646,24300,40-44,4877,5020,9897,"Grand Junction, CO",39.019524,-108.460571,157335
3647,24300,45-49,4125,4282,8407,"Grand Junction, CO",39.019524,-108.460571,157335
3648,24300,50-54,4211,4284,8495,"Grand Junction, CO",39.019524,-108.460571,157335
3649,24300,55-59,5098,4655,9753,"Grand Junction, CO",39.019524,-108.460571,157335
3650,24300,60-64,5915,5409,11324,"Grand Junction, CO",39.019524,-108.460571,157335
3651,24300,65+,17229,15007,32236,"Grand Junction, CO",39.019524,-108.460571,157335
3652,24330,15-19,1303,1400,2703,"Grand Rapids, MN",47.490817,-93.611102,45070
3653,24330,20-24,989,1119,2108,"Grand Rapids, MN",47.490817,-93.611102,45070
3654,24330,25-29,1032,1054,2086,"Grand Rapids, MN",47.490817,-93.611102,45070
3655,24330,30-34,1064,1163,2227,"Grand Rapids, MN",47.490817,-93.611102,45070
3656,24330,35-39,1265,1253,2518,"Grand Rapids, MN",47.490817,-93.611102,45070
3657,24330,40-44,1253,1379,2632,"Grand Rapids, MN",47.490817,-93.611102,45070
3658,24330,45-49,1169,1219,2388,"Grand Rapids, MN",47.490817,-93.611102,45070
3659,24330,50-54,1330,1346,2676,"Grand Rapids, MN",47.490817,-93.611102,45070
3660,24330,55-59,1600,1609,3209,"Grand Rapids, MN",47.490817,-93.611102,45070
3661,24330,60-64,1888,1904,3792,"Grand Rapids, MN",47.490817,-93.611102,45070
3662,24330,65+,5728,5519,11247,"Grand Rapids, MN",47.490817,-93.611102,45070
3663,24340,15-19,37909,38564,76473,"Grand Rapids-Kentwood, MI",43.037598,-85.778167,1091620
3664,24340,20-24,38700,39838,78538,"Grand Rapids-Kentwood, MI",43.037598,-85.778167,1091620
3665,24340,25-29,38742,41072,79814,"Grand Rapids-Kentwood, MI",43.037598,-85.778167,1091620
3666,24340,30-34,38652,39985,78637,"Grand Rapids-Kentwood, MI",43.037598,-85.778167,1091620
3667,24340,35-39,36195,37648,73843,"Grand Rapids-Kentwood, MI",43.037598,-85.778167,1091620
3668,24340,40-44,33257,34738,67995,"Grand Rapids-Kentwood, MI",43.037598,-85.778167,1091620
3669,24340,45-49,29578,30789,60367,"Grand Rapids-Kentwood, MI",43.037598,-85.778167,1091620
3670,24340,50-54,31889,32932,64821,"Grand Rapids-Kentwood, MI",43.037598,-85.778167,1091620
3671,24340,55-59,33724,33856,67580,"Grand Rapids-Kentwood, MI",43.037598,-85.778167,1091620
3672,24340,60-64,33792,33164,66956,"Grand Rapids-Kentwood, MI",43.037598,-85.778167,1091620
3673,24340,65+,90101,76049,166150,"Grand Rapids-Kentwood, MI",43.037598,-85.778167,1091620
3674,24380,15-19,854,847,1701,"Grants, NM",34.928272,-107.99268,27184
3675,24380,20-24,802,884,1686,"Grants, NM",34.928272,-107.99268,27184
3676,24380,25-29,845,1089,1934,"Grants, NM",34.928272,-107.99268,27184
3677,24380,30-34,933,1098,2031,"Grants, NM",34.928272,-107.99268,27184
3678,24380,35-39,780,1020,1800,"Grants, NM",34.928272,-107.99268,27184
3679,24380,40-44,802,1018,1820,"Grants, NM",34.928272,-107.99268,27184
3680,24380,45-49,662,831,1493,"Grants, NM",34.928272,-107.99268,27184
3681,24380,50-54,727,812,1539,"Grants, NM",34.928272,-107.99268,27184
3682,24380,55-59,775,769,1544,"Grants, NM",34.928272,-107.99268,27184
3683,24380,60-64,918,861,1779,"Grants, NM",34.928272,-107.99268,27184
3684,24380,65+,2506,2111,4617,"Grants, NM",34.928272,-107.99268,27184
3685,24420,15-19,2191,2507,4698,"Grants Pass, OR",42.386983,-123.57162,88346
3686,24420,20-24,1907,2055,3962,"Grants Pass, OR",42.386983,-123.57162,88346
3687,24420,25-29,2343,2446,4789,"Grants Pass, OR",42.386983,-123.57162,88346
3688,24420,30-34,2546,2558,5104,"Grants Pass, OR",42.386983,-123.57162,88346
3689,24420,35-39,2391,2480,4871,"Grants Pass, OR",42.386983,-123.57162,88346
3690,24420,40-44,2492,2408,4900,"Grants Pass, OR",42.386983,-123.57162,88346
3691,24420,45-49,2257,2300,4557,"Grants Pass, OR",42.386983,-123.57162,88346
3692,24420,50-54,2617,2467,5084,"Grants Pass, OR",42.386983,-123.57162,88346
3693,24420,55-59,3099,2818,5917,"Grants Pass, OR",42.386983,-123.57162,88346
3694,24420,60-64,3781,3297,7078,"Grants Pass, OR",42.386983,-123.57162,88346
3695,24420,65+,12601,10807,23408,"Grants Pass, OR",42.386983,-123.57162,88346
3696,24460,15-19,857,900,1757,"Great Bend, KS",38.481239,-98.767837,25216
3697,24460,20-24,699,723,1422,"Great Bend, KS",38.481239,-98.767837,25216
3698,24460,25-29,711,717,1428,"Great Bend, KS",38.481239,-98.767837,25216
3699,24460,30-34,753,697,1450,"Great Bend, KS",38.481239,-98.767837,25216
3700,24460,35-39,761,802,1563,"Great Bend, KS",38.481239,-98.767837,25216
3701,24460,40-44,693,771,1464,"Great Bend, KS",38.481239,-98.767837,25216
3702,24460,45-49,571,570,1141,"Great Bend, KS",38.481239,-98.767837,25216
3703,24460,50-54,654,645,1299,"Great Bend, KS",38.481239,-98.767837,25216
3704,24460,55-59,836,890,1726,"Great Bend, KS",38.481239,-98.767837,25216
3705,24460,60-64,969,931,1900,"Great Bend, KS",38.481239,-98.767837,25216
3706,24460,65+,2732,2343,5075,"Great Bend, KS",38.481239,-98.767837,25216
3707,24500,15-19,2298,2660,4958,"Great Falls, MT",47.316575,-111.350262,84511
3708,24500,20-24,2482,3238,5720,"Great Falls, MT",47.316575,-111.350262,84511
3709,24500,25-29,2820,3173,5993,"Great Falls, MT",47.316575,-111.350262,84511
3710,24500,30-34,2853,2991,5844,"Great Falls, MT",47.316575,-111.350262,84511
3711,24500,35-39,2613,2835,5448,"Great Falls, MT",47.316575,-111.350262,84511
3712,24500,40-44,2324,2474,4798,"Great Falls, MT",47.316575,-111.350262,84511
3713,24500,45-49,1986,2098,4084,"Great Falls, MT",47.316575,-111.350262,84511
3714,24500,50-54,2171,2249,4420,"Great Falls, MT",47.316575,-111.350262,84511
3715,24500,55-59,2630,2575,5205,"Great Falls, MT",47.316575,-111.350262,84511
3716,24500,60-64,2919,2772,5691,"Great Falls, MT",47.316575,-111.350262,84511
3717,24500,65+,8768,7569,16337,"Great Falls, MT",47.316575,-111.350262,84511
3718,24540,15-19,12265,12323,24588,"Greeley, CO",40.555961,-104.383666,340036
3719,24540,20-24,10276,10446,20722,"Greeley, CO",40.555961,-104.383666,340036
3720,24540,25-29,11699,12199,23898,"Greeley, CO",40.555961,-104.383666,340036
3721,24540,30-34,13275,14199,27474,"Greeley, CO",40.555961,-104.383666,340036
3722,24540,35-39,12605,14108,26713,"Greeley, CO",40.555961,-104.383666,340036
3723,24540,40-44,10986,12161,23147,"Greeley, CO",40.555961,-104.383666,340036
3724,24540,45-49,9803,10844,20647,"Greeley, CO",40.555961,-104.383666,340036
3725,24540,50-54,9706,10326,20032,"Greeley, CO",40.555961,-104.383666,340036
3726,24540,55-59,9261,9560,18821,"Greeley, CO",40.555961,-104.383666,340036
3727,24540,60-64,9242,9306,18548,"Greeley, CO",40.555961,-104.383666,340036
3728,24540,65+,22783,20203,42986,"Greeley, CO",40.555961,-104.383666,340036
3729,24580,15-19,10785,10979,21764,"Green Bay, WI",44.474024,-87.99613,329490
3730,24580,20-24,9990,10117,20107,"Green Bay, WI",44.474024,-87.99613,329490
3731,24580,25-29,10078,10682,20760,"Green Bay, WI",44.474024,-87.99613,329490
3732,24580,30-34,10215,10725,20940,"Green Bay, WI",44.474024,-87.99613,329490
3733,24580,35-39,10522,11113,21635,"Green Bay, WI",44.474024,-87.99613,329490
3734,24580,40-44,10215,10835,21050,"Green Bay, WI",44.474024,-87.99613,329490
3735,24580,45-49,9181,9641,18822,"Green Bay, WI",44.474024,-87.99613,329490
3736,24580,50-54,10245,10595,20840,"Green Bay, WI",44.474024,-87.99613,329490
3737,24580,55-59,11752,11755,23507,"Green Bay, WI",44.474024,-87.99613,329490
3738,24580,60-64,11336,11438,22774,"Green Bay, WI",44.474024,-87.99613,329490
3739,24580,65+,29571,26078,55649,"Green Bay, WI",44.474024,-87.99613,329490
3740,24620,15-19,2004,2225,4229,"Greeneville, TN",36.179487,-82.847523,70621
3741,24620,20-24,1864,2008,3872,"Greeneville, TN",36.179487,-82.847523,70621
3742,24620,25-29,1919,2088,4007,"Greeneville, TN",36.179487,-82.847523,70621
3743,24620,30-34,1953,1956,3909,"Greeneville, TN",36.179487,-82.847523,70621
3744,24620,35-39,1889,1814,3703,"Greeneville, TN",36.179487,-82.847523,70621
3745,24620,40-44,2074,2109,4183,"Greeneville, TN",36.179487,-82.847523,70621
3746,24620,45-49,2206,2237,4443,"Greeneville, TN",36.179487,-82.847523,70621
3747,24620,50-54,2509,2499,5008,"Greeneville, TN",36.179487,-82.847523,70621
3748,24620,55-59,2795,2559,5354,"Greeneville, TN",36.179487,-82.847523,70621
3749,24620,60-64,2704,2634,5338,"Greeneville, TN",36.179487,-82.847523,70621
3750,24620,65+,8500,7227,15727,"Greeneville, TN",36.179487,-82.847523,70621
3751,24660,15-19,28793,27464,56257,"Greensboro-High Point, NC",36.025204,-79.792633,778848
3752,24660,20-24,26588,25113,51701,"Greensboro-High Point, NC",36.025204,-79.792633,778848
3753,24660,25-29,25901,24643,50544,"Greensboro-High Point, NC",36.025204,-79.792633,778848
3754,24660,30-34,26846,24205,51051,"Greensboro-High Point, NC",36.025204,-79.792633,778848
3755,24660,35-39,24404,22227,46631,"Greensboro-High Point, NC",36.025204,-79.792633,778848
3756,24660,40-44,24464,22385,46849,"Greensboro-High Point, NC",36.025204,-79.792633,778848
3757,24660,45-49,24653,22686,47339,"Greensboro-High Point, NC",36.025204,-79.792633,778848
3758,24660,50-54,27333,26075,53408,"Greensboro-High Point, NC",36.025204,-79.792633,778848
3759,24660,55-59,27083,25610,52693,"Greensboro-High Point, NC",36.025204,-79.792633,778848
3760,24660,60-64,26063,24420,50483,"Greensboro-High Point, NC",36.025204,-79.792633,778848
3761,24660,65+,73871,58074,131945,"Greensboro-High Point, NC",36.025204,-79.792633,778848
3762,24700,15-19,849,847,1696,"Greensburg, IN",39.30598,-85.499831,26320
3763,24700,20-24,729,864,1593,"Greensburg, IN",39.30598,-85.499831,26320
3764,24700,25-29,827,808,1635,"Greensburg, IN",39.30598,-85.499831,26320
3765,24700,30-34,787,820,1607,"Greensburg, IN",39.30598,-85.499831,26320
3766,24700,35-39,771,794,1565,"Greensburg, IN",39.30598,-85.499831,26320
3767,24700,40-44,806,819,1625,"Greensburg, IN",39.30598,-85.499831,26320
3768,24700,45-49,769,815,1584,"Greensburg, IN",39.30598,-85.499831,26320
3769,24700,50-54,816,874,1690,"Greensburg, IN",39.30598,-85.499831,26320
3770,24700,55-59,905,922,1827,"Greensburg, IN",39.30598,-85.499831,26320
3771,24700,60-64,900,959,1859,"Greensburg, IN",39.30598,-85.499831,26320
3772,24700,65+,2483,2035,4518,"Greensburg, IN",39.30598,-85.499831,26320
3773,24740,15-19,1452,1418,2870,"Greenville, MS",33.273174,-90.944446,43687
3774,24740,20-24,1328,1274,2602,"Greenville, MS",33.273174,-90.944446,43687
3775,24740,25-29,1456,1352,2808,"Greenville, MS",33.273174,-90.944446,43687
3776,24740,30-34,1351,1152,2503,"Greenville, MS",33.273174,-90.944446,43687
3777,24740,35-39,1331,1137,2468,"Greenville, MS",33.273174,-90.944446,43687
3778,24740,40-44,1368,1109,2477,"Greenville, MS",33.273174,-90.944446,43687
3779,24740,45-49,1359,1024,2383,"Greenville, MS",33.273174,-90.944446,43687
3780,24740,50-54,1460,1195,2655,"Greenville, MS",33.273174,-90.944446,43687
3781,24740,55-59,1527,1341,2868,"Greenville, MS",33.273174,-90.944446,43687
3782,24740,60-64,1704,1394,3098,"Greenville, MS",33.273174,-90.944446,43687
3783,24740,65+,4413,3172,7585,"Greenville, MS",33.273174,-90.944446,43687
3784,24780,15-19,7613,6964,14577,"Greenville, NC",35.59249,-77.372739,172169
3785,24780,20-24,11605,9952,21557,"Greenville, NC",35.59249,-77.372739,172169
3786,24780,25-29,6526,5813,12339,"Greenville, NC",35.59249,-77.372739,172169
3787,24780,30-34,5814,5404,11218,"Greenville, NC",35.59249,-77.372739,172169
3788,24780,35-39,5408,4698,10106,"Greenville, NC",35.59249,-77.372739,172169
3789,24780,40-44,5341,4700,10041,"Greenville, NC",35.59249,-77.372739,172169
3790,24780,45-49,4910,4267,9177,"Greenville, NC",35.59249,-77.372739,172169
3791,24780,50-54,5011,4495,9506,"Greenville, NC",35.59249,-77.372739,172169
3792,24780,55-59,5069,4307,9376,"Greenville, NC",35.59249,-77.372739,172169
3793,24780,60-64,5168,4306,9474,"Greenville, NC",35.59249,-77.372739,172169
3794,24780,65+,13992,10610,24602,"Greenville, NC",35.59249,-77.372739,172169
3795,24820,15-19,1635,1718,3353,"Greenville, OH",40.131467,-84.621191,51597
3796,24820,20-24,1354,1473,2827,"Greenville, OH",40.131467,-84.621191,51597
3797,24820,25-29,1368,1503,2871,"Greenville, OH",40.131467,-84.621191,51597
3798,24820,30-34,1373,1432,2805,"Greenville, OH",40.131467,-84.621191,51597
3799,24820,35-39,1376,1408,2784,"Greenville, OH",40.131467,-84.621191,51597
3800,24820,40-44,1514,1541,3055,"Greenville, OH",40.131467,-84.621191,51597
3801,24820,45-49,1388,1473,2861,"Greenville, OH",40.131467,-84.621191,51597
3802,24820,50-54,1591,1678,3269,"Greenville, OH",40.131467,-84.621191,51597
3803,24820,55-59,1848,1813,3661,"Greenville, OH",40.131467,-84.621191,51597
3804,24820,60-64,1848,1861,3709,"Greenville, OH",40.131467,-84.621191,51597
3805,24820,65+,5601,4707,10308,"Greenville, OH",40.131467,-84.621191,51597
3806,24860,15-19,31242,31940,63182,"Greenville-Anderson, SC",34.683709,-82.413423,940774
3807,24860,20-24,32124,32529,64653,"Greenville-Anderson, SC",34.683709,-82.413423,940774
3808,24860,25-29,31120,30218,61338,"Greenville-Anderson, SC",34.683709,-82.413423,940774
3809,24860,30-34,32271,30710,62981,"Greenville-Anderson, SC",34.683709,-82.413423,940774
3810,24860,35-39,29929,28840,58769,"Greenville-Anderson, SC",34.683709,-82.413423,940774
3811,24860,40-44,29381,28135,57516,"Greenville-Anderson, SC",34.683709,-82.413423,940774
3812,24860,45-49,28579,27578,56157,"Greenville-Anderson, SC",34.683709,-82.413423,940774
3813,24860,50-54,30765,29774,60539,"Greenville-Anderson, SC",34.683709,-82.413423,940774
3814,24860,55-59,31817,30156,61973,"Greenville-Anderson, SC",34.683709,-82.413423,940774
3815,24860,60-64,31321,28821,60142,"Greenville-Anderson, SC",34.683709,-82.413423,940774
3816,24860,65+,89406,72043,161449,"Greenville-Anderson, SC",34.683709,-82.413423,940774
3817,24900,15-19,1377,1359,2736,"Greenwood, MS",33.491305,-90.113633,37436
3818,24900,20-24,1243,1292,2535,"Greenwood, MS",33.491305,-90.113633,37436
3819,24900,25-29,1142,1132,2274,"Greenwood, MS",33.491305,-90.113633,37436
3820,24900,30-34,1080,1099,2179,"Greenwood, MS",33.491305,-90.113633,37436
3821,24900,35-39,1066,1010,2076,"Greenwood, MS",33.491305,-90.113633,37436
3822,24900,40-44,1176,1094,2270,"Greenwood, MS",33.491305,-90.113633,37436
3823,24900,45-49,1111,928,2039,"Greenwood, MS",33.491305,-90.113633,37436
3824,24900,50-54,1139,966,2105,"Greenwood, MS",33.491305,-90.113633,37436
3825,24900,55-59,1228,1136,2364,"Greenwood, MS",33.491305,-90.113633,37436
3826,24900,60-64,1341,1084,2425,"Greenwood, MS",33.491305,-90.113633,37436
3827,24900,65+,3742,2966,6708,"Greenwood, MS",33.491305,-90.113633,37436
3828,24940,15-19,2429,2238,4667,"Greenwood, SC",34.155796,-82.127876,69241
3829,24940,20-24,2298,2078,4376,"Greenwood, SC",34.155796,-82.127876,69241
3830,24940,25-29,2252,1983,4235,"Greenwood, SC",34.155796,-82.127876,69241
3831,24940,30-34,2431,1951,4382,"Greenwood, SC",34.155796,-82.127876,69241
3832,24940,35-39,2098,1897,3995,"Greenwood, SC",34.155796,-82.127876,69241
3833,24940,40-44,2063,1824,3887,"Greenwood, SC",34.155796,-82.127876,69241
3834,24940,45-49,2049,1847,3896,"Greenwood, SC",34.155796,-82.127876,69241
3835,24940,50-54,2300,2147,4447,"Greenwood, SC",34.155796,-82.127876,69241
3836,24940,55-59,2415,2163,4578,"Greenwood, SC",34.155796,-82.127876,69241
3837,24940,60-64,2372,2074,4446,"Greenwood, SC",34.155796,-82.127876,69241
3838,24940,65+,7449,5849,13298,"Greenwood, SC",34.155796,-82.127876,69241
3839,24980,15-19,675,718,1393,"Grenada, MS",33.770031,-89.80274,21365
3840,24980,20-24,591,576,1167,"Grenada, MS",33.770031,-89.80274,21365
3841,24980,25-29,702,674,1376,"Grenada, MS",33.770031,-89.80274,21365
3842,24980,30-34,737,611,1348,"Grenada, MS",33.770031,-89.80274,21365
3843,24980,35-39,633,575,1208,"Grenada, MS",33.770031,-89.80274,21365
3844,24980,40-44,657,596,1253,"Grenada, MS",33.770031,-89.80274,21365
3845,24980,45-49,657,572,1229,"Grenada, MS",33.770031,-89.80274,21365
3846,24980,50-54,736,660,1396,"Grenada, MS",33.770031,-89.80274,21365
3847,24980,55-59,735,688,1423,"Grenada, MS",33.770031,-89.80274,21365
3848,24980,60-64,724,680,1404,"Grenada, MS",33.770031,-89.80274,21365
3849,24980,65+,2230,1664,3894,"Grenada, MS",33.770031,-89.80274,21365
3850,25060,15-19,12992,14551,27543,"Gulfport-Biloxi, MS",30.480153,-88.999297,418082
3851,25060,20-24,12030,13180,25210,"Gulfport-Biloxi, MS",30.480153,-88.999297,418082
3852,25060,25-29,13617,13161,26778,"Gulfport-Biloxi, MS",30.480153,-88.999297,418082
3853,25060,30-34,14554,13373,27927,"Gulfport-Biloxi, MS",30.480153,-88.999297,418082
3854,25060,35-39,13930,12883,26813,"Gulfport-Biloxi, MS",30.480153,-88.999297,418082
3855,25060,40-44,13666,12661,26327,"Gulfport-Biloxi, MS",30.480153,-88.999297,418082
3856,25060,45-49,12713,11865,24578,"Gulfport-Biloxi, MS",30.480153,-88.999297,418082
3857,25060,50-54,13426,12913,26339,"Gulfport-Biloxi, MS",30.480153,-88.999297,418082
3858,25060,55-59,14617,13939,28556,"Gulfport-Biloxi, MS",30.480153,-88.999297,418082
3859,25060,60-64,14767,14085,28852,"Gulfport-Biloxi, MS",30.480153,-88.999297,418082
3860,25060,65+,38126,32221,70347,"Gulfport-Biloxi, MS",30.480153,-88.999297,418082
3861,25100,15-19,726,904,1630,"Guymon, OK",36.746317,-101.483855,20865
3862,25100,20-24,692,920,1612,"Guymon, OK",36.746317,-101.483855,20865
3863,25100,25-29,602,712,1314,"Guymon, OK",36.746317,-101.483855,20865
3864,25100,30-34,625,793,1418,"Guymon, OK",36.746317,-101.483855,20865
3865,25100,35-39,571,768,1339,"Guymon, OK",36.746317,-101.483855,20865
3866,25100,40-44,579,757,1336,"Guymon, OK",36.746317,-101.483855,20865
3867,25100,45-49,566,590,1156,"Guymon, OK",36.746317,-101.483855,20865
3868,25100,50-54,530,693,1223,"Guymon, OK",36.746317,-101.483855,20865
3869,25100,55-59,525,688,1213,"Guymon, OK",36.746317,-101.483855,20865
3870,25100,60-64,503,561,1064,"Guymon, OK",36.746317,-101.483855,20865
3871,25100,65+,1283,1270,2553,"Guymon, OK",36.746317,-101.483855,20865
3872,25180,15-19,8474,9349,17823,"Hagerstown-Martinsburg, MD-WV",39.554433,-77.984594,298227
3873,25180,20-24,7903,9049,16952,"Hagerstown-Martinsburg, MD-WV",39.554433,-77.984594,298227
3874,25180,25-29,9159,10333,19492,"Hagerstown-Martinsburg, MD-WV",39.554433,-77.984594,298227
3875,25180,30-34,9891,10647,20538,"Hagerstown-Martinsburg, MD-WV",39.554433,-77.984594,298227
3876,25180,35-39,9333,10264,19597,"Hagerstown-Martinsburg, MD-WV",39.554433,-77.984594,298227
3877,25180,40-44,9108,10021,19129,"Hagerstown-Martinsburg, MD-WV",39.554433,-77.984594,298227
3878,25180,45-49,8883,9534,18417,"Hagerstown-Martinsburg, MD-WV",39.554433,-77.984594,298227
3879,25180,50-54,10114,10596,20710,"Hagerstown-Martinsburg, MD-WV",39.554433,-77.984594,298227
3880,25180,55-59,10629,10658,21287,"Hagerstown-Martinsburg, MD-WV",39.554433,-77.984594,298227
3881,25180,60-64,9910,9971,19881,"Hagerstown-Martinsburg, MD-WV",39.554433,-77.984594,298227
3882,25180,65+,27325,23331,50656,"Hagerstown-Martinsburg, MD-WV",39.554433,-77.984594,298227
3883,25200,15-19,775,877,1652,"Hailey, ID",43.445822,-114.183901,25905
3884,25200,20-24,642,618,1260,"Hailey, ID",43.445822,-114.183901,25905
3885,25200,25-29,584,719,1303,"Hailey, ID",43.445822,-114.183901,25905
3886,25200,30-34,668,721,1389,"Hailey, ID",43.445822,-114.183901,25905
3887,25200,35-39,749,783,1532,"Hailey, ID",43.445822,-114.183901,25905
3888,25200,40-44,875,862,1737,"Hailey, ID",43.445822,-114.183901,25905
3889,25200,45-49,850,851,1701,"Hailey, ID",43.445822,-114.183901,25905
3890,25200,50-54,821,873,1694,"Hailey, ID",43.445822,-114.183901,25905
3891,25200,55-59,1105,871,1976,"Hailey, ID",43.445822,-114.183901,25905
3892,25200,60-64,1108,981,2089,"Hailey, ID",43.445822,-114.183901,25905
3893,25200,65+,2681,2800,5481,"Hailey, ID",43.445822,-114.183901,25905
3894,25220,15-19,4713,4614,9327,"Hammond, LA",30.621348,-90.40649,135217
3895,25220,20-24,4622,4368,8990,"Hammond, LA",30.621348,-90.40649,135217
3896,25220,25-29,4754,4766,9520,"Hammond, LA",30.621348,-90.40649,135217
3897,25220,30-34,5104,4783,9887,"Hammond, LA",30.621348,-90.40649,135217
3898,25220,35-39,4495,4413,8908,"Hammond, LA",30.621348,-90.40649,135217
3899,25220,40-44,4343,4259,8602,"Hammond, LA",30.621348,-90.40649,135217
3900,25220,45-49,3789,3606,7395,"Hammond, LA",30.621348,-90.40649,135217
3901,25220,50-54,4004,3759,7763,"Hammond, LA",30.621348,-90.40649,135217
3902,25220,55-59,4275,3946,8221,"Hammond, LA",30.621348,-90.40649,135217
3903,25220,60-64,4364,3939,8303,"Hammond, LA",30.621348,-90.40649,135217
3904,25220,65+,11226,9253,20479,"Hammond, LA",30.621348,-90.40649,135217
3905,25260,15-19,5069,5525,10594,"Hanford-Corcoran, CA",36.072478,-119.81553,153443
3906,25260,20-24,5050,7310,12360,"Hanford-Corcoran, CA",36.072478,-119.81553,153443
3907,25260,25-29,5266,7544,12810,"Hanford-Corcoran, CA",36.072478,-119.81553,153443
3908,25260,30-34,5174,7424,12598,"Hanford-Corcoran, CA",36.072478,-119.81553,153443
3909,25260,35-39,4770,7220,11990,"Hanford-Corcoran, CA",36.072478,-119.81553,153443
3910,25260,40-44,4091,6263,10354,"Hanford-Corcoran, CA",36.072478,-119.81553,153443
3911,25260,45-49,3533,5511,9044,"Hanford-Corcoran, CA",36.072478,-119.81553,153443
3912,25260,50-54,3235,4823,8058,"Hanford-Corcoran, CA",36.072478,-119.81553,153443
3913,25260,55-59,3530,4132,7662,"Hanford-Corcoran, CA",36.072478,-119.81553,153443
3914,25260,60-64,3203,3600,6803,"Hanford-Corcoran, CA",36.072478,-119.81553,153443
3915,25260,65+,8631,7791,16422,"Hanford-Corcoran, CA",36.072478,-119.81553,153443
3916,25300,15-19,1232,1259,2491,"Hannibal, MO",39.664115,-91.579179,38879
3917,25300,20-24,1118,1219,2337,"Hannibal, MO",39.664115,-91.579179,38879
3918,25300,25-29,1102,1087,2189,"Hannibal, MO",39.664115,-91.579179,38879
3919,25300,30-34,1163,1058,2221,"Hannibal, MO",39.664115,-91.579179,38879
3920,25300,35-39,1148,1211,2359,"Hannibal, MO",39.664115,-91.579179,38879
3921,25300,40-44,1144,1161,2305,"Hannibal, MO",39.664115,-91.579179,38879
3922,25300,45-49,1098,1154,2252,"Hannibal, MO",39.664115,-91.579179,38879
3923,25300,50-54,1208,1221,2429,"Hannibal, MO",39.664115,-91.579179,38879
3924,25300,55-59,1361,1311,2672,"Hannibal, MO",39.664115,-91.579179,38879
3925,25300,60-64,1381,1395,2776,"Hannibal, MO",39.664115,-91.579179,38879
3926,25300,65+,4149,3492,7641,"Hannibal, MO",39.664115,-91.579179,38879
3927,25420,15-19,18219,18699,36918,"Harrisburg-Carlisle, PA",40.335915,-77.05049,596305
3928,25420,20-24,17259,17751,35010,"Harrisburg-Carlisle, PA",40.335915,-77.05049,596305
3929,25420,25-29,18954,19463,38417,"Harrisburg-Carlisle, PA",40.335915,-77.05049,596305
3930,25420,30-34,19961,20731,40692,"Harrisburg-Carlisle, PA",40.335915,-77.05049,596305
3931,25420,35-39,19417,20190,39607,"Harrisburg-Carlisle, PA",40.335915,-77.05049,596305
3932,25420,40-44,18228,18530,36758,"Harrisburg-Carlisle, PA",40.335915,-77.05049,596305
3933,25420,45-49,17007,17688,34695,"Harrisburg-Carlisle, PA",40.335915,-77.05049,596305
3934,25420,50-54,18809,19328,38137,"Harrisburg-Carlisle, PA",40.335915,-77.05049,596305
3935,25420,55-59,20197,19563,39760,"Harrisburg-Carlisle, PA",40.335915,-77.05049,596305
3936,25420,60-64,20755,19590,40345,"Harrisburg-Carlisle, PA",40.335915,-77.05049,596305
3937,25420,65+,60452,48983,109435,"Harrisburg-Carlisle, PA",40.335915,-77.05049,596305
3938,25460,15-19,1322,1438,2760,"Harrison, AR",36.087809,-93.162053,45034
3939,25460,20-24,1097,1208,2305,"Harrison, AR",36.087809,-93.162053,45034
3940,25460,25-29,1243,1286,2529,"Harrison, AR",36.087809,-93.162053,45034
3941,25460,30-34,1278,1292,2570,"Harrison, AR",36.087809,-93.162053,45034
3942,25460,35-39,1260,1306,2566,"Harrison, AR",36.087809,-93.162053,45034
3943,25460,40-44,1302,1291,2593,"Harrison, AR",36.087809,-93.162053,45034
3944,25460,45-49,1275,1267,2542,"Harrison, AR",36.087809,-93.162053,45034
3945,25460,50-54,1393,1410,2803,"Harrison, AR",36.087809,-93.162053,45034
3946,25460,55-59,1556,1542,3098,"Harrison, AR",36.087809,-93.162053,45034
3947,25460,60-64,1683,1602,3285,"Harrison, AR",36.087809,-93.162053,45034
3948,25460,65+,5301,4546,9847,"Harrison, AR",36.087809,-93.162053,45034
3949,25500,15-19,7226,5783,13009,"Harrisonburg, VA",38.507585,-78.885321,135824
3950,25500,20-24,8095,7541,15636,"Harrisonburg, VA",38.507585,-78.885321,135824
3951,25500,25-29,4096,4179,8275,"Harrisonburg, VA",38.507585,-78.885321,135824
3952,25500,30-34,4014,4132,8146,"Harrisonburg, VA",38.507585,-78.885321,135824
3953,25500,35-39,4059,4141,8200,"Harrisonburg, VA",38.507585,-78.885321,135824
3954,25500,40-44,3816,4048,7864,"Harrisonburg, VA",38.507585,-78.885321,135824
3955,25500,45-49,3420,3658,7078,"Harrisonburg, VA",38.507585,-78.885321,135824
3956,25500,50-54,3733,3835,7568,"Harrisonburg, VA",38.507585,-78.885321,135824
3957,25500,55-59,3973,3923,7896,"Harrisonburg, VA",38.507585,-78.885321,135824
3958,25500,60-64,3919,3767,7686,"Harrisonburg, VA",38.507585,-78.885321,135824
3959,25500,65+,11815,10019,21834,"Harrisonburg, VA",38.507585,-78.885321,135824
3960,25540,15-19,39770,41201,80971,"Hartford-East Hartford-Middletown, CT",41.71865,-72.573919,1211906
3961,25540,20-24,42035,43353,85388,"Hartford-East Hartford-Middletown, CT",41.71865,-72.573919,1211906
3962,25540,25-29,37574,40132,77706,"Hartford-East Hartford-Middletown, CT",41.71865,-72.573919,1211906
3963,25540,30-34,38186,39978,78164,"Hartford-East Hartford-Middletown, CT",41.71865,-72.573919,1211906
3964,25540,35-39,39448,40016,79464,"Hartford-East Hartford-Middletown, CT",41.71865,-72.573919,1211906
3965,25540,40-44,37263,36796,74059,"Hartford-East Hartford-Middletown, CT",41.71865,-72.573919,1211906
3966,25540,45-49,35231,34161,69392,"Hartford-East Hartford-Middletown, CT",41.71865,-72.573919,1211906
3967,25540,50-54,41273,39464,80737,"Hartford-East Hartford-Middletown, CT",41.71865,-72.573919,1211906
3968,25540,55-59,44895,42735,87630,"Hartford-East Hartford-Middletown, CT",41.71865,-72.573919,1211906
3969,25540,60-64,43166,41129,84295,"Hartford-East Hartford-Middletown, CT",41.71865,-72.573919,1211906
3970,25540,65+,122836,96769,219605,"Hartford-East Hartford-Middletown, CT",41.71865,-72.573919,1211906
3971,25580,15-19,1182,1254,2436,"Hastings, NE",40.520632,-98.500044,31027
3972,25580,20-24,1042,1187,2229,"Hastings, NE",40.520632,-98.500044,31027
3973,25580,25-29,972,978,1950,"Hastings, NE",40.520632,-98.500044,31027
3974,25580,30-34,885,891,1776,"Hastings, NE",40.520632,-98.500044,31027
3975,25580,35-39,861,952,1813,"Hastings, NE",40.520632,-98.500044,31027
3976,25580,40-44,873,854,1727,"Hastings, NE",40.520632,-98.500044,31027
3977,25580,45-49,769,831,1600,"Hastings, NE",40.520632,-98.500044,31027
3978,25580,50-54,827,868,1695,"Hastings, NE",40.520632,-98.500044,31027
3979,25580,55-59,936,916,1852,"Hastings, NE",40.520632,-98.500044,31027
3980,25580,60-64,1041,1094,2135,"Hastings, NE",40.520632,-98.500044,31027
3981,25580,65+,3177,2656,5833,"Hastings, NE",40.520632,-98.500044,31027
3982,25620,15-19,5935,5669,11604,"Hattiesburg, MS",31.273766,-89.300634,173078
3983,25620,20-24,7466,6425,13891,"Hattiesburg, MS",31.273766,-89.300634,173078
3984,25620,25-29,6341,5874,12215,"Hattiesburg, MS",31.273766,-89.300634,173078
3985,25620,30-34,6318,5682,12000,"Hattiesburg, MS",31.273766,-89.300634,173078
3986,25620,35-39,6041,5420,11461,"Hattiesburg, MS",31.273766,-89.300634,173078
3987,25620,40-44,5713,5312,11025,"Hattiesburg, MS",31.273766,-89.300634,173078
3988,25620,45-49,5040,4787,9827,"Hattiesburg, MS",31.273766,-89.300634,173078
3989,25620,50-54,5231,4904,10135,"Hattiesburg, MS",31.273766,-89.300634,173078
3990,25620,55-59,5377,4899,10276,"Hattiesburg, MS",31.273766,-89.300634,173078
3991,25620,60-64,5367,4850,10217,"Hattiesburg, MS",31.273766,-89.300634,173078
3992,25620,65+,14485,11561,26046,"Hattiesburg, MS",31.273766,-89.300634,173078
3993,25700,15-19,1102,1127,2229,"Hays, KS",38.914597,-99.317313,28790
3994,25700,20-24,1852,1849,3701,"Hays, KS",38.914597,-99.317313,28790
3995,25700,25-29,887,1015,1902,"Hays, KS",38.914597,-99.317313,28790
3996,25700,30-34,847,843,1690,"Hays, KS",38.914597,-99.317313,28790
3997,25700,35-39,917,956,1873,"Hays, KS",38.914597,-99.317313,28790
3998,25700,40-44,778,830,1608,"Hays, KS",38.914597,-99.317313,28790
3999,25700,45-49,659,712,1371,"Hays, KS",38.914597,-99.317313,28790
4000,25700,50-54,690,735,1425,"Hays, KS",38.914597,-99.317313,28790
4001,25700,55-59,777,764,1541,"Hays, KS",38.914597,-99.317313,28790
4002,25700,60-64,844,834,1678,"Hays, KS",38.914597,-99.317313,28790
4003,25700,65+,2606,2218,4824,"Hays, KS",38.914597,-99.317313,28790
4004,25720,15-19,2910,3239,6149,"Heber, UT",40.699219,-111.020425,79266
4005,25720,20-24,2167,2405,4572,"Heber, UT",40.699219,-111.020425,79266
4006,25720,25-29,2051,2254,4305,"Heber, UT",40.699219,-111.020425,79266
4007,25720,30-34,2173,2250,4423,"Heber, UT",40.699219,-111.020425,79266
4008,25720,35-39,2544,2626,5170,"Heber, UT",40.699219,-111.020425,79266
4009,25720,40-44,2863,2900,5763,"Heber, UT",40.699219,-111.020425,79266
4010,25720,45-49,2524,2730,5254,"Heber, UT",40.699219,-111.020425,79266
4011,25720,50-54,2689,2752,5441,"Heber, UT",40.699219,-111.020425,79266
4012,25720,55-59,2595,2634,5229,"Heber, UT",40.699219,-111.020425,79266
4013,25720,60-64,2656,2780,5436,"Heber, UT",40.699219,-111.020425,79266
4014,25720,65+,5265,5730,10995,"Heber, UT",40.699219,-111.020425,79266
4015,25740,15-19,2485,2513,4998,"Helena, MT",46.811354,-112.284031,84693
4016,25740,20-24,2129,2285,4414,"Helena, MT",46.811354,-112.284031,84693
4017,25740,25-29,2382,2376,4758,"Helena, MT",46.811354,-112.284031,84693
4018,25740,30-34,2664,2655,5319,"Helena, MT",46.811354,-112.284031,84693
4019,25740,35-39,2882,2930,5812,"Helena, MT",46.811354,-112.284031,84693
4020,25740,40-44,2580,2731,5311,"Helena, MT",46.811354,-112.284031,84693
4021,25740,45-49,2344,2372,4716,"Helena, MT",46.811354,-112.284031,84693
4022,25740,50-54,2573,2545,5118,"Helena, MT",46.811354,-112.284031,84693
4023,25740,55-59,3021,2894,5915,"Helena, MT",46.811354,-112.284031,84693
4024,25740,60-64,3329,3126,6455,"Helena, MT",46.811354,-112.284031,84693
4025,25740,65+,8839,8313,17152,"Helena, MT",46.811354,-112.284031,84693
4026,25760,15-19,500,540,1040,"Helena-West Helena, AR",34.423687,-90.855593,15906
4027,25760,20-24,488,405,893,"Helena-West Helena, AR",34.423687,-90.855593,15906
4028,25760,25-29,486,384,870,"Helena-West Helena, AR",34.423687,-90.855593,15906
4029,25760,30-34,450,374,824,"Helena-West Helena, AR",34.423687,-90.855593,15906
4030,25760,35-39,445,381,826,"Helena-West Helena, AR",34.423687,-90.855593,15906
4031,25760,40-44,457,383,840,"Helena-West Helena, AR",34.423687,-90.855593,15906
4032,25760,45-49,451,357,808,"Helena-West Helena, AR",34.423687,-90.855593,15906
4033,25760,50-54,444,439,883,"Helena-West Helena, AR",34.423687,-90.855593,15906
4034,25760,55-59,586,483,1069,"Helena-West Helena, AR",34.423687,-90.855593,15906
4035,25760,60-64,665,514,1179,"Helena-West Helena, AR",34.423687,-90.855593,15906
4036,25760,65+,1799,1418,3217,"Helena-West Helena, AR",34.423687,-90.855593,15906
4037,25780,15-19,1391,1400,2791,"Henderson, NC",36.365481,-78.405434,42185
4038,25780,20-24,1261,1275,2536,"Henderson, NC",36.365481,-78.405434,42185
4039,25780,25-29,1353,1264,2617,"Henderson, NC",36.365481,-78.405434,42185
4040,25780,30-34,1340,1213,2553,"Henderson, NC",36.365481,-78.405434,42185
4041,25780,35-39,1251,948,2199,"Henderson, NC",36.365481,-78.405434,42185
4042,25780,40-44,1244,1063,2307,"Henderson, NC",36.365481,-78.405434,42185
4043,25780,45-49,1230,1093,2323,"Henderson, NC",36.365481,-78.405434,42185
4044,25780,50-54,1446,1305,2751,"Henderson, NC",36.365481,-78.405434,42185
4045,25780,55-59,1516,1329,2845,"Henderson, NC",36.365481,-78.405434,42185
4046,25780,60-64,1595,1272,2867,"Henderson, NC",36.365481,-78.405434,42185
4047,25780,65+,4710,3460,8170,"Henderson, NC",36.365481,-78.405434,42185
4048,25820,15-19,726,794,1520,"Hereford, TX",34.940766,-102.607564,18329
4049,25820,20-24,642,630,1272,"Hereford, TX",34.940766,-102.607564,18329
4050,25820,25-29,579,638,1217,"Hereford, TX",34.940766,-102.607564,18329
4051,25820,30-34,584,615,1199,"Hereford, TX",34.940766,-102.607564,18329
4052,25820,35-39,557,524,1081,"Hereford, TX",34.940766,-102.607564,18329
4053,25820,40-44,519,551,1070,"Hereford, TX",34.940766,-102.607564,18329
4054,25820,45-49,510,522,1032,"Hereford, TX",34.940766,-102.607564,18329
4055,25820,50-54,472,468,940,"Hereford, TX",34.940766,-102.607564,18329
4056,25820,55-59,444,490,934,"Hereford, TX",34.940766,-102.607564,18329
4057,25820,60-64,448,458,906,"Hereford, TX",34.940766,-102.607564,18329
4058,25820,65+,1286,1112,2398,"Hereford, TX",34.940766,-102.607564,18329
4059,25840,15-19,3124,3293,6417,"Hermiston-Pendleton, OR",45.544602,-119.076191,92291
4060,25840,20-24,2615,3353,5968,"Hermiston-Pendleton, OR",45.544602,-119.076191,92291
4061,25840,25-29,2781,3616,6397,"Hermiston-Pendleton, OR",45.544602,-119.076191,92291
4062,25840,30-34,2842,3523,6365,"Hermiston-Pendleton, OR",45.544602,-119.076191,92291
4063,25840,35-39,2697,3257,5954,"Hermiston-Pendleton, OR",45.544602,-119.076191,92291
4064,25840,40-44,2652,3096,5748,"Hermiston-Pendleton, OR",45.544602,-119.076191,92291
4065,25840,45-49,2509,2899,5408,"Hermiston-Pendleton, OR",45.544602,-119.076191,92291
4066,25840,50-54,2539,2806,5345,"Hermiston-Pendleton, OR",45.544602,-119.076191,92291
4067,25840,55-59,2482,2803,5285,"Hermiston-Pendleton, OR",45.544602,-119.076191,92291
4068,25840,60-64,2653,2715,5368,"Hermiston-Pendleton, OR",45.544602,-119.076191,92291
4069,25840,65+,7684,7237,14921,"Hermiston-Pendleton, OR",45.544602,-119.076191,92291
4070,25860,15-19,10436,11734,22170,"Hickory-Lenoir-Morganton, NC",35.814286,-81.456575,366441
4071,25860,20-24,9888,10898,20786,"Hickory-Lenoir-Morganton, NC",35.814286,-81.456575,366441
4072,25860,25-29,10707,11627,22334,"Hickory-Lenoir-Morganton, NC",35.814286,-81.456575,366441
4073,25860,30-34,10980,11061,22041,"Hickory-Lenoir-Morganton, NC",35.814286,-81.456575,366441
4074,25860,35-39,10025,10340,20365,"Hickory-Lenoir-Morganton, NC",35.814286,-81.456575,366441
4075,25860,40-44,10572,10745,21317,"Hickory-Lenoir-Morganton, NC",35.814286,-81.456575,366441
4076,25860,45-49,11407,11710,23117,"Hickory-Lenoir-Morganton, NC",35.814286,-81.456575,366441
4077,25860,50-54,13296,13429,26725,"Hickory-Lenoir-Morganton, NC",35.814286,-81.456575,366441
4078,25860,55-59,13765,13993,27758,"Hickory-Lenoir-Morganton, NC",35.814286,-81.456575,366441
4079,25860,60-64,13501,13046,26547,"Hickory-Lenoir-Morganton, NC",35.814286,-81.456575,366441
4080,25860,65+,39858,32933,72791,"Hickory-Lenoir-Morganton, NC",35.814286,-81.456575,366441
4081,25880,15-19,1586,1621,3207,"Hillsdale, MI",41.927461,-84.637479,45546
4082,25880,20-24,1476,1446,2922,"Hillsdale, MI",41.927461,-84.637479,45546
4083,25880,25-29,1150,1255,2405,"Hillsdale, MI",41.927461,-84.637479,45546
4084,25880,30-34,1200,1264,2464,"Hillsdale, MI",41.927461,-84.637479,45546
4085,25880,35-39,1242,1234,2476,"Hillsdale, MI",41.927461,-84.637479,45546
4086,25880,40-44,1261,1271,2532,"Hillsdale, MI",41.927461,-84.637479,45546
4087,25880,45-49,1239,1305,2544,"Hillsdale, MI",41.927461,-84.637479,45546
4088,25880,50-54,1381,1467,2848,"Hillsdale, MI",41.927461,-84.637479,45546
4089,25880,55-59,1546,1628,3174,"Hillsdale, MI",41.927461,-84.637479,45546
4090,25880,60-64,1858,1782,3640,"Hillsdale, MI",41.927461,-84.637479,45546
4091,25880,65+,4942,4497,9439,"Hillsdale, MI",41.927461,-84.637479,45546
4092,25900,15-19,5487,5825,11312,"Hilo, HI",19.597764,-155.502443,202906
4093,25900,20-24,4911,4821,9732,"Hilo, HI",19.597764,-155.502443,202906
4094,25900,25-29,5375,5330,10705,"Hilo, HI",19.597764,-155.502443,202906
4095,25900,30-34,6254,6026,12280,"Hilo, HI",19.597764,-155.502443,202906
4096,25900,35-39,6516,6362,12878,"Hilo, HI",19.597764,-155.502443,202906
4097,25900,40-44,6343,6229,12572,"Hilo, HI",19.597764,-155.502443,202906
4098,25900,45-49,5745,5744,11489,"Hilo, HI",19.597764,-155.502443,202906
4099,25900,50-54,5890,5790,11680,"Hilo, HI",19.597764,-155.502443,202906
4100,25900,55-59,6687,6319,13006,"Hilo, HI",19.597764,-155.502443,202906
4101,25900,60-64,7724,7530,15254,"Hilo, HI",19.597764,-155.502443,202906
4102,25900,65+,23745,22302,46047,"Hilo, HI",19.597764,-155.502443,202906
4103,25940,15-19,5775,6841,12616,"Hilton Head Island-Bluffton, SC",32.386792,-80.830877,222072
4104,25940,20-24,5742,7487,13229,"Hilton Head Island-Bluffton, SC",32.386792,-80.830877,222072
4105,25940,25-29,5932,6321,12253,"Hilton Head Island-Bluffton, SC",32.386792,-80.830877,222072
4106,25940,30-34,5819,5834,11653,"Hilton Head Island-Bluffton, SC",32.386792,-80.830877,222072
4107,25940,35-39,5680,5647,11327,"Hilton Head Island-Bluffton, SC",32.386792,-80.830877,222072
4108,25940,40-44,5609,5367,10976,"Hilton Head Island-Bluffton, SC",32.386792,-80.830877,222072
4109,25940,45-49,5600,5307,10907,"Hilton Head Island-Bluffton, SC",32.386792,-80.830877,222072
4110,25940,50-54,6338,5815,12153,"Hilton Head Island-Bluffton, SC",32.386792,-80.830877,222072
4111,25940,55-59,8110,6894,15004,"Hilton Head Island-Bluffton, SC",32.386792,-80.830877,222072
4112,25940,60-64,9555,8058,17613,"Hilton Head Island-Bluffton, SC",32.386792,-80.830877,222072
4113,25940,65+,32745,28695,61440,"Hilton Head Island-Bluffton, SC",32.386792,-80.830877,222072
4114,25980,15-19,2412,2698,5110,"Hinesville, GA",31.778788,-81.57648,82863
4115,25980,20-24,3460,4459,7919,"Hinesville, GA",31.778788,-81.57648,82863
4116,25980,25-29,3915,4406,8321,"Hinesville, GA",31.778788,-81.57648,82863
4117,25980,30-34,3427,3606,7033,"Hinesville, GA",31.778788,-81.57648,82863
4118,25980,35-39,2823,2856,5679,"Hinesville, GA",31.778788,-81.57648,82863
4119,25980,40-44,2268,2351,4619,"Hinesville, GA",31.778788,-81.57648,82863
4120,25980,45-49,1939,1828,3767,"Hinesville, GA",31.778788,-81.57648,82863
4121,25980,50-54,1970,1767,3737,"Hinesville, GA",31.778788,-81.57648,82863
4122,25980,55-59,2115,1850,3965,"Hinesville, GA",31.778788,-81.57648,82863
4123,25980,60-64,2007,1797,3804,"Hinesville, GA",31.778788,-81.57648,82863
4124,25980,65+,4641,3850,8491,"Hinesville, GA",31.778788,-81.57648,82863
4125,26020,15-19,2875,3026,5901,"Hobbs, NM",32.795687,-103.413271,73004
4126,26020,20-24,2334,2721,5055,"Hobbs, NM",32.795687,-103.413271,73004
4127,26020,25-29,2376,2757,5133,"Hobbs, NM",32.795687,-103.413271,73004
4128,26020,30-34,2384,2700,5084,"Hobbs, NM",32.795687,-103.413271,73004
4129,26020,35-39,2463,2802,5265,"Hobbs, NM",32.795687,-103.413271,73004
4130,26020,40-44,2168,2467,4635,"Hobbs, NM",32.795687,-103.413271,73004
4131,26020,45-49,1991,2096,4087,"Hobbs, NM",32.795687,-103.413271,73004
4132,26020,50-54,1804,1980,3784,"Hobbs, NM",32.795687,-103.413271,73004
4133,26020,55-59,1812,2045,3857,"Hobbs, NM",32.795687,-103.413271,73004
4134,26020,60-64,1825,1916,3741,"Hobbs, NM",32.795687,-103.413271,73004
4135,26020,65+,4427,3893,8320,"Hobbs, NM",32.795687,-103.413271,73004
4136,26090,15-19,3796,3954,7750,"Holland, MI",42.421251,-86.261403,120950
4137,26090,20-24,3197,3485,6682,"Holland, MI",42.421251,-86.261403,120950
4138,26090,25-29,3482,3600,7082,"Holland, MI",42.421251,-86.261403,120950
4139,26090,30-34,3683,3700,7383,"Holland, MI",42.421251,-86.261403,120950
4140,26090,35-39,3791,3798,7589,"Holland, MI",42.421251,-86.261403,120950
4141,26090,40-44,3602,3785,7387,"Holland, MI",42.421251,-86.261403,120950
4142,26090,45-49,3367,3564,6931,"Holland, MI",42.421251,-86.261403,120950
4143,26090,50-54,3950,3996,7946,"Holland, MI",42.421251,-86.261403,120950
4144,26090,55-59,4202,4429,8631,"Holland, MI",42.421251,-86.261403,120950
4145,26090,60-64,4372,4518,8890,"Holland, MI",42.421251,-86.261403,120950
4146,26090,65+,11215,10098,21313,"Holland, MI",42.421251,-86.261403,120950
4147,26140,15-19,3277,3477,6754,"Homosassa Springs, FL",28.850292,-82.595552,158083
4148,26140,20-24,2734,3014,5748,"Homosassa Springs, FL",28.850292,-82.595552,158083
4149,26140,25-29,3210,3512,6722,"Homosassa Springs, FL",28.850292,-82.595552,158083
4150,26140,30-34,3481,3598,7079,"Homosassa Springs, FL",28.850292,-82.595552,158083
4151,26140,35-39,3331,3382,6713,"Homosassa Springs, FL",28.850292,-82.595552,158083
4152,26140,40-44,3340,3183,6523,"Homosassa Springs, FL",28.850292,-82.595552,158083
4153,26140,45-49,3608,3466,7074,"Homosassa Springs, FL",28.850292,-82.595552,158083
4154,26140,50-54,4887,4152,9039,"Homosassa Springs, FL",28.850292,-82.595552,158083
4155,26140,55-59,6226,5461,11687,"Homosassa Springs, FL",28.850292,-82.595552,158083
4156,26140,60-64,7615,6605,14220,"Homosassa Springs, FL",28.850292,-82.595552,158083
4157,26140,65+,29918,27446,57364,"Homosassa Springs, FL",28.850292,-82.595552,158083
4158,26220,15-19,763,828,1591,"Hood River, OR",45.511775,-121.655976,24057
4159,26220,20-24,622,747,1369,"Hood River, OR",45.511775,-121.655976,24057
4160,26220,25-29,687,762,1449,"Hood River, OR",45.511775,-121.655976,24057
4161,26220,30-34,735,773,1508,"Hood River, OR",45.511775,-121.655976,24057
4162,26220,35-39,846,774,1620,"Hood River, OR",45.511775,-121.655976,24057
4163,26220,40-44,852,843,1695,"Hood River, OR",45.511775,-121.655976,24057
4164,26220,45-49,723,791,1514,"Hood River, OR",45.511775,-121.655976,24057
4165,26220,50-54,780,771,1551,"Hood River, OR",45.511775,-121.655976,24057
4166,26220,55-59,742,815,1557,"Hood River, OR",45.511775,-121.655976,24057
4167,26220,60-64,809,800,1609,"Hood River, OR",45.511775,-121.655976,24057
4168,26220,65+,2127,1969,4096,"Hood River, OR",45.511775,-121.655976,24057
4169,26260,15-19,852,893,1745,"Hope, AR",33.70084,-93.499549,27881
4170,26260,20-24,736,806,1542,"Hope, AR",33.70084,-93.499549,27881
4171,26260,25-29,788,758,1546,"Hope, AR",33.70084,-93.499549,27881
4172,26260,30-34,829,755,1584,"Hope, AR",33.70084,-93.499549,27881
4173,26260,35-39,810,700,1510,"Hope, AR",33.70084,-93.499549,27881
4174,26260,40-44,809,766,1575,"Hope, AR",33.70084,-93.499549,27881
4175,26260,45-49,816,769,1585,"Hope, AR",33.70084,-93.499549,27881
4176,26260,50-54,855,808,1663,"Hope, AR",33.70084,-93.499549,27881
4177,26260,55-59,987,975,1962,"Hope, AR",33.70084,-93.499549,27881
4178,26260,60-64,1005,923,1928,"Hope, AR",33.70084,-93.499549,27881
4179,26260,65+,2996,2522,5518,"Hope, AR",33.70084,-93.499549,27881
4180,26300,15-19,2748,3008,5756,"Hot Springs, AR",34.578852,-93.146932,100330
4181,26300,20-24,2428,2574,5002,"Hot Springs, AR",34.578852,-93.146932,100330
4182,26300,25-29,2745,2703,5448,"Hot Springs, AR",34.578852,-93.146932,100330
4183,26300,30-34,2972,2855,5827,"Hot Springs, AR",34.578852,-93.146932,100330
4184,26300,35-39,2928,2662,5590,"Hot Springs, AR",34.578852,-93.146932,100330
4185,26300,40-44,2913,2854,5767,"Hot Springs, AR",34.578852,-93.146932,100330
4186,26300,45-49,2949,2724,5673,"Hot Springs, AR",34.578852,-93.146932,100330
4187,26300,50-54,3187,2995,6182,"Hot Springs, AR",34.578852,-93.146932,100330
4188,26300,55-59,3560,3244,6804,"Hot Springs, AR",34.578852,-93.146932,100330
4189,26300,60-64,3980,3518,7498,"Hot Springs, AR",34.578852,-93.146932,100330
4190,26300,65+,13423,11052,24475,"Hot Springs, AR",34.578852,-93.146932,100330
4191,26340,15-19,1547,2295,3842,"Houghton, MI",47.367297,-88.351332,39420
4192,26340,20-24,1929,3601,5530,"Houghton, MI",47.367297,-88.351332,39420
4193,26340,25-29,929,1166,2095,"Houghton, MI",47.367297,-88.351332,39420
4194,26340,30-34,879,1006,1885,"Houghton, MI",47.367297,-88.351332,39420
4195,26340,35-39,943,1012,1955,"Houghton, MI",47.367297,-88.351332,39420
4196,26340,40-44,916,941,1857,"Houghton, MI",47.367297,-88.351332,39420
4197,26340,45-49,885,925,1810,"Houghton, MI",47.367297,-88.351332,39420
4198,26340,50-54,879,1011,1890,"Houghton, MI",47.367297,-88.351332,39420
4199,26340,55-59,1100,1120,2220,"Houghton, MI",47.367297,-88.351332,39420
4200,26340,60-64,1172,1191,2363,"Houghton, MI",47.367297,-88.351332,39420
4201,26340,65+,3861,3613,7474,"Houghton, MI",47.367297,-88.351332,39420
4202,26380,15-19,6531,6920,13451,"Houma-Thibodaux, LA",29.33413,-90.843674,206212
4203,26380,20-24,5825,6009,11834,"Houma-Thibodaux, LA",29.33413,-90.843674,206212
4204,26380,25-29,6378,6469,12847,"Houma-Thibodaux, LA",29.33413,-90.843674,206212
4205,26380,30-34,7428,7084,14512,"Houma-Thibodaux, LA",29.33413,-90.843674,206212
4206,26380,35-39,7071,6863,13934,"Houma-Thibodaux, LA",29.33413,-90.843674,206212
4207,26380,40-44,6612,6597,13209,"Houma-Thibodaux, LA",29.33413,-90.843674,206212
4208,26380,45-49,5769,5745,11514,"Houma-Thibodaux, LA",29.33413,-90.843674,206212
4209,26380,50-54,6575,6256,12831,"Houma-Thibodaux, LA",29.33413,-90.843674,206212
4210,26380,55-59,7323,7196,14519,"Houma-Thibodaux, LA",29.33413,-90.843674,206212
4211,26380,60-64,6946,6849,13795,"Houma-Thibodaux, LA",29.33413,-90.843674,206212
4212,26380,65+,17746,14868,32614,"Houma-Thibodaux, LA",29.33413,-90.843674,206212
4213,26420,15-19,249848,262808,512656,"Houston-The Woodlands-Sugar Land, TX",29.749593,-95.353642,7206841
4214,26420,20-24,230054,232749,462803,"Houston-The Woodlands-Sugar Land, TX",29.749593,-95.353642,7206841
4215,26420,25-29,251958,250972,502930,"Houston-The Woodlands-Sugar Land, TX",29.749593,-95.353642,7206841
4216,26420,30-34,267626,265455,533081,"Houston-The Woodlands-Sugar Land, TX",29.749593,-95.353642,7206841
4217,26420,35-39,267884,271023,538907,"Houston-The Woodlands-Sugar Land, TX",29.749593,-95.353642,7206841
4218,26420,40-44,254420,257059,511479,"Houston-The Woodlands-Sugar Land, TX",29.749593,-95.353642,7206841
4219,26420,45-49,235651,235321,470972,"Houston-The Woodlands-Sugar Land, TX",29.749593,-95.353642,7206841
4220,26420,50-54,223623,225256,448879,"Houston-The Woodlands-Sugar Land, TX",29.749593,-95.353642,7206841
4221,26420,55-59,208348,205976,414324,"Houston-The Woodlands-Sugar Land, TX",29.749593,-95.353642,7206841
4222,26420,60-64,196891,190564,387455,"Houston-The Woodlands-Sugar Land, TX",29.749593,-95.353642,7206841
4223,26420,65+,468818,392729,861547,"Houston-The Woodlands-Sugar Land, TX",29.749593,-95.353642,7206841
4224,26460,15-19,1392,1757,3149,"Hudson, NY",42.247696,-73.626718,61778
4225,26460,20-24,1372,1518,2890,"Hudson, NY",42.247696,-73.626718,61778
4226,26460,25-29,1609,1706,3315,"Hudson, NY",42.247696,-73.626718,61778
4227,26460,30-34,1741,1743,3484,"Hudson, NY",42.247696,-73.626718,61778
4228,26460,35-39,1809,1753,3562,"Hudson, NY",42.247696,-73.626718,61778
4229,26460,40-44,1719,1711,3430,"Hudson, NY",42.247696,-73.626718,61778
4230,26460,45-49,1730,1779,3509,"Hudson, NY",42.247696,-73.626718,61778
4231,26460,50-54,2101,2211,4312,"Hudson, NY",42.247696,-73.626718,61778
4232,26460,55-59,2515,2643,5158,"Hudson, NY",42.247696,-73.626718,61778
4233,26460,60-64,2629,2658,5287,"Hudson, NY",42.247696,-73.626718,61778
4234,26460,65+,8245,7466,15711,"Hudson, NY",42.247696,-73.626718,61778
4235,26500,15-19,1394,1325,2719,"Huntingdon, PA",40.422311,-77.968595,43889
4236,26500,20-24,1298,1550,2848,"Huntingdon, PA",40.422311,-77.968595,43889
4237,26500,25-29,1028,1661,2689,"Huntingdon, PA",40.422311,-77.968595,43889
4238,26500,30-34,1055,1736,2791,"Huntingdon, PA",40.422311,-77.968595,43889
4239,26500,35-39,1061,1518,2579,"Huntingdon, PA",40.422311,-77.968595,43889
4240,26500,40-44,1083,1512,2595,"Huntingdon, PA",40.422311,-77.968595,43889
4241,26500,45-49,1103,1595,2698,"Huntingdon, PA",40.422311,-77.968595,43889
4242,26500,50-54,1300,1645,2945,"Huntingdon, PA",40.422311,-77.968595,43889
4243,26500,55-59,1472,1681,3153,"Huntingdon, PA",40.422311,-77.968595,43889
4244,26500,60-64,1506,1599,3105,"Huntingdon, PA",40.422311,-77.968595,43889
4245,26500,65+,4945,4493,9438,"Huntingdon, PA",40.422311,-77.968595,43889
4246,26540,15-19,1177,1231,2408,"Huntington, IN",40.826394,-85.478597,36717
4247,26540,20-24,1213,1282,2495,"Huntington, IN",40.826394,-85.478597,36717
4248,26540,25-29,1081,1138,2219,"Huntington, IN",40.826394,-85.478597,36717
4249,26540,30-34,1087,1145,2232,"Huntington, IN",40.826394,-85.478597,36717
4250,26540,35-39,1057,1119,2176,"Huntington, IN",40.826394,-85.478597,36717
4251,26540,40-44,1093,1153,2246,"Huntington, IN",40.826394,-85.478597,36717
4252,26540,45-49,1079,1061,2140,"Huntington, IN",40.826394,-85.478597,36717
4253,26540,50-54,1121,1185,2306,"Huntington, IN",40.826394,-85.478597,36717
4254,26540,55-59,1336,1274,2610,"Huntington, IN",40.826394,-85.478597,36717
4255,26540,60-64,1362,1391,2753,"Huntington, IN",40.826394,-85.478597,36717
4256,26540,65+,3631,2920,6551,"Huntington, IN",40.826394,-85.478597,36717
4257,26580,15-19,10719,11576,22295,"Huntington-Ashland, WV-KY-OH",38.406577,-82.542646,356581
4258,26580,20-24,11460,11593,23053,"Huntington-Ashland, WV-KY-OH",38.406577,-82.542646,356581
4259,26580,25-29,10277,10805,21082,"Huntington-Ashland, WV-KY-OH",38.406577,-82.542646,356581
4260,26580,30-34,10285,10413,20698,"Huntington-Ashland, WV-KY-OH",38.406577,-82.542646,356581
4261,26580,35-39,10439,10499,20938,"Huntington-Ashland, WV-KY-OH",38.406577,-82.542646,356581
4262,26580,40-44,11113,11185,22298,"Huntington-Ashland, WV-KY-OH",38.406577,-82.542646,356581
4263,26580,45-49,11079,10905,21984,"Huntington-Ashland, WV-KY-OH",38.406577,-82.542646,356581
4264,26580,50-54,11849,11832,23681,"Huntington-Ashland, WV-KY-OH",38.406577,-82.542646,356581
4265,26580,55-59,11890,11567,23457,"Huntington-Ashland, WV-KY-OH",38.406577,-82.542646,356581
4266,26580,60-64,12627,11805,24432,"Huntington-Ashland, WV-KY-OH",38.406577,-82.542646,356581
4267,26580,65+,39306,31945,71251,"Huntington-Ashland, WV-KY-OH",38.406577,-82.542646,356581
4268,26620,15-19,15439,16154,31593,"Huntsville, AL",34.783262,-86.734871,502728
4269,26620,20-24,15634,16161,31795,"Huntsville, AL",34.783262,-86.734871,502728
4270,26620,25-29,16810,18071,34881,"Huntsville, AL",34.783262,-86.734871,502728
4271,26620,30-34,17549,17895,35444,"Huntsville, AL",34.783262,-86.734871,502728
4272,26620,35-39,16969,17273,34242,"Huntsville, AL",34.783262,-86.734871,502728
4273,26620,40-44,16022,15842,31864,"Huntsville, AL",34.783262,-86.734871,502728
4274,26620,45-49,15349,14708,30057,"Huntsville, AL",34.783262,-86.734871,502728
4275,26620,50-54,16792,16627,33419,"Huntsville, AL",34.783262,-86.734871,502728
4276,26620,55-59,18764,18412,37176,"Huntsville, AL",34.783262,-86.734871,502728
4277,26620,60-64,17113,17227,34340,"Huntsville, AL",34.783262,-86.734871,502728
4278,26620,65+,43042,34913,77955,"Huntsville, AL",34.783262,-86.734871,502728
4279,26660,15-19,2905,2677,5582,"Huntsville, TX",30.743163,-95.569825,77977
4280,26660,20-24,5300,5457,10757,"Huntsville, TX",30.743163,-95.569825,77977
4281,26660,25-29,2080,3614,5694,"Huntsville, TX",30.743163,-95.569825,77977
4282,26660,30-34,1783,3678,5461,"Huntsville, TX",30.743163,-95.569825,77977
4283,26660,35-39,1674,3727,5401,"Huntsville, TX",30.743163,-95.569825,77977
4284,26660,40-44,1609,3634,5243,"Huntsville, TX",30.743163,-95.569825,77977
4285,26660,45-49,1540,3673,5213,"Huntsville, TX",30.743163,-95.569825,77977
4286,26660,50-54,1714,3497,5211,"Huntsville, TX",30.743163,-95.569825,77977
4287,26660,55-59,1903,2752,4655,"Huntsville, TX",30.743163,-95.569825,77977
4288,26660,60-64,1916,2331,4247,"Huntsville, TX",30.743163,-95.569825,77977
4289,26660,65+,5730,5280,11010,"Huntsville, TX",30.743163,-95.569825,77977
4290,26700,15-19,608,721,1329,"Huron, SD",44.311391,-98.382386,20757
4291,26700,20-24,500,537,1037,"Huron, SD",44.311391,-98.382386,20757
4292,26700,25-29,623,573,1196,"Huron, SD",44.311391,-98.382386,20757
4293,26700,30-34,614,590,1204,"Huron, SD",44.311391,-98.382386,20757
4294,26700,35-39,589,635,1224,"Huron, SD",44.311391,-98.382386,20757
4295,26700,40-44,550,606,1156,"Huron, SD",44.311391,-98.382386,20757
4296,26700,45-49,507,546,1053,"Huron, SD",44.311391,-98.382386,20757
4297,26700,50-54,567,571,1138,"Huron, SD",44.311391,-98.382386,20757
4298,26700,55-59,647,674,1321,"Huron, SD",44.311391,-98.382386,20757
4299,26700,60-64,715,720,1435,"Huron, SD",44.311391,-98.382386,20757
4300,26700,65+,2019,1775,3794,"Huron, SD",44.311391,-98.382386,20757
4301,26740,15-19,2039,2220,4259,"Hutchinson, KS",37.948185,-98.078346,61414
4302,26740,20-24,1702,2095,3797,"Hutchinson, KS",37.948185,-98.078346,61414
4303,26740,25-29,1674,1966,3640,"Hutchinson, KS",37.948185,-98.078346,61414
4304,26740,30-34,1617,1996,3613,"Hutchinson, KS",37.948185,-98.078346,61414
4305,26740,35-39,1802,2062,3864,"Hutchinson, KS",37.948185,-98.078346,61414
4306,26740,40-44,1762,1940,3702,"Hutchinson, KS",37.948185,-98.078346,61414
4307,26740,45-49,1625,1781,3406,"Hutchinson, KS",37.948185,-98.078346,61414
4308,26740,50-54,1681,1780,3461,"Hutchinson, KS",37.948185,-98.078346,61414
4309,26740,55-59,1979,1986,3965,"Hutchinson, KS",37.948185,-98.078346,61414
4310,26740,60-64,2209,2147,4356,"Hutchinson, KS",37.948185,-98.078346,61414
4311,26740,65+,6923,5567,12490,"Hutchinson, KS",37.948185,-98.078346,61414
4312,26780,15-19,1172,1261,2433,"Hutchinson, MN",44.821657,-94.272323,36735
4313,26780,20-24,992,1031,2023,"Hutchinson, MN",44.821657,-94.272323,36735
4314,26780,25-29,1016,1127,2143,"Hutchinson, MN",44.821657,-94.272323,36735
4315,26780,30-34,1062,1113,2175,"Hutchinson, MN",44.821657,-94.272323,36735
4316,26780,35-39,1110,1181,2291,"Hutchinson, MN",44.821657,-94.272323,36735
4317,26780,40-44,1079,1203,2282,"Hutchinson, MN",44.821657,-94.272323,36735
4318,26780,45-49,1056,1104,2160,"Hutchinson, MN",44.821657,-94.272323,36735
4319,26780,50-54,1130,1249,2379,"Hutchinson, MN",44.821657,-94.272323,36735
4320,26780,55-59,1294,1309,2603,"Hutchinson, MN",44.821657,-94.272323,36735
4321,26780,60-64,1280,1311,2591,"Hutchinson, MN",44.821657,-94.272323,36735
4322,26780,65+,3809,3223,7032,"Hutchinson, MN",44.821657,-94.272323,36735
4323,26820,15-19,6200,6517,12717,"Idaho Falls, ID",43.620423,-112.420919,162786
4324,26820,20-24,4596,4864,9460,"Idaho Falls, ID",43.620423,-112.420919,162786
4325,26820,25-29,5219,5233,10452,"Idaho Falls, ID",43.620423,-112.420919,162786
4326,26820,30-34,5451,5451,10902,"Idaho Falls, ID",43.620423,-112.420919,162786
4327,26820,35-39,5661,5713,11374,"Idaho Falls, ID",43.620423,-112.420919,162786
4328,26820,40-44,5283,5678,10961,"Idaho Falls, ID",43.620423,-112.420919,162786
4329,26820,45-49,4264,4528,8792,"Idaho Falls, ID",43.620423,-112.420919,162786
4330,26820,50-54,3906,4046,7952,"Idaho Falls, ID",43.620423,-112.420919,162786
4331,26820,55-59,4044,4274,8318,"Idaho Falls, ID",43.620423,-112.420919,162786
4332,26820,60-64,4228,4296,8524,"Idaho Falls, ID",43.620423,-112.420919,162786
4333,26820,65+,11504,10376,21880,"Idaho Falls, ID",43.620423,-112.420919,162786
4334,26860,15-19,3601,3315,6916,"Indiana, PA",40.651432,-79.087545,82886
4335,26860,20-24,4450,4555,9005,"Indiana, PA",40.651432,-79.087545,82886
4336,26860,25-29,2041,2347,4388,"Indiana, PA",40.651432,-79.087545,82886
4337,26860,30-34,1855,2283,4138,"Indiana, PA",40.651432,-79.087545,82886
4338,26860,35-39,2085,2279,4364,"Indiana, PA",40.651432,-79.087545,82886
4339,26860,40-44,2060,2239,4299,"Indiana, PA",40.651432,-79.087545,82886
4340,26860,45-49,2059,2097,4156,"Indiana, PA",40.651432,-79.087545,82886
4341,26860,50-54,2420,2578,4998,"Indiana, PA",40.651432,-79.087545,82886
4342,26860,55-59,2712,2717,5429,"Indiana, PA",40.651432,-79.087545,82886
4343,26860,60-64,2976,3042,6018,"Indiana, PA",40.651432,-79.087545,82886
4344,26860,65+,9015,7939,16954,"Indiana, PA",40.651432,-79.087545,82886
4345,26900,15-19,68299,72102,140401,"Indianapolis-Carmel-Anderson, IN",39.74867,-86.212382,2126804
4346,26900,20-24,67070,66369,133439,"Indianapolis-Carmel-Anderson, IN",39.74867,-86.212382,2126804
4347,26900,25-29,75697,75174,150871,"Indianapolis-Carmel-Anderson, IN",39.74867,-86.212382,2126804
4348,26900,30-34,77762,75880,153642,"Indianapolis-Carmel-Anderson, IN",39.74867,-86.212382,2126804
4349,26900,35-39,75581,73345,148926,"Indianapolis-Carmel-Anderson, IN",39.74867,-86.212382,2126804
4350,26900,40-44,71290,70552,141842,"Indianapolis-Carmel-Anderson, IN",39.74867,-86.212382,2126804
4351,26900,45-49,64888,64454,129342,"Indianapolis-Carmel-Anderson, IN",39.74867,-86.212382,2126804
4352,26900,50-54,66656,66061,132717,"Indianapolis-Carmel-Anderson, IN",39.74867,-86.212382,2126804
4353,26900,55-59,68026,65735,133761,"Indianapolis-Carmel-Anderson, IN",39.74867,-86.212382,2126804
4354,26900,60-64,66187,62166,128353,"Indianapolis-Carmel-Anderson, IN",39.74867,-86.212382,2126804
4355,26900,65+,169884,135337,305221,"Indianapolis-Carmel-Anderson, IN",39.74867,-86.212382,2126804
4356,26940,15-19,865,894,1759,"Indianola, MS",33.605529,-90.59509,25402
4357,26940,20-24,756,1056,1812,"Indianola, MS",33.605529,-90.59509,25402
4358,26940,25-29,699,1315,2014,"Indianola, MS",33.605529,-90.59509,25402
4359,26940,30-34,746,1295,2041,"Indianola, MS",33.605529,-90.59509,25402
4360,26940,35-39,674,1032,1706,"Indianola, MS",33.605529,-90.59509,25402
4361,26940,40-44,722,970,1692,"Indianola, MS",33.605529,-90.59509,25402
4362,26940,45-49,614,925,1539,"Indianola, MS",33.605529,-90.59509,25402
4363,26940,50-54,726,881,1607,"Indianola, MS",33.605529,-90.59509,25402
4364,26940,55-59,791,791,1582,"Indianola, MS",33.605529,-90.59509,25402
4365,26940,60-64,784,668,1452,"Indianola, MS",33.605529,-90.59509,25402
4366,26940,65+,2166,1613,3779,"Indianola, MS",33.605529,-90.59509,25402
4367,26980,15-19,7428,7021,14449,"Iowa City, IA",41.517806,-91.64793,177239
4368,26980,20-24,12728,11920,24648,"Iowa City, IA",41.517806,-91.64793,177239
4369,26980,25-29,6832,7275,14107,"Iowa City, IA",41.517806,-91.64793,177239
4370,26980,30-34,5666,6033,11699,"Iowa City, IA",41.517806,-91.64793,177239
4371,26980,35-39,5546,5827,11373,"Iowa City, IA",41.517806,-91.64793,177239
4372,26980,40-44,5131,5470,10601,"Iowa City, IA",41.517806,-91.64793,177239
4373,26980,45-49,4207,4614,8821,"Iowa City, IA",41.517806,-91.64793,177239
4374,26980,50-54,4476,4585,9061,"Iowa City, IA",41.517806,-91.64793,177239
4375,26980,55-59,4474,4427,8901,"Iowa City, IA",41.517806,-91.64793,177239
4376,26980,60-64,4627,4415,9042,"Iowa City, IA",41.517806,-91.64793,177239
4377,26980,65+,13329,11068,24397,"Iowa City, IA",41.517806,-91.64793,177239
4378,27020,15-19,741,854,1595,"Iron Mountain, MI-WI",45.947705,-88.08097,30380
4379,27020,20-24,660,758,1418,"Iron Mountain, MI-WI",45.947705,-88.08097,30380
4380,27020,25-29,736,817,1553,"Iron Mountain, MI-WI",45.947705,-88.08097,30380
4381,27020,30-34,733,816,1549,"Iron Mountain, MI-WI",45.947705,-88.08097,30380
4382,27020,35-39,855,910,1765,"Iron Mountain, MI-WI",45.947705,-88.08097,30380
4383,27020,40-44,829,839,1668,"Iron Mountain, MI-WI",45.947705,-88.08097,30380
4384,27020,45-49,760,775,1535,"Iron Mountain, MI-WI",45.947705,-88.08097,30380
4385,27020,50-54,921,1001,1922,"Iron Mountain, MI-WI",45.947705,-88.08097,30380
4386,27020,55-59,1213,1238,2451,"Iron Mountain, MI-WI",45.947705,-88.08097,30380
4387,27020,60-64,1361,1353,2714,"Iron Mountain, MI-WI",45.947705,-88.08097,30380
4388,27020,65+,3851,3664,7515,"Iron Mountain, MI-WI",45.947705,-88.08097,30380
4389,27060,15-19,5985,5864,11849,"Ithaca, NY",42.453006,-76.473483,105162
4390,27060,20-24,8796,9238,18034,"Ithaca, NY",42.453006,-76.473483,105162
4391,27060,25-29,3409,3596,7005,"Ithaca, NY",42.453006,-76.473483,105162
4392,27060,30-34,2986,2916,5902,"Ithaca, NY",42.453006,-76.473483,105162
4393,27060,35-39,3045,2845,5890,"Ithaca, NY",42.453006,-76.473483,105162
4394,27060,40-44,2975,2760,5735,"Ithaca, NY",42.453006,-76.473483,105162
4395,27060,45-49,2494,2464,4958,"Ithaca, NY",42.453006,-76.473483,105162
4396,27060,50-54,2732,2668,5400,"Ithaca, NY",42.453006,-76.473483,105162
4397,27060,55-59,2942,2737,5679,"Ithaca, NY",42.453006,-76.473483,105162
4398,27060,60-64,3069,2786,5855,"Ithaca, NY",42.453006,-76.473483,105162
4399,27060,65+,8900,7654,16554,"Ithaca, NY",42.453006,-76.473483,105162
4400,27100,15-19,4690,5129,9819,"Jackson, MI",42.248474,-84.420868,160050
4401,27100,20-24,4372,5208,9580,"Jackson, MI",42.248474,-84.420868,160050
4402,27100,25-29,4703,5544,10247,"Jackson, MI",42.248474,-84.420868,160050
4403,27100,30-34,4920,5556,10476,"Jackson, MI",42.248474,-84.420868,160050
4404,27100,35-39,4411,5133,9544,"Jackson, MI",42.248474,-84.420868,160050
4405,27100,40-44,4344,5186,9530,"Jackson, MI",42.248474,-84.420868,160050
4406,27100,45-49,4240,5053,9293,"Jackson, MI",42.248474,-84.420868,160050
4407,27100,50-54,5173,5544,10717,"Jackson, MI",42.248474,-84.420868,160050
4408,27100,55-59,5592,5696,11288,"Jackson, MI",42.248474,-84.420868,160050
4409,27100,60-64,5772,5926,11698,"Jackson, MI",42.248474,-84.420868,160050
4410,27100,65+,16126,13803,29929,"Jackson, MI",42.248474,-84.420868,160050
4411,27140,15-19,20145,20778,40923,"Jackson, MS",32.42828,-90.202388,587202
4412,27140,20-24,19345,18524,37869,"Jackson, MS",32.42828,-90.202388,587202
4413,27140,25-29,20050,19253,39303,"Jackson, MS",32.42828,-90.202388,587202
4414,27140,30-34,20276,19492,39768,"Jackson, MS",32.42828,-90.202388,587202
4415,27140,35-39,20237,18998,39235,"Jackson, MS",32.42828,-90.202388,587202
4416,27140,40-44,19852,18769,38621,"Jackson, MS",32.42828,-90.202388,587202
4417,27140,45-49,18502,16950,35452,"Jackson, MS",32.42828,-90.202388,587202
4418,27140,50-54,18818,17457,36275,"Jackson, MS",32.42828,-90.202388,587202
4419,27140,55-59,19556,17798,37354,"Jackson, MS",32.42828,-90.202388,587202
4420,27140,60-64,19929,17387,37316,"Jackson, MS",32.42828,-90.202388,587202
4421,27140,65+,52611,40222,92833,"Jackson, MS",32.42828,-90.202388,587202
4422,27160,15-19,1002,1090,2092,"Jackson, OH",39.013477,-82.614142,32511
4423,27160,20-24,857,923,1780,"Jackson, OH",39.013477,-82.614142,32511
4424,27160,25-29,966,974,1940,"Jackson, OH",39.013477,-82.614142,32511
4425,27160,30-34,1004,1037,2041,"Jackson, OH",39.013477,-82.614142,32511
4426,27160,35-39,984,1009,1993,"Jackson, OH",39.013477,-82.614142,32511
4427,27160,40-44,1038,985,2023,"Jackson, OH",39.013477,-82.614142,32511
4428,27160,45-49,993,1007,2000,"Jackson, OH",39.013477,-82.614142,32511
4429,27160,50-54,1061,1079,2140,"Jackson, OH",39.013477,-82.614142,32511
4430,27160,55-59,1082,1077,2159,"Jackson, OH",39.013477,-82.614142,32511
4431,27160,60-64,1141,1036,2177,"Jackson, OH",39.013477,-82.614142,32511
4432,27160,65+,3225,2584,5809,"Jackson, OH",39.013477,-82.614142,32511
4433,27180,15-19,6604,6215,12819,"Jackson, TN",35.753215,-88.882692,180799
4434,27180,20-24,6078,5782,11860,"Jackson, TN",35.753215,-88.882692,180799
4435,27180,25-29,5842,5499,11341,"Jackson, TN",35.753215,-88.882692,180799
4436,27180,30-34,5858,5152,11010,"Jackson, TN",35.753215,-88.882692,180799
4437,27180,35-39,5517,5064,10581,"Jackson, TN",35.753215,-88.882692,180799
4438,27180,40-44,5572,5165,10737,"Jackson, TN",35.753215,-88.882692,180799
4439,27180,45-49,5421,5035,10456,"Jackson, TN",35.753215,-88.882692,180799
4440,27180,50-54,5705,5400,11105,"Jackson, TN",35.753215,-88.882692,180799
4441,27180,55-59,6339,5827,12166,"Jackson, TN",35.753215,-88.882692,180799
4442,27180,60-64,6336,5682,12018,"Jackson, TN",35.753215,-88.882692,180799
4443,27180,65+,18223,14248,32471,"Jackson, TN",35.753215,-88.882692,180799
4444,27220,15-19,819,981,1800,"Jackson, WY-ID",44.048662,-110.426087,35842
4445,27220,20-24,847,921,1768,"Jackson, WY-ID",44.048662,-110.426087,35842
4446,27220,25-29,1216,1304,2520,"Jackson, WY-ID",44.048662,-110.426087,35842
4447,27220,30-34,1325,1538,2863,"Jackson, WY-ID",44.048662,-110.426087,35842
4448,27220,35-39,1413,1568,2981,"Jackson, WY-ID",44.048662,-110.426087,35842
4449,27220,40-44,1411,1513,2924,"Jackson, WY-ID",44.048662,-110.426087,35842
4450,27220,45-49,1152,1493,2645,"Jackson, WY-ID",44.048662,-110.426087,35842
4451,27220,50-54,1148,1327,2475,"Jackson, WY-ID",44.048662,-110.426087,35842
4452,27220,55-59,1069,1098,2167,"Jackson, WY-ID",44.048662,-110.426087,35842
4453,27220,60-64,1135,1192,2327,"Jackson, WY-ID",44.048662,-110.426087,35842
4454,27220,65+,2718,2936,5654,"Jackson, WY-ID",44.048662,-110.426087,35842
4455,27260,15-19,47341,50136,97477,"Jacksonville, FL",30.236594,-81.754446,1637666
4456,27260,20-24,46657,48591,95248,"Jacksonville, FL",30.236594,-81.754446,1637666
4457,27260,25-29,54789,55130,109919,"Jacksonville, FL",30.236594,-81.754446,1637666
4458,27260,30-34,60603,59177,119780,"Jacksonville, FL",30.236594,-81.754446,1637666
4459,27260,35-39,57823,55744,113567,"Jacksonville, FL",30.236594,-81.754446,1637666
4460,27260,40-44,53270,51586,104856,"Jacksonville, FL",30.236594,-81.754446,1637666
4461,27260,45-49,50019,48323,98342,"Jacksonville, FL",30.236594,-81.754446,1637666
4462,27260,50-54,53021,51423,104444,"Jacksonville, FL",30.236594,-81.754446,1637666
4463,27260,55-59,56844,53064,109908,"Jacksonville, FL",30.236594,-81.754446,1637666
4464,27260,60-64,56686,51656,108342,"Jacksonville, FL",30.236594,-81.754446,1637666
4465,27260,65+,149933,122123,272056,"Jacksonville, FL",30.236594,-81.754446,1637666
4466,27300,15-19,1095,1322,2417,"Jacksonville, IL",39.69395,-90.285047,37442
4467,27300,20-24,1266,1313,2579,"Jacksonville, IL",39.69395,-90.285047,37442
4468,27300,25-29,991,1209,2200,"Jacksonville, IL",39.69395,-90.285047,37442
4469,27300,30-34,1040,1258,2298,"Jacksonville, IL",39.69395,-90.285047,37442
4470,27300,35-39,1055,1364,2419,"Jacksonville, IL",39.69395,-90.285047,37442
4471,27300,40-44,1060,1238,2298,"Jacksonville, IL",39.69395,-90.285047,37442
4472,27300,45-49,995,1113,2108,"Jacksonville, IL",39.69395,-90.285047,37442
4473,27300,50-54,1077,1175,2252,"Jacksonville, IL",39.69395,-90.285047,37442
4474,27300,55-59,1335,1298,2633,"Jacksonville, IL",39.69395,-90.285047,37442
4475,27300,60-64,1386,1376,2762,"Jacksonville, IL",39.69395,-90.285047,37442
4476,27300,65+,4210,3408,7618,"Jacksonville, IL",39.69395,-90.285047,37442
4477,27340,15-19,5418,10824,16242,"Jacksonville, NC",34.763109,-77.499469,206160
4478,27340,20-24,8977,25580,34557,"Jacksonville, NC",34.763109,-77.499469,206160
4479,27340,25-29,8221,11348,19569,"Jacksonville, NC",34.763109,-77.499469,206160
4480,27340,30-34,7729,8314,16043,"Jacksonville, NC",34.763109,-77.499469,206160
4481,27340,35-39,6537,7044,13581,"Jacksonville, NC",34.763109,-77.499469,206160
4482,27340,40-44,5004,4956,9960,"Jacksonville, NC",34.763109,-77.499469,206160
4483,27340,45-49,4039,4016,8055,"Jacksonville, NC",34.763109,-77.499469,206160
4484,27340,50-54,4036,3544,7580,"Jacksonville, NC",34.763109,-77.499469,206160
4485,27340,55-59,4462,3862,8324,"Jacksonville, NC",34.763109,-77.499469,206160
4486,27340,60-64,4483,3952,8435,"Jacksonville, NC",34.763109,-77.499469,206160
4487,27340,65+,11153,9229,20382,"Jacksonville, NC",34.763109,-77.499469,206160
4488,27380,15-19,1709,2089,3798,"Jacksonville, TX",31.843881,-95.156343,51097
4489,27380,20-24,1441,1842,3283,"Jacksonville, TX",31.843881,-95.156343,51097
4490,27380,25-29,1386,1666,3052,"Jacksonville, TX",31.843881,-95.156343,51097
4491,27380,30-34,1505,1578,3083,"Jacksonville, TX",31.843881,-95.156343,51097
4492,27380,35-39,1388,1491,2879,"Jacksonville, TX",31.843881,-95.156343,51097
4493,27380,40-44,1464,1567,3031,"Jacksonville, TX",31.843881,-95.156343,51097
4494,27380,45-49,1431,1687,3118,"Jacksonville, TX",31.843881,-95.156343,51097
4495,27380,50-54,1421,1618,3039,"Jacksonville, TX",31.843881,-95.156343,51097
4496,27380,55-59,1495,1580,3075,"Jacksonville, TX",31.843881,-95.156343,51097
4497,27380,60-64,1501,1454,2955,"Jacksonville, TX",31.843881,-95.156343,51097
4498,27380,65+,4853,4256,9109,"Jacksonville, TX",31.843881,-95.156343,51097
4499,27420,15-19,682,715,1397,"Jamestown, ND",46.972223,-98.956123,21576
4500,27420,20-24,718,810,1528,"Jamestown, ND",46.972223,-98.956123,21576
4501,27420,25-29,578,756,1334,"Jamestown, ND",46.972223,-98.956123,21576
4502,27420,30-34,571,728,1299,"Jamestown, ND",46.972223,-98.956123,21576
4503,27420,35-39,600,744,1344,"Jamestown, ND",46.972223,-98.956123,21576
4504,27420,40-44,588,718,1306,"Jamestown, ND",46.972223,-98.956123,21576
4505,27420,45-49,530,594,1124,"Jamestown, ND",46.972223,-98.956123,21576
4506,27420,50-54,570,660,1230,"Jamestown, ND",46.972223,-98.956123,21576
4507,27420,55-59,670,713,1383,"Jamestown, ND",46.972223,-98.956123,21576
4508,27420,60-64,807,867,1674,"Jamestown, ND",46.972223,-98.956123,21576
4509,27420,65+,2311,1959,4270,"Jamestown, ND",46.972223,-98.956123,21576
4510,27460,15-19,4288,4417,8705,"Jamestown-Dunkirk-Fredonia, NY",42.304216,-79.407595,126807
4511,27460,20-24,3726,4054,7780,"Jamestown-Dunkirk-Fredonia, NY",42.304216,-79.407595,126807
4512,27460,25-29,3290,3755,7045,"Jamestown-Dunkirk-Fredonia, NY",42.304216,-79.407595,126807
4513,27460,30-34,3695,3751,7446,"Jamestown-Dunkirk-Fredonia, NY",42.304216,-79.407595,126807
4514,27460,35-39,3531,3652,7183,"Jamestown-Dunkirk-Fredonia, NY",42.304216,-79.407595,126807
4515,27460,40-44,3455,3445,6900,"Jamestown-Dunkirk-Fredonia, NY",42.304216,-79.407595,126807
4516,27460,45-49,3445,3391,6836,"Jamestown-Dunkirk-Fredonia, NY",42.304216,-79.407595,126807
4517,27460,50-54,3924,4084,8008,"Jamestown-Dunkirk-Fredonia, NY",42.304216,-79.407595,126807
4518,27460,55-59,4543,4535,9078,"Jamestown-Dunkirk-Fredonia, NY",42.304216,-79.407595,126807
4519,27460,60-64,4983,4912,9895,"Jamestown-Dunkirk-Fredonia, NY",42.304216,-79.407595,126807
4520,27460,65+,14411,12399,26810,"Jamestown-Dunkirk-Fredonia, NY",42.304216,-79.407595,126807
4521,27500,15-19,5305,5487,10792,"Janesville-Beloit, WI",42.66988,-89.075284,164381
4522,27500,20-24,4806,5011,9817,"Janesville-Beloit, WI",42.66988,-89.075284,164381
4523,27500,25-29,5065,5198,10263,"Janesville-Beloit, WI",42.66988,-89.075284,164381
4524,27500,30-34,4913,4974,9887,"Janesville-Beloit, WI",42.66988,-89.075284,164381
4525,27500,35-39,5359,5230,10589,"Janesville-Beloit, WI",42.66988,-89.075284,164381
4526,27500,40-44,5059,5253,10312,"Janesville-Beloit, WI",42.66988,-89.075284,164381
4527,27500,45-49,4843,4788,9631,"Janesville-Beloit, WI",42.66988,-89.075284,164381
4528,27500,50-54,5359,5424,10783,"Janesville-Beloit, WI",42.66988,-89.075284,164381
4529,27500,55-59,5897,5789,11686,"Janesville-Beloit, WI",42.66988,-89.075284,164381
4530,27500,60-64,5856,5727,11583,"Janesville-Beloit, WI",42.66988,-89.075284,164381
4531,27500,65+,15584,12923,28507,"Janesville-Beloit, WI",42.66988,-89.075284,164381
4532,27530,15-19,1763,1966,3729,"Jasper, AL",33.791558,-87.301094,64818
4533,27530,20-24,1831,1819,3650,"Jasper, AL",33.791558,-87.301094,64818
4534,27530,25-29,1947,2036,3983,"Jasper, AL",33.791558,-87.301094,64818
4535,27530,30-34,1989,1954,3943,"Jasper, AL",33.791558,-87.301094,64818
4536,27530,35-39,1740,1693,3433,"Jasper, AL",33.791558,-87.301094,64818
4537,27530,40-44,1961,1858,3819,"Jasper, AL",33.791558,-87.301094,64818
4538,27530,45-49,1922,1949,3871,"Jasper, AL",33.791558,-87.301094,64818
4539,27530,50-54,2126,2225,4351,"Jasper, AL",33.791558,-87.301094,64818
4540,27530,55-59,2272,2250,4522,"Jasper, AL",33.791558,-87.301094,64818
4541,27530,60-64,2413,2142,4555,"Jasper, AL",33.791558,-87.301094,64818
4542,27530,65+,7166,5692,12858,"Jasper, AL",33.791558,-87.301094,64818
4543,27540,15-19,1662,1855,3517,"Jasper, IN",38.384156,-87.035953,55693
4544,27540,20-24,1528,1530,3058,"Jasper, IN",38.384156,-87.035953,55693
4545,27540,25-29,1541,1596,3137,"Jasper, IN",38.384156,-87.035953,55693
4546,27540,30-34,1468,1572,3040,"Jasper, IN",38.384156,-87.035953,55693
4547,27540,35-39,1520,1736,3256,"Jasper, IN",38.384156,-87.035953,55693
4548,27540,40-44,1548,1694,3242,"Jasper, IN",38.384156,-87.035953,55693
4549,27540,45-49,1517,1640,3157,"Jasper, IN",38.384156,-87.035953,55693
4550,27540,50-54,1701,1805,3506,"Jasper, IN",38.384156,-87.035953,55693
4551,27540,55-59,1996,2147,4143,"Jasper, IN",38.384156,-87.035953,55693
4552,27540,60-64,2072,2078,4150,"Jasper, IN",38.384156,-87.035953,55693
4553,27540,65+,5668,4861,10529,"Jasper, IN",38.384156,-87.035953,55693
4554,27600,15-19,2601,2749,5350,"Jefferson, GA",34.130905,-83.562557,80286
4555,27600,20-24,2120,2102,4222,"Jefferson, GA",34.130905,-83.562557,80286
4556,27600,25-29,2488,2473,4961,"Jefferson, GA",34.130905,-83.562557,80286
4557,27600,30-34,2808,2820,5628,"Jefferson, GA",34.130905,-83.562557,80286
4558,27600,35-39,2896,2839,5735,"Jefferson, GA",34.130905,-83.562557,80286
4559,27600,40-44,2833,2892,5725,"Jefferson, GA",34.130905,-83.562557,80286
4560,27600,45-49,2559,2657,5216,"Jefferson, GA",34.130905,-83.562557,80286
4561,27600,50-54,2677,2790,5467,"Jefferson, GA",34.130905,-83.562557,80286
4562,27600,55-59,2535,2615,5150,"Jefferson, GA",34.130905,-83.562557,80286
4563,27600,60-64,2318,2262,4580,"Jefferson, GA",34.130905,-83.562557,80286
4564,27600,65+,6339,5184,11523,"Jefferson, GA",34.130905,-83.562557,80286
4565,27620,15-19,4974,5249,10223,"Jefferson City, MO",38.636885,-92.088876,150706
4566,27620,20-24,4462,4973,9435,"Jefferson City, MO",38.636885,-92.088876,150706
4567,27620,25-29,4285,5100,9385,"Jefferson City, MO",38.636885,-92.088876,150706
4568,27620,30-34,4519,5316,9835,"Jefferson City, MO",38.636885,-92.088876,150706
4569,27620,35-39,4530,5370,9900,"Jefferson City, MO",38.636885,-92.088876,150706
4570,27620,40-44,4435,5178,9613,"Jefferson City, MO",38.636885,-92.088876,150706
4571,27620,45-49,4161,4780,8941,"Jefferson City, MO",38.636885,-92.088876,150706
4572,27620,50-54,4624,5010,9634,"Jefferson City, MO",38.636885,-92.088876,150706
4573,27620,55-59,4997,5179,10176,"Jefferson City, MO",38.636885,-92.088876,150706
4574,27620,60-64,5053,4894,9947,"Jefferson City, MO",38.636885,-92.088876,150706
4575,27620,65+,14186,12186,26372,"Jefferson City, MO",38.636885,-92.088876,150706
4576,27660,15-19,1043,1082,2125,"Jennings, LA",30.269529,-92.816221,32345
4577,27660,20-24,870,952,1822,"Jennings, LA",30.269529,-92.816221,32345
4578,27660,25-29,1038,1056,2094,"Jennings, LA",30.269529,-92.816221,32345
4579,27660,30-34,1048,1020,2068,"Jennings, LA",30.269529,-92.816221,32345
4580,27660,35-39,1059,981,2040,"Jennings, LA",30.269529,-92.816221,32345
4581,27660,40-44,967,994,1961,"Jennings, LA",30.269529,-92.816221,32345
4582,27660,45-49,916,844,1760,"Jennings, LA",30.269529,-92.816221,32345
4583,27660,50-54,941,929,1870,"Jennings, LA",30.269529,-92.816221,32345
4584,27660,55-59,1117,1026,2143,"Jennings, LA",30.269529,-92.816221,32345
4585,27660,60-64,1169,1046,2215,"Jennings, LA",30.269529,-92.816221,32345
4586,27660,65+,2949,2451,5400,"Jennings, LA",30.269529,-92.816221,32345
4587,27700,15-19,905,1003,1908,"Jesup, GA",31.547845,-81.912376,30380
4588,27700,20-24,805,895,1700,"Jesup, GA",31.547845,-81.912376,30380
4589,27700,25-29,879,1062,1941,"Jesup, GA",31.547845,-81.912376,30380
4590,27700,30-34,994,1197,2191,"Jesup, GA",31.547845,-81.912376,30380
4591,27700,35-39,964,1126,2090,"Jesup, GA",31.547845,-81.912376,30380
4592,27700,40-44,878,1067,1945,"Jesup, GA",31.547845,-81.912376,30380
4593,27700,45-49,859,994,1853,"Jesup, GA",31.547845,-81.912376,30380
4594,27700,50-54,938,1032,1970,"Jesup, GA",31.547845,-81.912376,30380
4595,27700,55-59,1019,975,1994,"Jesup, GA",31.547845,-81.912376,30380
4596,27700,60-64,915,921,1836,"Jesup, GA",31.547845,-81.912376,30380
4597,27700,65+,2669,2249,4918,"Jesup, GA",31.547845,-81.912376,30380
4598,27740,15-19,6284,6361,12645,"Johnson City, TN",36.265822,-82.332693,208068
4599,27740,20-24,7976,7583,15559,"Johnson City, TN",36.265822,-82.332693,208068
4600,27740,25-29,6561,6639,13200,"Johnson City, TN",36.265822,-82.332693,208068
4601,27740,30-34,6252,6377,12629,"Johnson City, TN",36.265822,-82.332693,208068
4602,27740,35-39,5825,5902,11727,"Johnson City, TN",36.265822,-82.332693,208068
4603,27740,40-44,5929,5941,11870,"Johnson City, TN",36.265822,-82.332693,208068
4604,27740,45-49,6456,6448,12904,"Johnson City, TN",36.265822,-82.332693,208068
4605,27740,50-54,7044,7155,14199,"Johnson City, TN",36.265822,-82.332693,208068
4606,27740,55-59,7272,7240,14512,"Johnson City, TN",36.265822,-82.332693,208068
4607,27740,60-64,7650,7066,14716,"Johnson City, TN",36.265822,-82.332693,208068
4608,27740,65+,23130,19793,42923,"Johnson City, TN",36.265822,-82.332693,208068
4609,27780,15-19,4131,4380,8511,"Johnstown, PA",40.510227,-78.710477,132167
4610,27780,20-24,3918,4178,8096,"Johnstown, PA",40.510227,-78.710477,132167
4611,27780,25-29,3280,3566,6846,"Johnstown, PA",40.510227,-78.710477,132167
4612,27780,30-34,3411,3607,7018,"Johnstown, PA",40.510227,-78.710477,132167
4613,27780,35-39,3355,3495,6850,"Johnstown, PA",40.510227,-78.710477,132167
4614,27780,40-44,3567,3679,7246,"Johnstown, PA",40.510227,-78.710477,132167
4615,27780,45-49,3731,3869,7600,"Johnstown, PA",40.510227,-78.710477,132167
4616,27780,50-54,4174,4362,8536,"Johnstown, PA",40.510227,-78.710477,132167
4617,27780,55-59,4601,4694,9295,"Johnstown, PA",40.510227,-78.710477,132167
4618,27780,60-64,5231,5171,10402,"Johnstown, PA",40.510227,-78.710477,132167
4619,27780,65+,16961,14059,31020,"Johnstown, PA",40.510227,-78.710477,132167
4620,27860,15-19,4908,5052,9960,"Jonesboro, AR",35.696978,-90.650175,134878
4621,27860,20-24,4714,4881,9595,"Jonesboro, AR",35.696978,-90.650175,134878
4622,27860,25-29,4944,4671,9615,"Jonesboro, AR",35.696978,-90.650175,134878
4623,27860,30-34,5226,4862,10088,"Jonesboro, AR",35.696978,-90.650175,134878
4624,27860,35-39,4494,4276,8770,"Jonesboro, AR",35.696978,-90.650175,134878
4625,27860,40-44,4458,4208,8666,"Jonesboro, AR",35.696978,-90.650175,134878
4626,27860,45-49,3821,3807,7628,"Jonesboro, AR",35.696978,-90.650175,134878
4627,27860,50-54,3911,3803,7714,"Jonesboro, AR",35.696978,-90.650175,134878
4628,27860,55-59,3999,3836,7835,"Jonesboro, AR",35.696978,-90.650175,134878
4629,27860,60-64,3928,3469,7397,"Jonesboro, AR",35.696978,-90.650175,134878
4630,27860,65+,11268,8554,19822,"Jonesboro, AR",35.696978,-90.650175,134878
4631,27900,15-19,6013,6319,12332,"Joplin, MO",37.055546,-94.339736,182541
4632,27900,20-24,5641,5857,11498,"Joplin, MO",37.055546,-94.339736,182541
4633,27900,25-29,5834,6090,11924,"Joplin, MO",37.055546,-94.339736,182541
4634,27900,30-34,6001,5955,11956,"Joplin, MO",37.055546,-94.339736,182541
4635,27900,35-39,5843,5805,11648,"Joplin, MO",37.055546,-94.339736,182541
4636,27900,40-44,5542,5682,11224,"Joplin, MO",37.055546,-94.339736,182541
4637,27900,45-49,5272,5247,10519,"Joplin, MO",37.055546,-94.339736,182541
4638,27900,50-54,5478,5378,10856,"Joplin, MO",37.055546,-94.339736,182541
4639,27900,55-59,5659,5710,11369,"Joplin, MO",37.055546,-94.339736,182541
4640,27900,60-64,5970,5550,11520,"Joplin, MO",37.055546,-94.339736,182541
4641,27900,65+,17162,13761,30923,"Joplin, MO",37.055546,-94.339736,182541
4642,27940,15-19,969,936,1905,"Juneau, AK",58.37291,-134.178445,31973
4643,27940,20-24,906,947,1853,"Juneau, AK",58.37291,-134.178445,31973
4644,27940,25-29,1052,1190,2242,"Juneau, AK",58.37291,-134.178445,31973
4645,27940,30-34,1223,1179,2402,"Juneau, AK",58.37291,-134.178445,31973
4646,27940,35-39,1228,1281,2509,"Juneau, AK",58.37291,-134.178445,31973
4647,27940,40-44,1044,1109,2153,"Juneau, AK",58.37291,-134.178445,31973
4648,27940,45-49,926,1045,1971,"Juneau, AK",58.37291,-134.178445,31973
4649,27940,50-54,1050,1092,2142,"Juneau, AK",58.37291,-134.178445,31973
4650,27940,55-59,1070,1178,2248,"Juneau, AK",58.37291,-134.178445,31973
4651,27940,60-64,1077,1159,2236,"Juneau, AK",58.37291,-134.178445,31973
4652,27940,65+,2494,2369,4863,"Juneau, AK",58.37291,-134.178445,31973
4653,27980,15-19,4368,4585,8953,"Kahului-Wailuku-Lahaina, HI",20.855931,-156.60155,164221
4654,27980,20-24,4052,3803,7855,"Kahului-Wailuku-Lahaina, HI",20.855931,-156.60155,164221
4655,27980,25-29,4473,4302,8775,"Kahului-Wailuku-Lahaina, HI",20.855931,-156.60155,164221
4656,27980,30-34,5256,4854,10110,"Kahului-Wailuku-Lahaina, HI",20.855931,-156.60155,164221
4657,27980,35-39,5752,5740,11492,"Kahului-Wailuku-Lahaina, HI",20.855931,-156.60155,164221
4658,27980,40-44,5456,5763,11219,"Kahului-Wailuku-Lahaina, HI",20.855931,-156.60155,164221
4659,27980,45-49,4900,5091,9991,"Kahului-Wailuku-Lahaina, HI",20.855931,-156.60155,164221
4660,27980,50-54,5328,5475,10803,"Kahului-Wailuku-Lahaina, HI",20.855931,-156.60155,164221
4661,27980,55-59,5685,5565,11250,"Kahului-Wailuku-Lahaina, HI",20.855931,-156.60155,164221
4662,27980,60-64,5882,5851,11733,"Kahului-Wailuku-Lahaina, HI",20.855931,-156.60155,164221
4663,27980,65+,17078,15447,32525,"Kahului-Wailuku-Lahaina, HI",20.855931,-156.60155,164221
4664,28020,15-19,9077,9362,18439,"Kalamazoo-Portage, MI",42.246266,-85.532854,261108
4665,28020,20-24,15566,14714,30280,"Kalamazoo-Portage, MI",42.246266,-85.532854,261108
4666,28020,25-29,9378,9415,18793,"Kalamazoo-Portage, MI",42.246266,-85.532854,261108
4667,28020,30-34,8372,8541,16913,"Kalamazoo-Portage, MI",42.246266,-85.532854,261108
4668,28020,35-39,7924,8153,16077,"Kalamazoo-Portage, MI",42.246266,-85.532854,261108
4669,28020,40-44,7798,7778,15576,"Kalamazoo-Portage, MI",42.246266,-85.532854,261108
4670,28020,45-49,6779,6787,13566,"Kalamazoo-Portage, MI",42.246266,-85.532854,261108
4671,28020,50-54,7186,7165,14351,"Kalamazoo-Portage, MI",42.246266,-85.532854,261108
4672,28020,55-59,7453,6989,14442,"Kalamazoo-Portage, MI",42.246266,-85.532854,261108
4673,28020,60-64,7687,7274,14961,"Kalamazoo-Portage, MI",42.246266,-85.532854,261108
4674,28020,65+,22951,18311,41262,"Kalamazoo-Portage, MI",42.246266,-85.532854,261108
4675,28060,15-19,2880,3295,6175,"Kalispell, MT",48.295422,-114.052059,108454
4676,28060,20-24,2536,2679,5215,"Kalispell, MT",48.295422,-114.052059,108454
4677,28060,25-29,3230,3181,6411,"Kalispell, MT",48.295422,-114.052059,108454
4678,28060,30-34,3463,3462,6925,"Kalispell, MT",48.295422,-114.052059,108454
4679,28060,35-39,3552,3548,7100,"Kalispell, MT",48.295422,-114.052059,108454
4680,28060,40-44,3507,3602,7109,"Kalispell, MT",48.295422,-114.052059,108454
4681,28060,45-49,3014,3184,6198,"Kalispell, MT",48.295422,-114.052059,108454
4682,28060,50-54,3176,3264,6440,"Kalispell, MT",48.295422,-114.052059,108454
4683,28060,55-59,3607,3493,7100,"Kalispell, MT",48.295422,-114.052059,108454
4684,28060,60-64,4277,3925,8202,"Kalispell, MT",48.295422,-114.052059,108454
4685,28060,65+,11489,10720,22209,"Kalispell, MT",48.295422,-114.052059,108454
4686,28100,15-19,4057,4079,8136,"Kankakee, IL",41.13951,-87.861117,106601
4687,28100,20-24,4030,4009,8039,"Kankakee, IL",41.13951,-87.861117,106601
4688,28100,25-29,3259,3331,6590,"Kankakee, IL",41.13951,-87.861117,106601
4689,28100,30-34,3180,3223,6403,"Kankakee, IL",41.13951,-87.861117,106601
4690,28100,35-39,3128,3170,6298,"Kankakee, IL",41.13951,-87.861117,106601
4691,28100,40-44,3235,3216,6451,"Kankakee, IL",41.13951,-87.861117,106601
4692,28100,45-49,3083,3072,6155,"Kankakee, IL",41.13951,-87.861117,106601
4693,28100,50-54,3280,3406,6686,"Kankakee, IL",41.13951,-87.861117,106601
4694,28100,55-59,3469,3451,6920,"Kankakee, IL",41.13951,-87.861117,106601
4695,28100,60-64,3490,3443,6933,"Kankakee, IL",41.13951,-87.861117,106601
4696,28100,65+,9900,8518,18418,"Kankakee, IL",41.13951,-87.861117,106601
4697,28140,15-19,68324,72292,140616,"Kansas City, MO-KS",38.931857,-94.443841,2199490
4698,28140,20-24,63835,63945,127780,"Kansas City, MO-KS",38.931857,-94.443841,2199490
4699,28140,25-29,75340,76233,151573,"Kansas City, MO-KS",38.931857,-94.443841,2199490
4700,28140,30-34,77604,78103,155707,"Kansas City, MO-KS",38.931857,-94.443841,2199490
4701,28140,35-39,78073,77817,155890,"Kansas City, MO-KS",38.931857,-94.443841,2199490
4702,28140,40-44,73053,73566,146619,"Kansas City, MO-KS",38.931857,-94.443841,2199490
4703,28140,45-49,65390,65713,131103,"Kansas City, MO-KS",38.931857,-94.443841,2199490
4704,28140,50-54,67273,68159,135432,"Kansas City, MO-KS",38.931857,-94.443841,2199490
4705,28140,55-59,70996,69092,140088,"Kansas City, MO-KS",38.931857,-94.443841,2199490
4706,28140,60-64,71561,67017,138578,"Kansas City, MO-KS",38.931857,-94.443841,2199490
4707,28140,65+,190615,153580,344195,"Kansas City, MO-KS",38.931857,-94.443841,2199490
4708,28180,15-19,1910,2087,3997,"Kapaa, HI",22.012038,-159.705965,73454
4709,28180,20-24,1644,1715,3359,"Kapaa, HI",22.012038,-159.705965,73454
4710,28180,25-29,2044,2088,4132,"Kapaa, HI",22.012038,-159.705965,73454
4711,28180,30-34,2294,2222,4516,"Kapaa, HI",22.012038,-159.705965,73454
4712,28180,35-39,2415,2466,4881,"Kapaa, HI",22.012038,-159.705965,73454
4713,28180,40-44,2368,2452,4820,"Kapaa, HI",22.012038,-159.705965,73454
4714,28180,45-49,2145,2152,4297,"Kapaa, HI",22.012038,-159.705965,73454
4715,28180,50-54,2246,2281,4527,"Kapaa, HI",22.012038,-159.705965,73454
4716,28180,55-59,2413,2359,4772,"Kapaa, HI",22.012038,-159.705965,73454
4717,28180,60-64,2617,2531,5148,"Kapaa, HI",22.012038,-159.705965,73454
4718,28180,65+,8325,7430,15755,"Kapaa, HI",22.012038,-159.705965,73454
4719,28260,15-19,2130,2253,4383,"Kearney, NE",40.738595,-99.031788,57013
4720,28260,20-24,2765,2897,5662,"Kearney, NE",40.738595,-99.031788,57013
4721,28260,25-29,1845,1928,3773,"Kearney, NE",40.738595,-99.031788,57013
4722,28260,30-34,1689,1750,3439,"Kearney, NE",40.738595,-99.031788,57013
4723,28260,35-39,1795,1945,3740,"Kearney, NE",40.738595,-99.031788,57013
4724,28260,40-44,1677,1817,3494,"Kearney, NE",40.738595,-99.031788,57013
4725,28260,45-49,1390,1492,2882,"Kearney, NE",40.738595,-99.031788,57013
4726,28260,50-54,1424,1481,2905,"Kearney, NE",40.738595,-99.031788,57013
4727,28260,55-59,1580,1518,3098,"Kearney, NE",40.738595,-99.031788,57013
4728,28260,60-64,1697,1659,3356,"Kearney, NE",40.738595,-99.031788,57013
4729,28260,65+,5118,4187,9305,"Kearney, NE",40.738595,-99.031788,57013
4730,28300,15-19,2717,2623,5340,"Keene, NH",42.92546,-72.248183,77329
4731,28300,20-24,2616,2563,5179,"Keene, NH",42.92546,-72.248183,77329
4732,28300,25-29,2198,2250,4448,"Keene, NH",42.92546,-72.248183,77329
4733,28300,30-34,2441,2576,5017,"Keene, NH",42.92546,-72.248183,77329
4734,28300,35-39,2325,2366,4691,"Keene, NH",42.92546,-72.248183,77329
4735,28300,40-44,2029,2075,4104,"Keene, NH",42.92546,-72.248183,77329
4736,28300,45-49,2006,1964,3970,"Keene, NH",42.92546,-72.248183,77329
4737,28300,50-54,2481,2441,4922,"Keene, NH",42.92546,-72.248183,77329
4738,28300,55-59,2869,2819,5688,"Keene, NH",42.92546,-72.248183,77329
4739,28300,60-64,3142,3009,6151,"Keene, NH",42.92546,-72.248183,77329
4740,28300,65+,8817,7728,16545,"Keene, NH",42.92546,-72.248183,77329
4741,28340,15-19,1496,1588,3084,"Kendallville, IN",41.404679,-85.417271,47227
4742,28340,20-24,1359,1443,2802,"Kendallville, IN",41.404679,-85.417271,47227
4743,28340,25-29,1462,1505,2967,"Kendallville, IN",41.404679,-85.417271,47227
4744,28340,30-34,1390,1424,2814,"Kendallville, IN",41.404679,-85.417271,47227
4745,28340,35-39,1369,1457,2826,"Kendallville, IN",41.404679,-85.417271,47227
4746,28340,40-44,1428,1481,2909,"Kendallville, IN",41.404679,-85.417271,47227
4747,28340,45-49,1374,1449,2823,"Kendallville, IN",41.404679,-85.417271,47227
4748,28340,50-54,1437,1548,2985,"Kendallville, IN",41.404679,-85.417271,47227
4749,28340,55-59,1539,1682,3221,"Kendallville, IN",41.404679,-85.417271,47227
4750,28340,60-64,1573,1714,3287,"Kendallville, IN",41.404679,-85.417271,47227
4751,28340,65+,4329,3730,8059,"Kendallville, IN",41.404679,-85.417271,47227
4752,28380,15-19,911,899,1810,"Kennett, MO",36.153025,-90.062254,27717
4753,28380,20-24,788,768,1556,"Kennett, MO",36.153025,-90.062254,27717
4754,28380,25-29,791,748,1539,"Kennett, MO",36.153025,-90.062254,27717
4755,28380,30-34,817,711,1528,"Kennett, MO",36.153025,-90.062254,27717
4756,28380,35-39,790,771,1561,"Kennett, MO",36.153025,-90.062254,27717
4757,28380,40-44,892,775,1667,"Kennett, MO",36.153025,-90.062254,27717
4758,28380,45-49,828,741,1569,"Kennett, MO",36.153025,-90.062254,27717
4759,28380,50-54,840,847,1687,"Kennett, MO",36.153025,-90.062254,27717
4760,28380,55-59,931,853,1784,"Kennett, MO",36.153025,-90.062254,27717
4761,28380,60-64,944,923,1867,"Kennett, MO",36.153025,-90.062254,27717
4762,28380,65+,2959,2171,5130,"Kennett, MO",36.153025,-90.062254,27717
4763,28420,15-19,11006,11624,22630,"Kennewick-Richland, WA",46.364155,-119.254927,308293
4764,28420,20-24,9264,10099,19363,"Kennewick-Richland, WA",46.364155,-119.254927,308293
4765,28420,25-29,10180,10795,20975,"Kennewick-Richland, WA",46.364155,-119.254927,308293
4766,28420,30-34,10613,11289,21902,"Kennewick-Richland, WA",46.364155,-119.254927,308293
4767,28420,35-39,10608,11567,22175,"Kennewick-Richland, WA",46.364155,-119.254927,308293
4768,28420,40-44,9664,10483,20147,"Kennewick-Richland, WA",46.364155,-119.254927,308293
4769,28420,45-49,8247,8878,17125,"Kennewick-Richland, WA",46.364155,-119.254927,308293
4770,28420,50-54,8208,8707,16915,"Kennewick-Richland, WA",46.364155,-119.254927,308293
4771,28420,55-59,8230,8411,16641,"Kennewick-Richland, WA",46.364155,-119.254927,308293
4772,28420,60-64,8346,8301,16647,"Kennewick-Richland, WA",46.364155,-119.254927,308293
4773,28420,65+,22350,20021,42371,"Kennewick-Richland, WA",46.364155,-119.254927,308293
4774,28500,15-19,1504,1647,3151,"Kerrville, TX",30.059953,-99.353339,53161
4775,28500,20-24,1441,1489,2930,"Kerrville, TX",30.059953,-99.353339,53161
4776,28500,25-29,1397,1324,2721,"Kerrville, TX",30.059953,-99.353339,53161
4777,28500,30-34,1398,1378,2776,"Kerrville, TX",30.059953,-99.353339,53161
4778,28500,35-39,1407,1346,2753,"Kerrville, TX",30.059953,-99.353339,53161
4779,28500,40-44,1279,1278,2557,"Kerrville, TX",30.059953,-99.353339,53161
4780,28500,45-49,1307,1244,2551,"Kerrville, TX",30.059953,-99.353339,53161
4781,28500,50-54,1561,1361,2922,"Kerrville, TX",30.059953,-99.353339,53161
4782,28500,55-59,1844,1660,3504,"Kerrville, TX",30.059953,-99.353339,53161
4783,28500,60-64,2276,1959,4235,"Kerrville, TX",30.059953,-99.353339,53161
4784,28500,65+,7921,6870,14791,"Kerrville, TX",30.059953,-99.353339,53161
4785,28540,15-19,371,428,799,"Ketchikan, AK",55.449938,-131.106685,13754
4786,28540,20-24,370,417,787,"Ketchikan, AK",55.449938,-131.106685,13754
4787,28540,25-29,415,507,922,"Ketchikan, AK",55.449938,-131.106685,13754
4788,28540,30-34,476,465,941,"Ketchikan, AK",55.449938,-131.106685,13754
4789,28540,35-39,484,515,999,"Ketchikan, AK",55.449938,-131.106685,13754
4790,28540,40-44,422,482,904,"Ketchikan, AK",55.449938,-131.106685,13754
4791,28540,45-49,384,395,779,"Ketchikan, AK",55.449938,-131.106685,13754
4792,28540,50-54,436,434,870,"Ketchikan, AK",55.449938,-131.106685,13754
4793,28540,55-59,441,522,963,"Ketchikan, AK",55.449938,-131.106685,13754
4794,28540,60-64,509,531,1040,"Ketchikan, AK",55.449938,-131.106685,13754
4795,28540,65+,1227,1211,2438,"Ketchikan, AK",55.449938,-131.106685,13754
4796,28580,15-19,1578,1726,3304,"Key West, FL",25.58612,-81.022603,82170
4797,28580,20-24,1690,1983,3673,"Key West, FL",25.58612,-81.022603,82170
4798,28580,25-29,2159,2401,4560,"Key West, FL",25.58612,-81.022603,82170
4799,28580,30-34,2344,2562,4906,"Key West, FL",25.58612,-81.022603,82170
4800,28580,35-39,2449,2830,5279,"Key West, FL",25.58612,-81.022603,82170
4801,28580,40-44,2380,2683,5063,"Key West, FL",25.58612,-81.022603,82170
4802,28580,45-49,2439,2804,5243,"Key West, FL",25.58612,-81.022603,82170
4803,28580,50-54,2990,3152,6142,"Key West, FL",25.58612,-81.022603,82170
4804,28580,55-59,3304,3662,6966,"Key West, FL",25.58612,-81.022603,82170
4805,28580,60-64,3220,3568,6788,"Key West, FL",25.58612,-81.022603,82170
4806,28580,65+,9422,10083,19505,"Key West, FL",25.58612,-81.022603,82170
4807,28620,15-19,1027,1071,2098,"Kill Devil Hills, NC",35.606269,-75.767536,37826
4808,28620,20-24,800,809,1609,"Kill Devil Hills, NC",35.606269,-75.767536,37826
4809,28620,25-29,835,906,1741,"Kill Devil Hills, NC",35.606269,-75.767536,37826
4810,28620,30-34,948,932,1880,"Kill Devil Hills, NC",35.606269,-75.767536,37826
4811,28620,35-39,1158,1108,2266,"Kill Devil Hills, NC",35.606269,-75.767536,37826
4812,28620,40-44,1162,1180,2342,"Kill Devil Hills, NC",35.606269,-75.767536,37826
4813,28620,45-49,1125,1127,2252,"Kill Devil Hills, NC",35.606269,-75.767536,37826
4814,28620,50-54,1324,1331,2655,"Kill Devil Hills, NC",35.606269,-75.767536,37826
4815,28620,55-59,1577,1415,2992,"Kill Devil Hills, NC",35.606269,-75.767536,37826
4816,28620,60-64,1913,1663,3576,"Kill Devil Hills, NC",35.606269,-75.767536,37826
4817,28620,65+,4590,4249,8839,"Kill Devil Hills, NC",35.606269,-75.767536,37826
4818,28660,15-19,15698,17286,32984,"Killeen-Temple, TX",31.20273,-97.789638,486101
4819,28660,20-24,18039,23001,41040,"Killeen-Temple, TX",31.20273,-97.789638,486101
4820,28660,25-29,19520,21403,40923,"Killeen-Temple, TX",31.20273,-97.789638,486101
4821,28660,30-34,19107,18980,38087,"Killeen-Temple, TX",31.20273,-97.789638,486101
4822,28660,35-39,18136,17734,35870,"Killeen-Temple, TX",31.20273,-97.789638,486101
4823,28660,40-44,16200,15540,31740,"Killeen-Temple, TX",31.20273,-97.789638,486101
4824,28660,45-49,13895,13001,26896,"Killeen-Temple, TX",31.20273,-97.789638,486101
4825,28660,50-54,12726,12137,24863,"Killeen-Temple, TX",31.20273,-97.789638,486101
4826,28660,55-59,12875,11820,24695,"Killeen-Temple, TX",31.20273,-97.789638,486101
4827,28660,60-64,12326,11032,23358,"Killeen-Temple, TX",31.20273,-97.789638,486101
4828,28660,65+,31472,25704,57176,"Killeen-Temple, TX",31.20273,-97.789638,486101
4829,28700,15-19,8304,9008,17312,"Kingsport-Bristol, TN-VA",36.604161,-82.440145,308661
4830,28700,20-24,8147,8349,16496,"Kingsport-Bristol, TN-VA",36.604161,-82.440145,308661
4831,28700,25-29,8747,9293,18040,"Kingsport-Bristol, TN-VA",36.604161,-82.440145,308661
4832,28700,30-34,8895,9142,18037,"Kingsport-Bristol, TN-VA",36.604161,-82.440145,308661
4833,28700,35-39,8492,8585,17077,"Kingsport-Bristol, TN-VA",36.604161,-82.440145,308661
4834,28700,40-44,8962,8694,17656,"Kingsport-Bristol, TN-VA",36.604161,-82.440145,308661
4835,28700,45-49,9744,9643,19387,"Kingsport-Bristol, TN-VA",36.604161,-82.440145,308661
4836,28700,50-54,11032,10924,21956,"Kingsport-Bristol, TN-VA",36.604161,-82.440145,308661
4837,28700,55-59,11469,11312,22781,"Kingsport-Bristol, TN-VA",36.604161,-82.440145,308661
4838,28700,60-64,11779,11074,22853,"Kingsport-Bristol, TN-VA",36.604161,-82.440145,308661
4839,28700,65+,38189,31796,69985,"Kingsport-Bristol, TN-VA",36.604161,-82.440145,308661
4840,28740,15-19,5551,5341,10892,"Kingston, NY",41.947212,-74.265458,182951
4841,28740,20-24,5371,5462,10833,"Kingston, NY",41.947212,-74.265458,182951
4842,28740,25-29,5222,5860,11082,"Kingston, NY",41.947212,-74.265458,182951
4843,28740,30-34,5910,6165,12075,"Kingston, NY",41.947212,-74.265458,182951
4844,28740,35-39,5395,6187,11582,"Kingston, NY",41.947212,-74.265458,182951
4845,28740,40-44,5493,5699,11192,"Kingston, NY",41.947212,-74.265458,182951
4846,28740,45-49,5197,5645,10842,"Kingston, NY",41.947212,-74.265458,182951
4847,28740,50-54,6130,6365,12495,"Kingston, NY",41.947212,-74.265458,182951
4848,28740,55-59,7095,7024,14119,"Kingston, NY",41.947212,-74.265458,182951
4849,28740,60-64,7256,7068,14324,"Kingston, NY",41.947212,-74.265458,182951
4850,28740,65+,20563,17402,37965,"Kingston, NY",41.947212,-74.265458,182951
4851,28780,15-19,1401,1459,2860,"Kingsville, TX",27.113943,-97.568508,30975
4852,28780,20-24,2201,2285,4486,"Kingsville, TX",27.113943,-97.568508,30975
4853,28780,25-29,1107,1269,2376,"Kingsville, TX",27.113943,-97.568508,30975
4854,28780,30-34,831,951,1782,"Kingsville, TX",27.113943,-97.568508,30975
4855,28780,35-39,879,989,1868,"Kingsville, TX",27.113943,-97.568508,30975
4856,28780,40-44,782,808,1590,"Kingsville, TX",27.113943,-97.568508,30975
4857,28780,45-49,714,742,1456,"Kingsville, TX",27.113943,-97.568508,30975
4858,28780,50-54,722,714,1436,"Kingsville, TX",27.113943,-97.568508,30975
4859,28780,55-59,712,703,1415,"Kingsville, TX",27.113943,-97.568508,30975
4860,28780,60-64,638,660,1298,"Kingsville, TX",27.113943,-97.568508,30975
4861,28780,65+,2296,1899,4195,"Kingsville, TX",27.113943,-97.568508,30975
4862,28820,15-19,1588,1808,3396,"Kinston, NC",35.240066,-77.635514,54706
4863,28820,20-24,1508,1535,3043,"Kinston, NC",35.240066,-77.635514,54706
4864,28820,25-29,1623,1633,3256,"Kinston, NC",35.240066,-77.635514,54706
4865,28820,30-34,1656,1460,3116,"Kinston, NC",35.240066,-77.635514,54706
4866,28820,35-39,1535,1361,2896,"Kinston, NC",35.240066,-77.635514,54706
4867,28820,40-44,1562,1434,2996,"Kinston, NC",35.240066,-77.635514,54706
4868,28820,45-49,1582,1505,3087,"Kinston, NC",35.240066,-77.635514,54706
4869,28820,50-54,1774,1583,3357,"Kinston, NC",35.240066,-77.635514,54706
4870,28820,55-59,2012,1867,3879,"Kinston, NC",35.240066,-77.635514,54706
4871,28820,60-64,2183,1918,4101,"Kinston, NC",35.240066,-77.635514,54706
4872,28820,65+,6533,4883,11416,"Kinston, NC",35.240066,-77.635514,54706
4873,28860,15-19,1746,1376,3122,"Kirksville, MO",40.284489,-92.565124,29210
4874,28860,20-24,2743,2412,5155,"Kirksville, MO",40.284489,-92.565124,29210
4875,28860,25-29,821,869,1690,"Kirksville, MO",40.284489,-92.565124,29210
4876,28860,30-34,720,690,1410,"Kirksville, MO",40.284489,-92.565124,29210
4877,28860,35-39,644,686,1330,"Kirksville, MO",40.284489,-92.565124,29210
4878,28860,40-44,658,640,1298,"Kirksville, MO",40.284489,-92.565124,29210
4879,28860,45-49,633,639,1272,"Kirksville, MO",40.284489,-92.565124,29210
4880,28860,50-54,699,756,1455,"Kirksville, MO",40.284489,-92.565124,29210
4881,28860,55-59,803,781,1584,"Kirksville, MO",40.284489,-92.565124,29210
4882,28860,60-64,812,796,1608,"Kirksville, MO",40.284489,-92.565124,29210
4883,28860,65+,2567,2085,4652,"Kirksville, MO",40.284489,-92.565124,29210
4884,28900,15-19,1925,2230,4155,"Klamath Falls, OR",42.683761,-121.646168,70164
4885,28900,20-24,1843,1999,3842,"Klamath Falls, OR",42.683761,-121.646168,70164
4886,28900,25-29,2115,2202,4317,"Klamath Falls, OR",42.683761,-121.646168,70164
4887,28900,30-34,2274,2293,4567,"Klamath Falls, OR",42.683761,-121.646168,70164
4888,28900,35-39,2061,2098,4159,"Klamath Falls, OR",42.683761,-121.646168,70164
4889,28900,40-44,1907,1979,3886,"Klamath Falls, OR",42.683761,-121.646168,70164
4890,28900,45-49,1779,1881,3660,"Klamath Falls, OR",42.683761,-121.646168,70164
4891,28900,50-54,1939,1964,3903,"Klamath Falls, OR",42.683761,-121.646168,70164
4892,28900,55-59,2301,2143,4444,"Klamath Falls, OR",42.683761,-121.646168,70164
4893,28900,60-64,2531,2411,4942,"Klamath Falls, OR",42.683761,-121.646168,70164
4894,28900,65+,7965,7434,15399,"Klamath Falls, OR",42.683761,-121.646168,70164
4895,28940,15-19,26947,28632,55579,"Knoxville, TN",36.014791,-84.206701,893412
4896,28940,20-24,31264,32201,63465,"Knoxville, TN",36.014791,-84.206701,893412
4897,28940,25-29,28946,29521,58467,"Knoxville, TN",36.014791,-84.206701,893412
4898,28940,30-34,28566,28554,57120,"Knoxville, TN",36.014791,-84.206701,893412
4899,28940,35-39,27514,27021,54535,"Knoxville, TN",36.014791,-84.206701,893412
4900,28940,40-44,27108,26871,53979,"Knoxville, TN",36.014791,-84.206701,893412
4901,28940,45-49,26898,26370,53268,"Knoxville, TN",36.014791,-84.206701,893412
4902,28940,50-54,29470,29077,58547,"Knoxville, TN",36.014791,-84.206701,893412
4903,28940,55-59,31315,29423,60738,"Knoxville, TN",36.014791,-84.206701,893412
4904,28940,60-64,30764,29087,59851,"Knoxville, TN",36.014791,-84.206701,893412
4905,28940,65+,92584,75807,168391,"Knoxville, TN",36.014791,-84.206701,893412
4906,29020,15-19,2471,2582,5053,"Kokomo, IN",40.483537,-86.114118,83687
4907,29020,20-24,2502,2452,4954,"Kokomo, IN",40.483537,-86.114118,83687
4908,29020,25-29,2693,2722,5415,"Kokomo, IN",40.483537,-86.114118,83687
4909,29020,30-34,2503,2482,4985,"Kokomo, IN",40.483537,-86.114118,83687
4910,29020,35-39,2441,2288,4729,"Kokomo, IN",40.483537,-86.114118,83687
4911,29020,40-44,2516,2289,4805,"Kokomo, IN",40.483537,-86.114118,83687
4912,29020,45-49,2434,2313,4747,"Kokomo, IN",40.483537,-86.114118,83687
4913,29020,50-54,2560,2594,5154,"Kokomo, IN",40.483537,-86.114118,83687
4914,29020,55-59,2895,2741,5636,"Kokomo, IN",40.483537,-86.114118,83687
4915,29020,60-64,2990,2796,5786,"Kokomo, IN",40.483537,-86.114118,83687
4916,29020,65+,9183,7318,16501,"Kokomo, IN",40.483537,-86.114118,83687
4917,29060,15-19,1659,1807,3466,"Laconia, NH",43.519109,-71.425366,64460
4918,29060,20-24,1494,1632,3126,"Laconia, NH",43.519109,-71.425366,64460
4919,29060,25-29,1680,1831,3511,"Laconia, NH",43.519109,-71.425366,64460
4920,29060,30-34,1698,1807,3505,"Laconia, NH",43.519109,-71.425366,64460
4921,29060,35-39,1830,1757,3587,"Laconia, NH",43.519109,-71.425366,64460
4922,29060,40-44,1882,1847,3729,"Laconia, NH",43.519109,-71.425366,64460
4923,29060,45-49,1806,1814,3620,"Laconia, NH",43.519109,-71.425366,64460
4924,29060,50-54,2202,2147,4349,"Laconia, NH",43.519109,-71.425366,64460
4925,29060,55-59,2729,2640,5369,"Laconia, NH",43.519109,-71.425366,64460
4926,29060,60-64,3052,2997,6049,"Laconia, NH",43.519109,-71.425366,64460
4927,29060,65+,7800,7142,14942,"Laconia, NH",43.519109,-71.425366,64460
4928,29100,15-19,5631,5087,10718,"La Crosse-Onalaska, WI-MN",43.783246,-91.318743,139211
4929,29100,20-24,7616,6802,14418,"La Crosse-Onalaska, WI-MN",43.783246,-91.318743,139211
4930,29100,25-29,4356,4535,8891,"La Crosse-Onalaska, WI-MN",43.783246,-91.318743,139211
4931,29100,30-34,3920,4233,8153,"La Crosse-Onalaska, WI-MN",43.783246,-91.318743,139211
4932,29100,35-39,4093,4410,8503,"La Crosse-Onalaska, WI-MN",43.783246,-91.318743,139211
4933,29100,40-44,3939,4141,8080,"La Crosse-Onalaska, WI-MN",43.783246,-91.318743,139211
4934,29100,45-49,3467,3544,7011,"La Crosse-Onalaska, WI-MN",43.783246,-91.318743,139211
4935,29100,50-54,3847,4029,7876,"La Crosse-Onalaska, WI-MN",43.783246,-91.318743,139211
4936,29100,55-59,4350,4197,8547,"La Crosse-Onalaska, WI-MN",43.783246,-91.318743,139211
4937,29100,60-64,4765,4474,9239,"La Crosse-Onalaska, WI-MN",43.783246,-91.318743,139211
4938,29100,65+,13566,11657,25223,"La Crosse-Onalaska, WI-MN",43.783246,-91.318743,139211
4939,29180,15-19,15207,15807,31014,"Lafayette, LA",29.957773,-92.04935,479212
4940,29180,20-24,14681,14648,29329,"Lafayette, LA",29.957773,-92.04935,479212
4941,29180,25-29,16023,15691,31714,"Lafayette, LA",29.957773,-92.04935,479212
4942,29180,30-34,17900,17229,35129,"Lafayette, LA",29.957773,-92.04935,479212
4943,29180,35-39,16783,16447,33230,"Lafayette, LA",29.957773,-92.04935,479212
4944,29180,40-44,15587,15344,30931,"Lafayette, LA",29.957773,-92.04935,479212
4945,29180,45-49,13542,13141,26683,"Lafayette, LA",29.957773,-92.04935,479212
4946,29180,50-54,14721,13743,28464,"Lafayette, LA",29.957773,-92.04935,479212
4947,29180,55-59,16128,14817,30945,"Lafayette, LA",29.957773,-92.04935,479212
4948,29180,60-64,16327,14973,31300,"Lafayette, LA",29.957773,-92.04935,479212
4949,29180,65+,40190,33058,73248,"Lafayette, LA",29.957773,-92.04935,479212
4950,29200,15-19,9670,10978,20648,"Lafayette-West Lafayette, IN",40.482153,-87.017112,224709
4951,29200,20-24,14954,19144,34098,"Lafayette-West Lafayette, IN",40.482153,-87.017112,224709
4952,29200,25-29,7800,8680,16480,"Lafayette-West Lafayette, IN",40.482153,-87.017112,224709
4953,29200,30-34,6857,7409,14266,"Lafayette-West Lafayette, IN",40.482153,-87.017112,224709
4954,29200,35-39,6124,6482,12606,"Lafayette-West Lafayette, IN",40.482153,-87.017112,224709
4955,29200,40-44,6079,6123,12202,"Lafayette-West Lafayette, IN",40.482153,-87.017112,224709
4956,29200,45-49,5472,5617,11089,"Lafayette-West Lafayette, IN",40.482153,-87.017112,224709
4957,29200,50-54,5746,5769,11515,"Lafayette-West Lafayette, IN",40.482153,-87.017112,224709
4958,29200,55-59,5886,5845,11731,"Lafayette-West Lafayette, IN",40.482153,-87.017112,224709
4959,29200,60-64,5944,5627,11571,"Lafayette-West Lafayette, IN",40.482153,-87.017112,224709
4960,29200,65+,16454,13601,30055,"Lafayette-West Lafayette, IN",40.482153,-87.017112,224709
4961,29260,15-19,930,992,1922,"La Grande, OR",45.304081,-117.999149,26212
4962,29260,20-24,1052,1023,2075,"La Grande, OR",45.304081,-117.999149,26212
4963,29260,25-29,708,803,1511,"La Grande, OR",45.304081,-117.999149,26212
4964,29260,30-34,739,746,1485,"La Grande, OR",45.304081,-117.999149,26212
4965,29260,35-39,808,815,1623,"La Grande, OR",45.304081,-117.999149,26212
4966,29260,40-44,725,799,1524,"La Grande, OR",45.304081,-117.999149,26212
4967,29260,45-49,655,641,1296,"La Grande, OR",45.304081,-117.999149,26212
4968,29260,50-54,640,651,1291,"La Grande, OR",45.304081,-117.999149,26212
4969,29260,55-59,735,703,1438,"La Grande, OR",45.304081,-117.999149,26212
4970,29260,60-64,914,811,1725,"La Grande, OR",45.304081,-117.999149,26212
4971,29260,65+,2940,2655,5595,"La Grande, OR",45.304081,-117.999149,26212
4972,29300,15-19,3234,3497,6731,"LaGrange, GA-AL",32.970298,-85.24416,104261
4973,29300,20-24,3259,3329,6588,"LaGrange, GA-AL",32.970298,-85.24416,104261
4974,29300,25-29,3699,3336,7035,"LaGrange, GA-AL",32.970298,-85.24416,104261
4975,29300,30-34,3663,3333,6996,"LaGrange, GA-AL",32.970298,-85.24416,104261
4976,29300,35-39,3377,2908,6285,"LaGrange, GA-AL",32.970298,-85.24416,104261
4977,29300,40-44,3194,2894,6088,"LaGrange, GA-AL",32.970298,-85.24416,104261
4978,29300,45-49,3351,2886,6237,"LaGrange, GA-AL",32.970298,-85.24416,104261
4979,29300,50-54,3477,3305,6782,"LaGrange, GA-AL",32.970298,-85.24416,104261
4980,29300,55-59,3692,3444,7136,"LaGrange, GA-AL",32.970298,-85.24416,104261
4981,29300,60-64,3524,3234,6758,"LaGrange, GA-AL",32.970298,-85.24416,104261
4982,29300,65+,10067,7689,17756,"LaGrange, GA-AL",32.970298,-85.24416,104261
4983,29340,15-19,6534,6861,13395,"Lake Charles, LA",29.978755,-93.253243,210362
4984,29340,20-24,6148,6322,12470,"Lake Charles, LA",29.978755,-93.253243,210362
4985,29340,25-29,7029,7055,14084,"Lake Charles, LA",29.978755,-93.253243,210362
4986,29340,30-34,7602,7435,15037,"Lake Charles, LA",29.978755,-93.253243,210362
4987,29340,35-39,7018,6864,13882,"Lake Charles, LA",29.978755,-93.253243,210362
4988,29340,40-44,6625,6692,13317,"Lake Charles, LA",29.978755,-93.253243,210362
4989,29340,45-49,5751,5851,11602,"Lake Charles, LA",29.978755,-93.253243,210362
4990,29340,50-54,6275,6204,12479,"Lake Charles, LA",29.978755,-93.253243,210362
4991,29340,55-59,6899,6375,13274,"Lake Charles, LA",29.978755,-93.253243,210362
4992,29340,60-64,7098,6572,13670,"Lake Charles, LA",29.978755,-93.253243,210362
4993,29340,65+,18522,15251,33773,"Lake Charles, LA",29.978755,-93.253243,210362
4994,29380,15-19,1888,2275,4163,"Lake City, FL",30.221651,-82.623371,70385
4995,29380,20-24,1679,2857,4536,"Lake City, FL",30.221651,-82.623371,70385
4996,29380,25-29,1866,2327,4193,"Lake City, FL",30.221651,-82.623371,70385
4997,29380,30-34,2112,2508,4620,"Lake City, FL",30.221651,-82.623371,70385
4998,29380,35-39,2059,2394,4453,"Lake City, FL",30.221651,-82.623371,70385
4999,29380,40-44,1924,2286,4210,"Lake City, FL",30.221651,-82.623371,70385
5000,29380,45-49,1788,2181,3969,"Lake City, FL",30.221651,-82.623371,70385
5001,29380,50-54,2022,2184,4206,"Lake City, FL",30.221651,-82.623371,70385
5002,29380,55-59,2308,2373,4681,"Lake City, FL",30.221651,-82.623371,70385
5003,29380,60-64,2471,2372,4843,"Lake City, FL",30.221651,-82.623371,70385
5004,29380,65+,7389,6461,13850,"Lake City, FL",30.221651,-82.623371,70385
5005,29420,15-19,4770,5196,9966,"Lake Havasu City-Kingman, AZ",35.717705,-113.749689,217692
5006,29420,20-24,4286,4859,9145,"Lake Havasu City-Kingman, AZ",35.717705,-113.749689,217692
5007,29420,25-29,4829,5815,10644,"Lake Havasu City-Kingman, AZ",35.717705,-113.749689,217692
5008,29420,30-34,5431,6065,11496,"Lake Havasu City-Kingman, AZ",35.717705,-113.749689,217692
5009,29420,35-39,4889,5542,10431,"Lake Havasu City-Kingman, AZ",35.717705,-113.749689,217692
5010,29420,40-44,4827,5227,10054,"Lake Havasu City-Kingman, AZ",35.717705,-113.749689,217692
5011,29420,45-49,4780,5166,9946,"Lake Havasu City-Kingman, AZ",35.717705,-113.749689,217692
5012,29420,50-54,6113,6051,12164,"Lake Havasu City-Kingman, AZ",35.717705,-113.749689,217692
5013,29420,55-59,8150,7548,15698,"Lake Havasu City-Kingman, AZ",35.717705,-113.749689,217692
5014,29420,60-64,10078,9592,19670,"Lake Havasu City-Kingman, AZ",35.717705,-113.749689,217692
5015,29420,65+,34646,34443,69089,"Lake Havasu City-Kingman, AZ",35.717705,-113.749689,217692
5016,29460,15-19,23110,24378,47488,"Lakeland-Winter Haven, FL",27.953649,-81.693534,753520
5017,29460,20-24,22224,22141,44365,"Lakeland-Winter Haven, FL",27.953649,-81.693534,753520
5018,29460,25-29,24024,24057,48081,"Lakeland-Winter Haven, FL",27.953649,-81.693534,753520
5019,29460,30-34,25937,26032,51969,"Lakeland-Winter Haven, FL",27.953649,-81.693534,753520
5020,29460,35-39,24294,24508,48802,"Lakeland-Winter Haven, FL",27.953649,-81.693534,753520
5021,29460,40-44,23351,22963,46314,"Lakeland-Winter Haven, FL",27.953649,-81.693534,753520
5022,29460,45-49,22239,21739,43978,"Lakeland-Winter Haven, FL",27.953649,-81.693534,753520
5023,29460,50-54,22234,22317,44551,"Lakeland-Winter Haven, FL",27.953649,-81.693534,753520
5024,29460,55-59,23200,22359,45559,"Lakeland-Winter Haven, FL",27.953649,-81.693534,753520
5025,29460,60-64,23743,21809,45552,"Lakeland-Winter Haven, FL",27.953649,-81.693534,753520
5026,29460,65+,80688,68855,149543,"Lakeland-Winter Haven, FL",27.953649,-81.693534,753520
5027,29500,15-19,364,445,809,"Lamesa, TX",32.742528,-101.948771,12413
5028,29500,20-24,310,658,968,"Lamesa, TX",32.742528,-101.948771,12413
5029,29500,25-29,315,719,1034,"Lamesa, TX",32.742528,-101.948771,12413
5030,29500,30-34,333,613,946,"Lamesa, TX",32.742528,-101.948771,12413
5031,29500,35-39,304,536,840,"Lamesa, TX",32.742528,-101.948771,12413
5032,29500,40-44,330,450,780,"Lamesa, TX",32.742528,-101.948771,12413
5033,29500,45-49,303,385,688,"Lamesa, TX",32.742528,-101.948771,12413
5034,29500,50-54,286,297,583,"Lamesa, TX",32.742528,-101.948771,12413
5035,29500,55-59,304,344,648,"Lamesa, TX",32.742528,-101.948771,12413
5036,29500,60-64,313,331,644,"Lamesa, TX",32.742528,-101.948771,12413
5037,29500,65+,1006,761,1767,"Lamesa, TX",32.742528,-101.948771,12413
5038,29540,15-19,17922,18718,36640,"Lancaster, PA",40.041992,-76.250198,553652
5039,29540,20-24,16754,16846,33600,"Lancaster, PA",40.041992,-76.250198,553652
5040,29540,25-29,17692,17655,35347,"Lancaster, PA",40.041992,-76.250198,553652
5041,29540,30-34,18564,18390,36954,"Lancaster, PA",40.041992,-76.250198,553652
5042,29540,35-39,17026,17273,34299,"Lancaster, PA",40.041992,-76.250198,553652
5043,29540,40-44,15923,15699,31622,"Lancaster, PA",40.041992,-76.250198,553652
5044,29540,45-49,14884,14854,29738,"Lancaster, PA",40.041992,-76.250198,553652
5045,29540,50-54,16150,16182,32332,"Lancaster, PA",40.041992,-76.250198,553652
5046,29540,55-59,18125,17550,35675,"Lancaster, PA",40.041992,-76.250198,553652
5047,29540,60-64,18544,17606,36150,"Lancaster, PA",40.041992,-76.250198,553652
5048,29540,65+,57028,47209,104237,"Lancaster, PA",40.041992,-76.250198,553652
5049,29620,15-19,20287,20146,40433,"Lansing-East Lansing, MI",42.771233,-84.496029,540281
5050,29620,20-24,26280,26366,52646,"Lansing-East Lansing, MI",42.771233,-84.496029,540281
5051,29620,25-29,18349,19047,37396,"Lansing-East Lansing, MI",42.771233,-84.496029,540281
5052,29620,30-34,17332,17577,34909,"Lansing-East Lansing, MI",42.771233,-84.496029,540281
5053,29620,35-39,16390,16732,33122,"Lansing-East Lansing, MI",42.771233,-84.496029,540281
5054,29620,40-44,16012,15970,31982,"Lansing-East Lansing, MI",42.771233,-84.496029,540281
5055,29620,45-49,14791,14298,29089,"Lansing-East Lansing, MI",42.771233,-84.496029,540281
5056,29620,50-54,16280,16100,32380,"Lansing-East Lansing, MI",42.771233,-84.496029,540281
5057,29620,55-59,17401,16593,33994,"Lansing-East Lansing, MI",42.771233,-84.496029,540281
5058,29620,60-64,17775,16577,34352,"Lansing-East Lansing, MI",42.771233,-84.496029,540281
5059,29620,65+,49176,40762,89938,"Lansing-East Lansing, MI",42.771233,-84.496029,540281
5060,29660,15-19,1623,1658,3281,"Laramie, WY",41.665514,-105.721883,37608
5061,29660,20-24,3703,4103,7806,"Laramie, WY",41.665514,-105.721883,37608
5062,29660,25-29,1468,1921,3389,"Laramie, WY",41.665514,-105.721883,37608
5063,29660,30-34,1073,1364,2437,"Laramie, WY",41.665514,-105.721883,37608
5064,29660,35-39,1063,1150,2213,"Laramie, WY",41.665514,-105.721883,37608
5065,29660,40-44,897,1090,1987,"Laramie, WY",41.665514,-105.721883,37608
5066,29660,45-49,784,874,1658,"Laramie, WY",41.665514,-105.721883,37608
5067,29660,50-54,750,804,1554,"Laramie, WY",41.665514,-105.721883,37608
5068,29660,55-59,794,777,1571,"Laramie, WY",41.665514,-105.721883,37608
5069,29660,60-64,917,929,1846,"Laramie, WY",41.665514,-105.721883,37608
5070,29660,65+,2512,2372,4884,"Laramie, WY",41.665514,-105.721883,37608
5071,29700,15-19,11532,12034,23566,"Laredo, TX",27.760799,-99.340752,267945
5072,29700,20-24,10566,10570,21136,"Laredo, TX",27.760799,-99.340752,267945
5073,29700,25-29,9536,10078,19614,"Laredo, TX",27.760799,-99.340752,267945
5074,29700,30-34,8301,8869,17170,"Laredo, TX",27.760799,-99.340752,267945
5075,29700,35-39,7972,8466,16438,"Laredo, TX",27.760799,-99.340752,267945
5076,29700,40-44,8221,8221,16442,"Laredo, TX",27.760799,-99.340752,267945
5077,29700,45-49,8453,8235,16688,"Laredo, TX",27.760799,-99.340752,267945
5078,29700,50-54,7972,7169,15141,"Laredo, TX",27.760799,-99.340752,267945
5079,29700,55-59,6664,6073,12737,"Laredo, TX",27.760799,-99.340752,267945
5080,29700,60-64,5906,5304,11210,"Laredo, TX",27.760799,-99.340752,267945
5081,29700,65+,15008,11687,26695,"Laredo, TX",27.760799,-99.340752,267945
5082,29740,15-19,8891,9104,17995,"Las Cruces, NM",32.349919,-106.834968,221508
5083,29740,20-24,11632,11412,23044,"Las Cruces, NM",32.349919,-106.834968,221508
5084,29740,25-29,7665,8228,15893,"Las Cruces, NM",32.349919,-106.834968,221508
5085,29740,30-34,6467,6779,13246,"Las Cruces, NM",32.349919,-106.834968,221508
5086,29740,35-39,6521,6818,13339,"Las Cruces, NM",32.349919,-106.834968,221508
5087,29740,40-44,5972,6090,12062,"Las Cruces, NM",32.349919,-106.834968,221508
5088,29740,45-49,5834,5295,11129,"Las Cruces, NM",32.349919,-106.834968,221508
5089,29740,50-54,5692,5231,10923,"Las Cruces, NM",32.349919,-106.834968,221508
5090,29740,55-59,6189,5530,11719,"Las Cruces, NM",32.349919,-106.834968,221508
5091,29740,60-64,6546,5627,12173,"Las Cruces, NM",32.349919,-106.834968,221508
5092,29740,65+,19471,17131,36602,"Las Cruces, NM",32.349919,-106.834968,221508
5093,29780,15-19,983,1027,2010,"Las Vegas, NM",35.644067,-104.863027,31346
5094,29780,20-24,906,975,1881,"Las Vegas, NM",35.644067,-104.863027,31346
5095,29780,25-29,905,939,1844,"Las Vegas, NM",35.644067,-104.863027,31346
5096,29780,30-34,832,909,1741,"Las Vegas, NM",35.644067,-104.863027,31346
5097,29780,35-39,817,893,1710,"Las Vegas, NM",35.644067,-104.863027,31346
5098,29780,40-44,858,871,1729,"Las Vegas, NM",35.644067,-104.863027,31346
5099,29780,45-49,858,805,1663,"Las Vegas, NM",35.644067,-104.863027,31346
5100,29780,50-54,910,958,1868,"Las Vegas, NM",35.644067,-104.863027,31346
5101,29780,55-59,1153,1197,2350,"Las Vegas, NM",35.644067,-104.863027,31346
5102,29780,60-64,1252,1317,2569,"Las Vegas, NM",35.644067,-104.863027,31346
5103,29780,65+,4045,3647,7692,"Las Vegas, NM",35.644067,-104.863027,31346
5104,29820,15-19,68351,71702,140053,"Las Vegas-Henderson-Paradise, NV",36.21413,-115.014398,2292476
5105,29820,20-24,66432,68534,134966,"Las Vegas-Henderson-Paradise, NV",36.21413,-115.014398,2292476
5106,29820,25-29,80706,81546,162252,"Las Vegas-Henderson-Paradise, NV",36.21413,-115.014398,2292476
5107,29820,30-34,85830,87348,173178,"Las Vegas-Henderson-Paradise, NV",36.21413,-115.014398,2292476
5108,29820,35-39,82338,84707,167045,"Las Vegas-Henderson-Paradise, NV",36.21413,-115.014398,2292476
5109,29820,40-44,77416,79418,156834,"Las Vegas-Henderson-Paradise, NV",36.21413,-115.014398,2292476
5110,29820,45-49,73651,73856,147507,"Las Vegas-Henderson-Paradise, NV",36.21413,-115.014398,2292476
5111,29820,50-54,73920,76975,150895,"Las Vegas-Henderson-Paradise, NV",36.21413,-115.014398,2292476
5112,29820,55-59,70414,72559,142973,"Las Vegas-Henderson-Paradise, NV",36.21413,-115.014398,2292476
5113,29820,60-64,67027,65603,132630,"Las Vegas-Henderson-Paradise, NV",36.21413,-115.014398,2292476
5114,29820,65+,188441,165378,353819,"Las Vegas-Henderson-Paradise, NV",36.21413,-115.014398,2292476
5115,29860,15-19,2843,2941,5784,"Laurel, MS",31.825465,-89.148054,83035
5116,29860,20-24,2453,2475,4928,"Laurel, MS",31.825465,-89.148054,83035
5117,29860,25-29,2406,2393,4799,"Laurel, MS",31.825465,-89.148054,83035
5118,29860,30-34,2584,2348,4932,"Laurel, MS",31.825465,-89.148054,83035
5119,29860,35-39,2650,2416,5066,"Laurel, MS",31.825465,-89.148054,83035
5120,29860,40-44,2529,2392,4921,"Laurel, MS",31.825465,-89.148054,83035
5121,29860,45-49,2304,2241,4545,"Laurel, MS",31.825465,-89.148054,83035
5122,29860,50-54,2490,2546,5036,"Laurel, MS",31.825465,-89.148054,83035
5123,29860,55-59,2635,2510,5145,"Laurel, MS",31.825465,-89.148054,83035
5124,29860,60-64,2913,2766,5679,"Laurel, MS",31.825465,-89.148054,83035
5125,29860,65+,8447,6827,15274,"Laurel, MS",31.825465,-89.148054,83035
5126,29900,15-19,1024,1130,2154,"Laurinburg, NC",34.840023,-79.477337,34227
5127,29900,20-24,1060,1156,2216,"Laurinburg, NC",34.840023,-79.477337,34227
5128,29900,25-29,1027,1249,2276,"Laurinburg, NC",34.840023,-79.477337,34227
5129,29900,30-34,963,1159,2122,"Laurinburg, NC",34.840023,-79.477337,34227
5130,29900,35-39,909,1091,2000,"Laurinburg, NC",34.840023,-79.477337,34227
5131,29900,40-44,926,951,1877,"Laurinburg, NC",34.840023,-79.477337,34227
5132,29900,45-49,968,1138,2106,"Laurinburg, NC",34.840023,-79.477337,34227
5133,29900,50-54,1019,1010,2029,"Laurinburg, NC",34.840023,-79.477337,34227
5134,29900,55-59,1080,1069,2149,"Laurinburg, NC",34.840023,-79.477337,34227
5135,29900,60-64,1111,1022,2133,"Laurinburg, NC",34.840023,-79.477337,34227
5136,29900,65+,3651,2720,6371,"Laurinburg, NC",34.840023,-79.477337,34227
5137,29940,15-19,5424,5263,10687,"Lawrence, KS",38.896417,-95.290947,119363
5138,29940,20-24,10061,10263,20324,"Lawrence, KS",38.896417,-95.290947,119363
5139,29940,25-29,4237,4497,8734,"Lawrence, KS",38.896417,-95.290947,119363
5140,29940,30-34,3683,4027,7710,"Lawrence, KS",38.896417,-95.290947,119363
5141,29940,35-39,3672,3850,7522,"Lawrence, KS",38.896417,-95.290947,119363
5142,29940,40-44,3530,3743,7273,"Lawrence, KS",38.896417,-95.290947,119363
5143,29940,45-49,2904,2945,5849,"Lawrence, KS",38.896417,-95.290947,119363
5144,29940,50-54,2891,2890,5781,"Lawrence, KS",38.896417,-95.290947,119363
5145,29940,55-59,3008,2840,5848,"Lawrence, KS",38.896417,-95.290947,119363
5146,29940,60-64,3249,2777,6026,"Lawrence, KS",38.896417,-95.290947,119363
5147,29940,65+,8741,7358,16099,"Lawrence, KS",38.896417,-95.290947,119363
5148,29980,15-19,1439,1494,2933,"Lawrenceburg, TN",35.220476,-87.396546,44828
5149,29980,20-24,1165,1293,2458,"Lawrenceburg, TN",35.220476,-87.396546,44828
5150,29980,25-29,1332,1314,2646,"Lawrenceburg, TN",35.220476,-87.396546,44828
5151,29980,30-34,1465,1418,2883,"Lawrenceburg, TN",35.220476,-87.396546,44828
5152,29980,35-39,1275,1259,2534,"Lawrenceburg, TN",35.220476,-87.396546,44828
5153,29980,40-44,1296,1304,2600,"Lawrenceburg, TN",35.220476,-87.396546,44828
5154,29980,45-49,1321,1255,2576,"Lawrenceburg, TN",35.220476,-87.396546,44828
5155,29980,50-54,1500,1509,3009,"Lawrenceburg, TN",35.220476,-87.396546,44828
5156,29980,55-59,1522,1570,3092,"Lawrenceburg, TN",35.220476,-87.396546,44828
5157,29980,60-64,1495,1434,2929,"Lawrenceburg, TN",35.220476,-87.396546,44828
5158,29980,65+,4377,3566,7943,"Lawrenceburg, TN",35.220476,-87.396546,44828
5159,30020,15-19,4081,5055,9136,"Lawton, OK",34.529113,-98.430902,127543
5160,30020,20-24,4326,6478,10804,"Lawton, OK",34.529113,-98.430902,127543
5161,30020,25-29,4584,5819,10403,"Lawton, OK",34.529113,-98.430902,127543
5162,30020,30-34,4615,5392,10007,"Lawton, OK",34.529113,-98.430902,127543
5163,30020,35-39,4270,4711,8981,"Lawton, OK",34.529113,-98.430902,127543
5164,30020,40-44,3748,4013,7761,"Lawton, OK",34.529113,-98.430902,127543
5165,30020,45-49,3162,3278,6440,"Lawton, OK",34.529113,-98.430902,127543
5166,30020,50-54,3238,3275,6513,"Lawton, OK",34.529113,-98.430902,127543
5167,30020,55-59,3561,3609,7170,"Lawton, OK",34.529113,-98.430902,127543
5168,30020,60-64,3788,3595,7383,"Lawton, OK",34.529113,-98.430902,127543
5169,30020,65+,9312,7881,17193,"Lawton, OK",34.529113,-98.430902,127543
5170,30060,15-19,1174,1227,2401,"Lebanon, MO",37.659698,-92.594843,36133
5171,30060,20-24,894,980,1874,"Lebanon, MO",37.659698,-92.594843,36133
5172,30060,25-29,1035,1059,2094,"Lebanon, MO",37.659698,-92.594843,36133
5173,30060,30-34,1058,1031,2089,"Lebanon, MO",37.659698,-92.594843,36133
5174,30060,35-39,1106,1092,2198,"Lebanon, MO",37.659698,-92.594843,36133
5175,30060,40-44,1090,1095,2185,"Lebanon, MO",37.659698,-92.594843,36133
5176,30060,45-49,1036,982,2018,"Lebanon, MO",37.659698,-92.594843,36133
5177,30060,50-54,1156,1182,2338,"Lebanon, MO",37.659698,-92.594843,36133
5178,30060,55-59,1248,1350,2598,"Lebanon, MO",37.659698,-92.594843,36133
5179,30060,60-64,1204,1192,2396,"Lebanon, MO",37.659698,-92.594843,36133
5180,30060,65+,3561,2979,6540,"Lebanon, MO",37.659698,-92.594843,36133
5181,30100,15-19,6588,7076,13664,"Lebanon, NH-VT",43.785726,-72.159142,223471
5182,30100,20-24,6579,7143,13722,"Lebanon, NH-VT",43.785726,-72.159142,223471
5183,30100,25-29,6259,6318,12577,"Lebanon, NH-VT",43.785726,-72.159142,223471
5184,30100,30-34,6611,6789,13400,"Lebanon, NH-VT",43.785726,-72.159142,223471
5185,30100,35-39,6626,6741,13367,"Lebanon, NH-VT",43.785726,-72.159142,223471
5186,30100,40-44,6162,6190,12352,"Lebanon, NH-VT",43.785726,-72.159142,223471
5187,30100,45-49,6181,5966,12147,"Lebanon, NH-VT",43.785726,-72.159142,223471
5188,30100,50-54,7189,7151,14340,"Lebanon, NH-VT",43.785726,-72.159142,223471
5189,30100,55-59,8596,8246,16842,"Lebanon, NH-VT",43.785726,-72.159142,223471
5190,30100,60-64,9620,9210,18830,"Lebanon, NH-VT",43.785726,-72.159142,223471
5191,30100,65+,27013,24369,51382,"Lebanon, NH-VT",43.785726,-72.159142,223471
5192,30140,15-19,4427,4761,9188,"Lebanon, PA",40.371448,-76.464819,143493
5193,30140,20-24,4250,4361,8611,"Lebanon, PA",40.371448,-76.464819,143493
5194,30140,25-29,4020,4101,8121,"Lebanon, PA",40.371448,-76.464819,143493
5195,30140,30-34,4292,4370,8662,"Lebanon, PA",40.371448,-76.464819,143493
5196,30140,35-39,4337,4361,8698,"Lebanon, PA",40.371448,-76.464819,143493
5197,30140,40-44,4283,4325,8608,"Lebanon, PA",40.371448,-76.464819,143493
5198,30140,45-49,4060,4212,8272,"Lebanon, PA",40.371448,-76.464819,143493
5199,30140,50-54,4258,4465,8723,"Lebanon, PA",40.371448,-76.464819,143493
5200,30140,55-59,4911,4797,9708,"Lebanon, PA",40.371448,-76.464819,143493
5201,30140,60-64,4900,4748,9648,"Lebanon, PA",40.371448,-76.464819,143493
5202,30140,65+,15534,12972,28506,"Lebanon, PA",40.371448,-76.464819,143493
5203,30220,15-19,985,946,1931,"Levelland, TX",33.605932,-102.343398,21363
5204,30220,20-24,699,784,1483,"Levelland, TX",33.605932,-102.343398,21363
5205,30220,25-29,620,661,1281,"Levelland, TX",33.605932,-102.343398,21363
5206,30220,30-34,681,745,1426,"Levelland, TX",33.605932,-102.343398,21363
5207,30220,35-39,717,720,1437,"Levelland, TX",33.605932,-102.343398,21363
5208,30220,40-44,654,644,1298,"Levelland, TX",33.605932,-102.343398,21363
5209,30220,45-49,540,558,1098,"Levelland, TX",33.605932,-102.343398,21363
5210,30220,50-54,567,527,1094,"Levelland, TX",33.605932,-102.343398,21363
5211,30220,55-59,655,591,1246,"Levelland, TX",33.605932,-102.343398,21363
5212,30220,60-64,624,625,1249,"Levelland, TX",33.605932,-102.343398,21363
5213,30220,65+,1741,1487,3228,"Levelland, TX",33.605932,-102.343398,21363
5214,30260,15-19,1821,1766,3587,"Lewisburg, PA",40.962179,-77.055475,42568
5215,30260,20-24,1611,2031,3642,"Lewisburg, PA",40.962179,-77.055475,42568
5216,30260,25-29,887,1517,2404,"Lewisburg, PA",40.962179,-77.055475,42568
5217,30260,30-34,1000,1929,2929,"Lewisburg, PA",40.962179,-77.055475,42568
5218,30260,35-39,1083,1917,3000,"Lewisburg, PA",40.962179,-77.055475,42568
5219,30260,40-44,1015,1677,2692,"Lewisburg, PA",40.962179,-77.055475,42568
5220,30260,45-49,1010,1464,2474,"Lewisburg, PA",40.962179,-77.055475,42568
5221,30260,50-54,1119,1459,2578,"Lewisburg, PA",40.962179,-77.055475,42568
5222,30260,55-59,1218,1427,2645,"Lewisburg, PA",40.962179,-77.055475,42568
5223,30260,60-64,1259,1316,2575,"Lewisburg, PA",40.962179,-77.055475,42568
5224,30260,65+,4403,3563,7966,"Lewisburg, PA",40.962179,-77.055475,42568
5225,30280,15-19,1073,1073,2146,"Lewisburg, TN",35.468343,-86.765865,34984
5226,30280,20-24,942,989,1931,"Lewisburg, TN",35.468343,-86.765865,34984
5227,30280,25-29,1104,1089,2193,"Lewisburg, TN",35.468343,-86.765865,34984
5228,30280,30-34,1254,1168,2422,"Lewisburg, TN",35.468343,-86.765865,34984
5229,30280,35-39,1147,1114,2261,"Lewisburg, TN",35.468343,-86.765865,34984
5230,30280,40-44,1074,1103,2177,"Lewisburg, TN",35.468343,-86.765865,34984
5231,30280,45-49,1118,1075,2193,"Lewisburg, TN",35.468343,-86.765865,34984
5232,30280,50-54,1183,1216,2399,"Lewisburg, TN",35.468343,-86.765865,34984
5233,30280,55-59,1251,1213,2464,"Lewisburg, TN",35.468343,-86.765865,34984
5234,30280,60-64,1198,1121,2319,"Lewisburg, TN",35.468343,-86.765865,34984
5235,30280,65+,3120,2622,5742,"Lewisburg, TN",35.468343,-86.765865,34984
5236,30300,15-19,1871,1953,3824,"Lewiston, ID-WA",46.251696,-116.925017,64851
5237,30300,20-24,1769,1839,3608,"Lewiston, ID-WA",46.251696,-116.925017,64851
5238,30300,25-29,1889,1933,3822,"Lewiston, ID-WA",46.251696,-116.925017,64851
5239,30300,30-34,2014,2012,4026,"Lewiston, ID-WA",46.251696,-116.925017,64851
5240,30300,35-39,1965,1975,3940,"Lewiston, ID-WA",46.251696,-116.925017,64851
5241,30300,40-44,1887,1848,3735,"Lewiston, ID-WA",46.251696,-116.925017,64851
5242,30300,45-49,1727,1794,3521,"Lewiston, ID-WA",46.251696,-116.925017,64851
5243,30300,50-54,1971,1901,3872,"Lewiston, ID-WA",46.251696,-116.925017,64851
5244,30300,55-59,2175,2067,4242,"Lewiston, ID-WA",46.251696,-116.925017,64851
5245,30300,60-64,2513,2324,4837,"Lewiston, ID-WA",46.251696,-116.925017,64851
5246,30300,65+,7571,6699,14270,"Lewiston, ID-WA",46.251696,-116.925017,64851
5247,30340,15-19,3444,3561,7005,"Lewiston-Auburn, ME",44.167681,-70.207435,111034
5248,30340,20-24,3301,3386,6687,"Lewiston-Auburn, ME",44.167681,-70.207435,111034
5249,30340,25-29,3348,3376,6724,"Lewiston-Auburn, ME",44.167681,-70.207435,111034
5250,30340,30-34,3604,3577,7181,"Lewiston-Auburn, ME",44.167681,-70.207435,111034
5251,30340,35-39,3563,3420,6983,"Lewiston-Auburn, ME",44.167681,-70.207435,111034
5252,30340,40-44,3438,3358,6796,"Lewiston-Auburn, ME",44.167681,-70.207435,111034
5253,30340,45-49,3219,3121,6340,"Lewiston-Auburn, ME",44.167681,-70.207435,111034
5254,30340,50-54,3685,3682,7367,"Lewiston-Auburn, ME",44.167681,-70.207435,111034
5255,30340,55-59,4069,4088,8157,"Lewiston-Auburn, ME",44.167681,-70.207435,111034
5256,30340,60-64,4045,3884,7929,"Lewiston-Auburn, ME",44.167681,-70.207435,111034
5257,30340,65+,11039,9279,20318,"Lewiston-Auburn, ME",44.167681,-70.207435,111034
5258,30380,15-19,1298,1383,2681,"Lewistown, PA",40.601615,-77.651832,46136
5259,30380,20-24,1173,1214,2387,"Lewistown, PA",40.601615,-77.651832,46136
5260,30380,25-29,1265,1357,2622,"Lewistown, PA",40.601615,-77.651832,46136
5261,30380,30-34,1273,1352,2625,"Lewistown, PA",40.601615,-77.651832,46136
5262,30380,35-39,1202,1274,2476,"Lewistown, PA",40.601615,-77.651832,46136
5263,30380,40-44,1278,1218,2496,"Lewistown, PA",40.601615,-77.651832,46136
5264,30380,45-49,1254,1231,2485,"Lewistown, PA",40.601615,-77.651832,46136
5265,30380,50-54,1544,1508,3052,"Lewistown, PA",40.601615,-77.651832,46136
5266,30380,55-59,1630,1705,3335,"Lewistown, PA",40.601615,-77.651832,46136
5267,30380,60-64,1610,1627,3237,"Lewistown, PA",40.601615,-77.651832,46136
5268,30380,65+,5551,4505,10056,"Lewistown, PA",40.601615,-77.651832,46136
5269,30420,15-19,884,962,1846,"Lexington, NE",40.756816,-99.821978,25722
5270,30420,20-24,711,686,1397,"Lexington, NE",40.756816,-99.821978,25722
5271,30420,25-29,747,823,1570,"Lexington, NE",40.756816,-99.821978,25722
5272,30420,30-34,685,917,1602,"Lexington, NE",40.756816,-99.821978,25722
5273,30420,35-39,724,879,1603,"Lexington, NE",40.756816,-99.821978,25722
5274,30420,40-44,704,787,1491,"Lexington, NE",40.756816,-99.821978,25722
5275,30420,45-49,682,730,1412,"Lexington, NE",40.756816,-99.821978,25722
5276,30420,50-54,667,807,1474,"Lexington, NE",40.756816,-99.821978,25722
5277,30420,55-59,653,822,1475,"Lexington, NE",40.756816,-99.821978,25722
5278,30420,60-64,764,832,1596,"Lexington, NE",40.756816,-99.821978,25722
5279,30420,65+,2332,2210,4542,"Lexington, NE",40.756816,-99.821978,25722
5280,30460,15-19,18097,18079,36176,"Lexington-Fayette, KY",38.102876,-84.438545,517846
5281,30460,20-24,22948,21995,44943,"Lexington-Fayette, KY",38.102876,-84.438545,517846
5282,30460,25-29,18587,19020,37607,"Lexington-Fayette, KY",38.102876,-84.438545,517846
5283,30460,30-34,17547,17675,35222,"Lexington-Fayette, KY",38.102876,-84.438545,517846
5284,30460,35-39,17012,16838,33850,"Lexington-Fayette, KY",38.102876,-84.438545,517846
5285,30460,40-44,16737,16661,33398,"Lexington-Fayette, KY",38.102876,-84.438545,517846
5286,30460,45-49,15708,15585,31293,"Lexington-Fayette, KY",38.102876,-84.438545,517846
5287,30460,50-54,15525,15696,31221,"Lexington-Fayette, KY",38.102876,-84.438545,517846
5288,30460,55-59,16153,15453,31606,"Lexington-Fayette, KY",38.102876,-84.438545,517846
5289,30460,60-64,16128,14604,30732,"Lexington-Fayette, KY",38.102876,-84.438545,517846
5290,30460,65+,43969,34817,78786,"Lexington-Fayette, KY",38.102876,-84.438545,517846
5291,30580,15-19,926,1000,1926,"Liberal, KS",37.18096,-100.855257,21747
5292,30580,20-24,751,844,1595,"Liberal, KS",37.18096,-100.855257,21747
5293,30580,25-29,755,818,1573,"Liberal, KS",37.18096,-100.855257,21747
5294,30580,30-34,684,773,1457,"Liberal, KS",37.18096,-100.855257,21747
5295,30580,35-39,638,691,1329,"Liberal, KS",37.18096,-100.855257,21747
5296,30580,40-44,568,673,1241,"Liberal, KS",37.18096,-100.855257,21747
5297,30580,45-49,581,634,1215,"Liberal, KS",37.18096,-100.855257,21747
5298,30580,50-54,594,626,1220,"Liberal, KS",37.18096,-100.855257,21747
5299,30580,55-59,509,613,1122,"Liberal, KS",37.18096,-100.855257,21747
5300,30580,60-64,528,536,1064,"Liberal, KS",37.18096,-100.855257,21747
5301,30580,65+,1293,1098,2391,"Liberal, KS",37.18096,-100.855257,21747
5302,30620,15-19,3309,3969,7278,"Lima, OH",40.771627,-84.106103,101670
5303,30620,20-24,3155,3777,6932,"Lima, OH",40.771627,-84.106103,101670
5304,30620,25-29,2886,3432,6318,"Lima, OH",40.771627,-84.106103,101670
5305,30620,30-34,2974,3270,6244,"Lima, OH",40.771627,-84.106103,101670
5306,30620,35-39,2898,3021,5919,"Lima, OH",40.771627,-84.106103,101670
5307,30620,40-44,3044,3107,6151,"Lima, OH",40.771627,-84.106103,101670
5308,30620,45-49,2719,2901,5620,"Lima, OH",40.771627,-84.106103,101670
5309,30620,50-54,2852,3167,6019,"Lima, OH",40.771627,-84.106103,101670
5310,30620,55-59,3262,3282,6544,"Lima, OH",40.771627,-84.106103,101670
5311,30620,60-64,3462,3327,6789,"Lima, OH",40.771627,-84.106103,101670
5312,30620,65+,10141,8397,18538,"Lima, OH",40.771627,-84.106103,101670
5313,30660,15-19,869,969,1838,"Lincoln, IL",40.129277,-89.365309,27992
5314,30660,20-24,867,1069,1936,"Lincoln, IL",40.129277,-89.365309,27992
5315,30660,25-29,869,1114,1983,"Lincoln, IL",40.129277,-89.365309,27992
5316,30660,30-34,877,1084,1961,"Lincoln, IL",40.129277,-89.365309,27992
5317,30660,35-39,873,1078,1951,"Lincoln, IL",40.129277,-89.365309,27992
5318,30660,40-44,932,1001,1933,"Lincoln, IL",40.129277,-89.365309,27992
5319,30660,45-49,791,810,1601,"Lincoln, IL",40.129277,-89.365309,27992
5320,30660,50-54,795,874,1669,"Lincoln, IL",40.129277,-89.365309,27992
5321,30660,55-59,844,865,1709,"Lincoln, IL",40.129277,-89.365309,27992
5322,30660,60-64,918,934,1852,"Lincoln, IL",40.129277,-89.365309,27992
5323,30660,65+,2887,2295,5182,"Lincoln, IL",40.129277,-89.365309,27992
5324,30700,15-19,13203,13532,26735,"Lincoln, NE",40.817429,-96.868801,342117
5325,30700,20-24,18197,18765,36962,"Lincoln, NE",40.817429,-96.868801,342117
5326,30700,25-29,11732,12922,24654,"Lincoln, NE",40.817429,-96.868801,342117
5327,30700,30-34,9870,11295,21165,"Lincoln, NE",40.817429,-96.868801,342117
5328,30700,35-39,10895,11745,22640,"Lincoln, NE",40.817429,-96.868801,342117
5329,30700,40-44,10318,10918,21236,"Lincoln, NE",40.817429,-96.868801,342117
5330,30700,45-49,8770,9735,18505,"Lincoln, NE",40.817429,-96.868801,342117
5331,30700,50-54,8685,9275,17960,"Lincoln, NE",40.817429,-96.868801,342117
5332,30700,55-59,9080,9225,18305,"Lincoln, NE",40.817429,-96.868801,342117
5333,30700,60-64,9799,9291,19090,"Lincoln, NE",40.817429,-96.868801,342117
5334,30700,65+,27955,23388,51343,"Lincoln, NE",40.817429,-96.868801,342117
5335,30780,15-19,23367,24286,47653,"Little Rock-North Little Rock-Conway, AR",34.755773,-92.400589,750936
5336,30780,20-24,26454,25288,51742,"Little Rock-North Little Rock-Conway, AR",34.755773,-92.400589,750936
5337,30780,25-29,26410,24868,51278,"Little Rock-North Little Rock-Conway, AR",34.755773,-92.400589,750936
5338,30780,30-34,27225,25146,52371,"Little Rock-North Little Rock-Conway, AR",34.755773,-92.400589,750936
5339,30780,35-39,26100,24380,50480,"Little Rock-North Little Rock-Conway, AR",34.755773,-92.400589,750936
5340,30780,40-44,24847,23589,48436,"Little Rock-North Little Rock-Conway, AR",34.755773,-92.400589,750936
5341,30780,45-49,23251,21525,44776,"Little Rock-North Little Rock-Conway, AR",34.755773,-92.400589,750936
5342,30780,50-54,23028,22208,45236,"Little Rock-North Little Rock-Conway, AR",34.755773,-92.400589,750936
5343,30780,55-59,24146,22392,46538,"Little Rock-North Little Rock-Conway, AR",34.755773,-92.400589,750936
5344,30780,60-64,24319,22248,46567,"Little Rock-North Little Rock-Conway, AR",34.755773,-92.400589,750936
5345,30780,65+,67782,53492,121274,"Little Rock-North Little Rock-Conway, AR",34.755773,-92.400589,750936
5346,30820,15-19,1448,1335,2783,"Lock Haven, PA",41.239508,-77.629009,37465
5347,30820,20-24,2011,1705,3716,"Lock Haven, PA",41.239508,-77.629009,37465
5348,30820,25-29,1044,1233,2277,"Lock Haven, PA",41.239508,-77.629009,37465
5349,30820,30-34,911,1179,2090,"Lock Haven, PA",41.239508,-77.629009,37465
5350,30820,35-39,953,1000,1953,"Lock Haven, PA",41.239508,-77.629009,37465
5351,30820,40-44,1003,981,1984,"Lock Haven, PA",41.239508,-77.629009,37465
5352,30820,45-49,1033,1024,2057,"Lock Haven, PA",41.239508,-77.629009,37465
5353,30820,50-54,1109,1112,2221,"Lock Haven, PA",41.239508,-77.629009,37465
5354,30820,55-59,1157,1228,2385,"Lock Haven, PA",41.239508,-77.629009,37465
5355,30820,60-64,1332,1294,2626,"Lock Haven, PA",41.239508,-77.629009,37465
5356,30820,65+,3887,3326,7213,"Lock Haven, PA",41.239508,-77.629009,37465
5357,30860,15-19,7827,7010,14837,"Logan, UT-ID",41.88902,-111.787438,152083
5358,30860,20-24,10130,10100,20230,"Logan, UT-ID",41.88902,-111.787438,152083
5359,30860,25-29,5570,6365,11935,"Logan, UT-ID",41.88902,-111.787438,152083
5360,30860,30-34,4261,4560,8821,"Logan, UT-ID",41.88902,-111.787438,152083
5361,30860,35-39,4371,4479,8850,"Logan, UT-ID",41.88902,-111.787438,152083
5362,30860,40-44,4561,4598,9159,"Logan, UT-ID",41.88902,-111.787438,152083
5363,30860,45-49,3634,3765,7399,"Logan, UT-ID",41.88902,-111.787438,152083
5364,30860,50-54,2959,3159,6118,"Logan, UT-ID",41.88902,-111.787438,152083
5365,30860,55-59,2924,2864,5788,"Logan, UT-ID",41.88902,-111.787438,152083
5366,30860,60-64,2984,2894,5878,"Logan, UT-ID",41.88902,-111.787438,152083
5367,30860,65+,8258,7537,15795,"Logan, UT-ID",41.88902,-111.787438,152083
5368,30900,15-19,1156,1314,2470,"Logansport, IN",40.753799,-86.355168,37563
5369,30900,20-24,1025,1137,2162,"Logansport, IN",40.753799,-86.355168,37563
5370,30900,25-29,1080,1189,2269,"Logansport, IN",40.753799,-86.355168,37563
5371,30900,30-34,1002,1085,2087,"Logansport, IN",40.753799,-86.355168,37563
5372,30900,35-39,1150,1140,2290,"Logansport, IN",40.753799,-86.355168,37563
5373,30900,40-44,1163,1210,2373,"Logansport, IN",40.753799,-86.355168,37563
5374,30900,45-49,1151,1185,2336,"Logansport, IN",40.753799,-86.355168,37563
5375,30900,50-54,1137,1344,2481,"Logansport, IN",40.753799,-86.355168,37563
5376,30900,55-59,1236,1319,2555,"Logansport, IN",40.753799,-86.355168,37563
5377,30900,60-64,1312,1359,2671,"Logansport, IN",40.753799,-86.355168,37563
5378,30900,65+,3846,3137,6983,"Logansport, IN",40.753799,-86.355168,37563
5379,30940,15-19,4774,5077,9851,"London, KY",36.985916,-83.966066,149615
5380,30940,20-24,4388,4842,9230,"London, KY",36.985916,-83.966066,149615
5381,30940,25-29,4631,4947,9578,"London, KY",36.985916,-83.966066,149615
5382,30940,30-34,4911,5024,9935,"London, KY",36.985916,-83.966066,149615
5383,30940,35-39,4448,4564,9012,"London, KY",36.985916,-83.966066,149615
5384,30940,40-44,4656,4668,9324,"London, KY",36.985916,-83.966066,149615
5385,30940,45-49,4590,4708,9298,"London, KY",36.985916,-83.966066,149615
5386,30940,50-54,4822,4975,9797,"London, KY",36.985916,-83.966066,149615
5387,30940,55-59,5158,4881,10039,"London, KY",36.985916,-83.966066,149615
5388,30940,60-64,4927,4538,9465,"London, KY",36.985916,-83.966066,149615
5389,30940,65+,13762,11267,25029,"London, KY",36.985916,-83.966066,149615
5390,30980,15-19,9449,10566,20015,"Longview, TX",32.431646,-94.684833,287868
5391,30980,20-24,8456,9709,18165,"Longview, TX",32.431646,-94.684833,287868
5392,30980,25-29,8607,9173,17780,"Longview, TX",32.431646,-94.684833,287868
5393,30980,30-34,9158,9248,18406,"Longview, TX",32.431646,-94.684833,287868
5394,30980,35-39,9158,9294,18452,"Longview, TX",32.431646,-94.684833,287868
5395,30980,40-44,8805,9110,17915,"Longview, TX",32.431646,-94.684833,287868
5396,30980,45-49,8042,8365,16407,"Longview, TX",32.431646,-94.684833,287868
5397,30980,50-54,8341,8684,17025,"Longview, TX",32.431646,-94.684833,287868
5398,30980,55-59,9198,8809,18007,"Longview, TX",32.431646,-94.684833,287868
5399,30980,60-64,9427,9176,18603,"Longview, TX",32.431646,-94.684833,287868
5400,30980,65+,26807,22081,48888,"Longview, TX",32.431646,-94.684833,287868
5401,31020,15-19,3192,3352,6544,"Longview, WA",46.196785,-122.67846,111524
5402,31020,20-24,2885,3016,5901,"Longview, WA",46.196785,-122.67846,111524
5403,31020,25-29,3512,3496,7008,"Longview, WA",46.196785,-122.67846,111524
5404,31020,30-34,3651,3667,7318,"Longview, WA",46.196785,-122.67846,111524
5405,31020,35-39,3327,3461,6788,"Longview, WA",46.196785,-122.67846,111524
5406,31020,40-44,3340,3436,6776,"Longview, WA",46.196785,-122.67846,111524
5407,31020,45-49,3121,3280,6401,"Longview, WA",46.196785,-122.67846,111524
5408,31020,50-54,3485,3504,6989,"Longview, WA",46.196785,-122.67846,111524
5409,31020,55-59,3692,3603,7295,"Longview, WA",46.196785,-122.67846,111524
5410,31020,60-64,3996,4010,8006,"Longview, WA",46.196785,-122.67846,111524
5411,31020,65+,11417,10256,21673,"Longview, WA",46.196785,-122.67846,111524
5412,31060,15-19,587,602,1189,"Los Alamos, NM",35.870047,-106.307968,19330
5413,31060,20-24,427,466,893,"Los Alamos, NM",35.870047,-106.307968,19330
5414,31060,25-29,544,648,1192,"Los Alamos, NM",35.870047,-106.307968,19330
5415,31060,30-34,645,799,1444,"Los Alamos, NM",35.870047,-106.307968,19330
5416,31060,35-39,597,794,1391,"Los Alamos, NM",35.870047,-106.307968,19330
5417,31060,40-44,605,648,1253,"Los Alamos, NM",35.870047,-106.307968,19330
5418,31060,45-49,565,548,1113,"Los Alamos, NM",35.870047,-106.307968,19330
5419,31060,50-54,640,609,1249,"Los Alamos, NM",35.870047,-106.307968,19330
5420,31060,55-59,653,729,1382,"Los Alamos, NM",35.870047,-106.307968,19330
5421,31060,60-64,615,694,1309,"Los Alamos, NM",35.870047,-106.307968,19330
5422,31060,65+,1820,1727,3547,"Los Alamos, NM",35.870047,-106.307968,19330
5423,31080,15-19,399697,414142,813839,"Los Angeles-Long Beach-Anaheim, CA",34.108703,-118.182753,12997353
5424,31080,20-24,412485,416301,828786,"Los Angeles-Long Beach-Anaheim, CA",34.108703,-118.182753,12997353
5425,31080,25-29,487109,495832,982941,"Los Angeles-Long Beach-Anaheim, CA",34.108703,-118.182753,12997353
5426,31080,30-34,503673,525267,1028940,"Los Angeles-Long Beach-Anaheim, CA",34.108703,-118.182753,12997353
5427,31080,35-39,454496,475730,930226,"Los Angeles-Long Beach-Anaheim, CA",34.108703,-118.182753,12997353
5428,31080,40-44,428370,434420,862790,"Los Angeles-Long Beach-Anaheim, CA",34.108703,-118.182753,12997353
5429,31080,45-49,424943,418402,843345,"Los Angeles-Long Beach-Anaheim, CA",34.108703,-118.182753,12997353
5430,31080,50-54,440347,440950,881297,"Los Angeles-Long Beach-Anaheim, CA",34.108703,-118.182753,12997353
5431,31080,55-59,427815,422371,850186,"Los Angeles-Long Beach-Anaheim, CA",34.108703,-118.182753,12997353
5432,31080,60-64,398639,382098,780737,"Los Angeles-Long Beach-Anaheim, CA",34.108703,-118.182753,12997353
5433,31080,65+,1077033,858238,1935271,"Los Angeles-Long Beach-Anaheim, CA",34.108703,-118.182753,12997353
5434,31140,15-19,38913,40493,79406,"Louisville/Jefferson County, KY-IN",38.305838,-85.681645,1284566
5435,31140,20-24,37891,38541,76432,"Louisville/Jefferson County, KY-IN",38.305838,-85.681645,1284566
5436,31140,25-29,43247,43761,87008,"Louisville/Jefferson County, KY-IN",38.305838,-85.681645,1284566
5437,31140,30-34,45307,44439,89746,"Louisville/Jefferson County, KY-IN",38.305838,-85.681645,1284566
5438,31140,35-39,42613,42685,85298,"Louisville/Jefferson County, KY-IN",38.305838,-85.681645,1284566
5439,31140,40-44,41736,41493,83229,"Louisville/Jefferson County, KY-IN",38.305838,-85.681645,1284566
5440,31140,45-49,39326,38737,78063,"Louisville/Jefferson County, KY-IN",38.305838,-85.681645,1284566
5441,31140,50-54,41269,40650,81919,"Louisville/Jefferson County, KY-IN",38.305838,-85.681645,1284566
5442,31140,55-59,44114,42208,86322,"Louisville/Jefferson County, KY-IN",38.305838,-85.681645,1284566
5443,31140,60-64,44468,41460,85928,"Louisville/Jefferson County, KY-IN",38.305838,-85.681645,1284566
5444,31140,65+,120002,95649,215651,"Louisville/Jefferson County, KY-IN",38.305838,-85.681645,1284566
5445,31180,15-19,13830,14074,27904,"Lubbock, TX",33.470327,-101.648825,325245
5446,31180,20-24,18756,19685,38441,"Lubbock, TX",33.470327,-101.648825,325245
5447,31180,25-29,12017,12381,24398,"Lubbock, TX",33.470327,-101.648825,325245
5448,31180,30-34,10908,10953,21861,"Lubbock, TX",33.470327,-101.648825,325245
5449,31180,35-39,10564,10935,21499,"Lubbock, TX",33.470327,-101.648825,325245
5450,31180,40-44,9747,9674,19421,"Lubbock, TX",33.470327,-101.648825,325245
5451,31180,45-49,8226,7938,16164,"Lubbock, TX",33.470327,-101.648825,325245
5452,31180,50-54,8211,7774,15985,"Lubbock, TX",33.470327,-101.648825,325245
5453,31180,55-59,8608,7949,16557,"Lubbock, TX",33.470327,-101.648825,325245
5454,31180,60-64,8470,7955,16425,"Lubbock, TX",33.470327,-101.648825,325245
5455,31180,65+,23658,18732,42390,"Lubbock, TX",33.470327,-101.648825,325245
5456,31220,15-19,778,844,1622,"Ludington, MI",43.957196,-86.442937,29383
5457,31220,20-24,653,755,1408,"Ludington, MI",43.957196,-86.442937,29383
5458,31220,25-29,760,811,1571,"Ludington, MI",43.957196,-86.442937,29383
5459,31220,30-34,780,771,1551,"Ludington, MI",43.957196,-86.442937,29383
5460,31220,35-39,772,803,1575,"Ludington, MI",43.957196,-86.442937,29383
5461,31220,40-44,813,797,1610,"Ludington, MI",43.957196,-86.442937,29383
5462,31220,45-49,750,748,1498,"Ludington, MI",43.957196,-86.442937,29383
5463,31220,50-54,882,832,1714,"Ludington, MI",43.957196,-86.442937,29383
5464,31220,55-59,1057,1037,2094,"Ludington, MI",43.957196,-86.442937,29383
5465,31220,60-64,1230,1222,2452,"Ludington, MI",43.957196,-86.442937,29383
5466,31220,65+,3951,3502,7453,"Ludington, MI",43.957196,-86.442937,29383
5467,31260,15-19,3026,3067,6093,"Lufkin, TX",31.251896,-94.611134,86506
5468,31260,20-24,2670,2723,5393,"Lufkin, TX",31.251896,-94.611134,86506
5469,31260,25-29,2768,2654,5422,"Lufkin, TX",31.251896,-94.611134,86506
5470,31260,30-34,2842,2679,5521,"Lufkin, TX",31.251896,-94.611134,86506
5471,31260,35-39,2702,2521,5223,"Lufkin, TX",31.251896,-94.611134,86506
5472,31260,40-44,2632,2530,5162,"Lufkin, TX",31.251896,-94.611134,86506
5473,31260,45-49,2501,2444,4945,"Lufkin, TX",31.251896,-94.611134,86506
5474,31260,50-54,2663,2665,5328,"Lufkin, TX",31.251896,-94.611134,86506
5475,31260,55-59,2631,2834,5465,"Lufkin, TX",31.251896,-94.611134,86506
5476,31260,60-64,2632,2573,5205,"Lufkin, TX",31.251896,-94.611134,86506
5477,31260,65+,8126,6485,14611,"Lufkin, TX",31.251896,-94.611134,86506
5478,31300,15-19,4391,4436,8827,"Lumberton, NC",34.63921,-79.100881,116328
5479,31300,20-24,3955,4027,7982,"Lumberton, NC",34.63921,-79.100881,116328
5480,31300,25-29,3730,3697,7427,"Lumberton, NC",34.63921,-79.100881,116328
5481,31300,30-34,3757,3442,7199,"Lumberton, NC",34.63921,-79.100881,116328
5482,31300,35-39,3433,3079,6512,"Lumberton, NC",34.63921,-79.100881,116328
5483,31300,40-44,3588,3298,6886,"Lumberton, NC",34.63921,-79.100881,116328
5484,31300,45-49,3678,3340,7018,"Lumberton, NC",34.63921,-79.100881,116328
5485,31300,50-54,3677,3489,7166,"Lumberton, NC",34.63921,-79.100881,116328
5486,31300,55-59,3706,3526,7232,"Lumberton, NC",34.63921,-79.100881,116328
5487,31300,60-64,3858,3362,7220,"Lumberton, NC",34.63921,-79.100881,116328
5488,31300,65+,10562,7999,18561,"Lumberton, NC",34.63921,-79.100881,116328
5489,31340,15-19,9701,9116,18817,"Lynchburg, VA",37.364926,-79.216689,262258
5490,31340,20-24,11960,11345,23305,"Lynchburg, VA",37.364926,-79.216689,262258
5491,31340,25-29,8530,8591,17121,"Lynchburg, VA",37.364926,-79.216689,262258
5492,31340,30-34,7908,7900,15808,"Lynchburg, VA",37.364926,-79.216689,262258
5493,31340,35-39,7137,6976,14113,"Lynchburg, VA",37.364926,-79.216689,262258
5494,31340,40-44,6841,6662,13503,"Lynchburg, VA",37.364926,-79.216689,262258
5495,31340,45-49,7089,6811,13900,"Lynchburg, VA",37.364926,-79.216689,262258
5496,31340,50-54,8277,7851,16128,"Lynchburg, VA",37.364926,-79.216689,262258
5497,31340,55-59,9160,8694,17854,"Lynchburg, VA",37.364926,-79.216689,262258
5498,31340,60-64,9459,8867,18326,"Lynchburg, VA",37.364926,-79.216689,262258
5499,31340,65+,27979,23033,51012,"Lynchburg, VA",37.364926,-79.216689,262258
5500,31380,15-19,1413,1224,2637,"Macomb, IL",40.455808,-90.678954,26828
5501,31380,20-24,2115,2220,4335,"Macomb, IL",40.455808,-90.678954,26828
5502,31380,25-29,652,750,1402,"Macomb, IL",40.455808,-90.678954,26828
5503,31380,30-34,655,784,1439,"Macomb, IL",40.455808,-90.678954,26828
5504,31380,35-39,731,694,1425,"Macomb, IL",40.455808,-90.678954,26828
5505,31380,40-44,653,641,1294,"Macomb, IL",40.455808,-90.678954,26828
5506,31380,45-49,591,622,1213,"Macomb, IL",40.455808,-90.678954,26828
5507,31380,50-54,628,620,1248,"Macomb, IL",40.455808,-90.678954,26828
5508,31380,55-59,734,751,1485,"Macomb, IL",40.455808,-90.678954,26828
5509,31380,60-64,844,814,1658,"Macomb, IL",40.455808,-90.678954,26828
5510,31380,65+,2726,2178,4904,"Macomb, IL",40.455808,-90.678954,26828
5511,31420,15-19,7991,8108,16099,"Macon-Bibb County, GA",32.856216,-83.714305,233883
5512,31420,20-24,7923,7601,15524,"Macon-Bibb County, GA",32.856216,-83.714305,233883
5513,31420,25-29,7880,7470,15350,"Macon-Bibb County, GA",32.856216,-83.714305,233883
5514,31420,30-34,8024,7284,15308,"Macon-Bibb County, GA",32.856216,-83.714305,233883
5515,31420,35-39,7381,6645,14026,"Macon-Bibb County, GA",32.856216,-83.714305,233883
5516,31420,40-44,7210,6719,13929,"Macon-Bibb County, GA",32.856216,-83.714305,233883
5517,31420,45-49,7078,6429,13507,"Macon-Bibb County, GA",32.856216,-83.714305,233883
5518,31420,50-54,7376,6828,14204,"Macon-Bibb County, GA",32.856216,-83.714305,233883
5519,31420,55-59,8066,7318,15384,"Macon-Bibb County, GA",32.856216,-83.714305,233883
5520,31420,60-64,8224,7255,15479,"Macon-Bibb County, GA",32.856216,-83.714305,233883
5521,31420,65+,23027,17404,40431,"Macon-Bibb County, GA",32.856216,-83.714305,233883
5522,31460,15-19,5832,5904,11736,"Madera, CA",37.209821,-119.749802,159410
5523,31460,20-24,5377,5091,10468,"Madera, CA",37.209821,-119.749802,159410
5524,31460,25-29,5813,5055,10868,"Madera, CA",37.209821,-119.749802,159410
5525,31460,30-34,5823,5323,11146,"Madera, CA",37.209821,-119.749802,159410
5526,31460,35-39,5694,5110,10804,"Madera, CA",37.209821,-119.749802,159410
5527,31460,40-44,5493,4719,10212,"Madera, CA",37.209821,-119.749802,159410
5528,31460,45-49,4986,4207,9193,"Madera, CA",37.209821,-119.749802,159410
5529,31460,50-54,4511,4312,8823,"Madera, CA",37.209821,-119.749802,159410
5530,31460,55-59,4345,4324,8669,"Madera, CA",37.209821,-119.749802,159410
5531,31460,60-64,4389,4205,8594,"Madera, CA",37.209821,-119.749802,159410
5532,31460,65+,11954,10786,22740,"Madera, CA",37.209821,-119.749802,159410
5533,31500,15-19,1094,1038,2132,"Madison, IN",38.783604,-85.44009,33141
5534,31500,20-24,1162,1108,2270,"Madison, IN",38.783604,-85.44009,33141
5535,31500,25-29,1114,926,2040,"Madison, IN",38.783604,-85.44009,33141
5536,31500,30-34,1010,913,1923,"Madison, IN",38.783604,-85.44009,33141
5537,31500,35-39,1043,921,1964,"Madison, IN",38.783604,-85.44009,33141
5538,31500,40-44,1053,983,2036,"Madison, IN",38.783604,-85.44009,33141
5539,31500,45-49,1020,972,1992,"Madison, IN",38.783604,-85.44009,33141
5540,31500,50-54,1080,1079,2159,"Madison, IN",38.783604,-85.44009,33141
5541,31500,55-59,1199,1191,2390,"Madison, IN",38.783604,-85.44009,33141
5542,31500,60-64,1267,1230,2497,"Madison, IN",38.783604,-85.44009,33141
5543,31500,65+,3304,2918,6222,"Madison, IN",38.783604,-85.44009,33141
5544,31540,15-19,22270,22732,45002,"Madison, WI",43.083846,-89.597745,683183
5545,31540,20-24,31151,31624,62775,"Madison, WI",43.083846,-89.597745,683183
5546,31540,25-29,25177,27575,52752,"Madison, WI",43.083846,-89.597745,683183
5547,31540,30-34,23114,24738,47852,"Madison, WI",43.083846,-89.597745,683183
5548,31540,35-39,23707,25236,48943,"Madison, WI",43.083846,-89.597745,683183
5549,31540,40-44,22157,23100,45257,"Madison, WI",43.083846,-89.597745,683183
5550,31540,45-49,18785,19557,38342,"Madison, WI",43.083846,-89.597745,683183
5551,31540,50-54,19937,20301,40238,"Madison, WI",43.083846,-89.597745,683183
5552,31540,55-59,21104,20555,41659,"Madison, WI",43.083846,-89.597745,683183
5553,31540,60-64,20941,20004,40945,"Madison, WI",43.083846,-89.597745,683183
5554,31540,65+,57141,48861,106002,"Madison, WI",43.083846,-89.597745,683183
5555,31580,15-19,1291,1445,2736,"Madisonville, KY",37.31107,-87.542196,45138
5556,31580,20-24,1186,1222,2408,"Madisonville, KY",37.31107,-87.542196,45138
5557,31580,25-29,1383,1384,2767,"Madisonville, KY",37.31107,-87.542196,45138
5558,31580,30-34,1376,1405,2781,"Madisonville, KY",37.31107,-87.542196,45138
5559,31580,35-39,1349,1316,2665,"Madisonville, KY",37.31107,-87.542196,45138
5560,31580,40-44,1419,1418,2837,"Madisonville, KY",37.31107,-87.542196,45138
5561,31580,45-49,1309,1332,2641,"Madisonville, KY",37.31107,-87.542196,45138
5562,31580,50-54,1427,1473,2900,"Madisonville, KY",37.31107,-87.542196,45138
5563,31580,55-59,1549,1489,3038,"Madisonville, KY",37.31107,-87.542196,45138
5564,31580,60-64,1707,1495,3202,"Madisonville, KY",37.31107,-87.542196,45138
5565,31580,65+,4716,3856,8572,"Madisonville, KY",37.31107,-87.542196,45138
5566,31620,15-19,1153,1102,2255,"Magnolia, AR",33.223038,-93.232843,22672
5567,31620,20-24,1180,1354,2534,"Magnolia, AR",33.223038,-93.232843,22672
5568,31620,25-29,689,626,1315,"Magnolia, AR",33.223038,-93.232843,22672
5569,31620,30-34,623,553,1176,"Magnolia, AR",33.223038,-93.232843,22672
5570,31620,35-39,609,554,1163,"Magnolia, AR",33.223038,-93.232843,22672
5571,31620,40-44,603,578,1181,"Magnolia, AR",33.223038,-93.232843,22672
5572,31620,45-49,600,523,1123,"Magnolia, AR",33.223038,-93.232843,22672
5573,31620,50-54,662,559,1221,"Magnolia, AR",33.223038,-93.232843,22672
5574,31620,55-59,700,674,1374,"Magnolia, AR",33.223038,-93.232843,22672
5575,31620,60-64,704,650,1354,"Magnolia, AR",33.223038,-93.232843,22672
5576,31620,65+,2204,1729,3933,"Magnolia, AR",33.223038,-93.232843,22672
5577,31660,15-19,1299,1618,2917,"Malone, NY",44.594376,-74.31067,47456
5578,31660,20-24,1167,2052,3219,"Malone, NY",44.594376,-74.31067,47456
5579,31660,25-29,1218,2136,3354,"Malone, NY",44.594376,-74.31067,47456
5580,31660,30-34,1257,2063,3320,"Malone, NY",44.594376,-74.31067,47456
5581,31660,35-39,1334,1852,3186,"Malone, NY",44.594376,-74.31067,47456
5582,31660,40-44,1161,1789,2950,"Malone, NY",44.594376,-74.31067,47456
5583,31660,45-49,1182,1624,2806,"Malone, NY",44.594376,-74.31067,47456
5584,31660,50-54,1360,1685,3045,"Malone, NY",44.594376,-74.31067,47456
5585,31660,55-59,1631,1752,3383,"Malone, NY",44.594376,-74.31067,47456
5586,31660,60-64,1655,1760,3415,"Malone, NY",44.594376,-74.31067,47456
5587,31660,65+,4380,4043,8423,"Malone, NY",44.594376,-74.31067,47456
5588,31680,15-19,882,1235,2117,"Malvern, AR",34.315177,-92.944147,33148
5589,31680,20-24,799,1041,1840,"Malvern, AR",34.315177,-92.944147,33148
5590,31680,25-29,887,1187,2074,"Malvern, AR",34.315177,-92.944147,33148
5591,31680,30-34,933,1162,2095,"Malvern, AR",34.315177,-92.944147,33148
5592,31680,35-39,970,1043,2013,"Malvern, AR",34.315177,-92.944147,33148
5593,31680,40-44,1002,1153,2155,"Malvern, AR",34.315177,-92.944147,33148
5594,31680,45-49,1024,1179,2203,"Malvern, AR",34.315177,-92.944147,33148
5595,31680,50-54,989,1156,2145,"Malvern, AR",34.315177,-92.944147,33148
5596,31680,55-59,1143,1262,2405,"Malvern, AR",34.315177,-92.944147,33148
5597,31680,60-64,1107,1145,2252,"Malvern, AR",34.315177,-92.944147,33148
5598,31680,65+,3527,2996,6523,"Malvern, AR",34.315177,-92.944147,33148
5599,31700,15-19,12315,12956,25271,"Manchester-Nashua, NH",42.911532,-71.723055,424079
5600,31700,20-24,12351,13047,25398,"Manchester-Nashua, NH",42.911532,-71.723055,424079
5601,31700,25-29,14331,15505,29836,"Manchester-Nashua, NH",42.911532,-71.723055,424079
5602,31700,30-34,14758,15861,30619,"Manchester-Nashua, NH",42.911532,-71.723055,424079
5603,31700,35-39,13843,14480,28323,"Manchester-Nashua, NH",42.911532,-71.723055,424079
5604,31700,40-44,12872,13169,26041,"Manchester-Nashua, NH",42.911532,-71.723055,424079
5605,31700,45-49,12732,12848,25580,"Manchester-Nashua, NH",42.911532,-71.723055,424079
5606,31700,50-54,14888,15190,30078,"Manchester-Nashua, NH",42.911532,-71.723055,424079
5607,31700,55-59,16256,16439,32695,"Manchester-Nashua, NH",42.911532,-71.723055,424079
5608,31700,60-64,15551,15601,31152,"Manchester-Nashua, NH",42.911532,-71.723055,424079
5609,31700,65+,38290,32324,70614,"Manchester-Nashua, NH",42.911532,-71.723055,424079
5610,31740,15-19,5289,5788,11077,"Manhattan, KS",39.268424,-96.562242,133932
5611,31740,20-24,9774,12960,22734,"Manhattan, KS",39.268424,-96.562242,133932
5612,31740,25-29,5446,7095,12541,"Manhattan, KS",39.268424,-96.562242,133932
5613,31740,30-34,4639,5246,9885,"Manhattan, KS",39.268424,-96.562242,133932
5614,31740,35-39,4274,4758,9032,"Manhattan, KS",39.268424,-96.562242,133932
5615,31740,40-44,3400,3656,7056,"Manhattan, KS",39.268424,-96.562242,133932
5616,31740,45-49,2517,2671,5188,"Manhattan, KS",39.268424,-96.562242,133932
5617,31740,50-54,2444,2400,4844,"Manhattan, KS",39.268424,-96.562242,133932
5618,31740,55-59,2657,2465,5122,"Manhattan, KS",39.268424,-96.562242,133932
5619,31740,60-64,2796,2596,5392,"Manhattan, KS",39.268424,-96.562242,133932
5620,31740,65+,7946,6687,14633,"Manhattan, KS",39.268424,-96.562242,133932
5621,31820,15-19,2299,2530,4829,"Manitowoc, WI",44.156137,-87.577352,81505
5622,31820,20-24,2045,2124,4169,"Manitowoc, WI",44.156137,-87.577352,81505
5623,31820,25-29,2190,2183,4373,"Manitowoc, WI",44.156137,-87.577352,81505
5624,31820,30-34,2000,2146,4146,"Manitowoc, WI",44.156137,-87.577352,81505
5625,31820,35-39,2302,2435,4737,"Manitowoc, WI",44.156137,-87.577352,81505
5626,31820,40-44,2266,2522,4788,"Manitowoc, WI",44.156137,-87.577352,81505
5627,31820,45-49,2201,2296,4497,"Manitowoc, WI",44.156137,-87.577352,81505
5628,31820,50-54,2651,2833,5484,"Manitowoc, WI",44.156137,-87.577352,81505
5629,31820,55-59,3185,3276,6461,"Manitowoc, WI",44.156137,-87.577352,81505
5630,31820,60-64,3272,3406,6678,"Manitowoc, WI",44.156137,-87.577352,81505
5631,31820,65+,9379,8368,17747,"Manitowoc, WI",44.156137,-87.577352,81505
5632,31860,15-19,4682,4363,9045,"Mankato, MN",44.15481,-94.147801,103612
5633,31860,20-24,6913,6871,13784,"Mankato, MN",44.15481,-94.147801,103612
5634,31860,25-29,3076,3605,6681,"Mankato, MN",44.15481,-94.147801,103612
5635,31860,30-34,2968,3248,6216,"Mankato, MN",44.15481,-94.147801,103612
5636,31860,35-39,3242,3435,6677,"Mankato, MN",44.15481,-94.147801,103612
5637,31860,40-44,2975,3284,6259,"Mankato, MN",44.15481,-94.147801,103612
5638,31860,45-49,2469,2571,5040,"Mankato, MN",44.15481,-94.147801,103612
5639,31860,50-54,2386,2664,5050,"Mankato, MN",44.15481,-94.147801,103612
5640,31860,55-59,2626,2808,5434,"Mankato, MN",44.15481,-94.147801,103612
5641,31860,60-64,2957,2827,5784,"Mankato, MN",44.15481,-94.147801,103612
5642,31860,65+,8534,7432,15966,"Mankato, MN",44.15481,-94.147801,103612
5643,31900,15-19,3535,3946,7481,"Mansfield, OH",40.774159,-82.542781,125195
5644,31900,20-24,3246,4205,7451,"Mansfield, OH",40.774159,-82.542781,125195
5645,31900,25-29,3592,4732,8324,"Mansfield, OH",40.774159,-82.542781,125195
5646,31900,30-34,3585,4378,7963,"Mansfield, OH",40.774159,-82.542781,125195
5647,31900,35-39,3338,4059,7397,"Mansfield, OH",40.774159,-82.542781,125195
5648,31900,40-44,3543,4049,7592,"Mansfield, OH",40.774159,-82.542781,125195
5649,31900,45-49,3410,3818,7228,"Mansfield, OH",40.774159,-82.542781,125195
5650,31900,50-54,3630,3957,7587,"Mansfield, OH",40.774159,-82.542781,125195
5651,31900,55-59,4030,3956,7986,"Mansfield, OH",40.774159,-82.542781,125195
5652,31900,60-64,4360,4173,8533,"Mansfield, OH",40.774159,-82.542781,125195
5653,31900,65+,13923,11142,25065,"Mansfield, OH",40.774159,-82.542781,125195
5654,31930,15-19,1838,1855,3693,"Marietta, OH",39.450676,-81.490636,59423
5655,31930,20-24,1728,1787,3515,"Marietta, OH",39.450676,-81.490636,59423
5656,31930,25-29,1623,1767,3390,"Marietta, OH",39.450676,-81.490636,59423
5657,31930,30-34,1685,1655,3340,"Marietta, OH",39.450676,-81.490636,59423
5658,31930,35-39,1659,1770,3429,"Marietta, OH",39.450676,-81.490636,59423
5659,31930,40-44,1702,1705,3407,"Marietta, OH",39.450676,-81.490636,59423
5660,31930,45-49,1796,1668,3464,"Marietta, OH",39.450676,-81.490636,59423
5661,31930,50-54,1893,1925,3818,"Marietta, OH",39.450676,-81.490636,59423
5662,31930,55-59,2091,2049,4140,"Marietta, OH",39.450676,-81.490636,59423
5663,31930,60-64,2363,2283,4646,"Marietta, OH",39.450676,-81.490636,59423
5664,31930,65+,6946,6052,12998,"Marietta, OH",39.450676,-81.490636,59423
5665,31940,15-19,1676,1879,3555,"Marinette, WI-MI",45.435279,-87.769216,65174
5666,31940,20-24,1400,1532,2932,"Marinette, WI-MI",45.435279,-87.769216,65174
5667,31940,25-29,1545,1605,3150,"Marinette, WI-MI",45.435279,-87.769216,65174
5668,31940,30-34,1525,1675,3200,"Marinette, WI-MI",45.435279,-87.769216,65174
5669,31940,35-39,1688,1814,3502,"Marinette, WI-MI",45.435279,-87.769216,65174
5670,31940,40-44,1743,1903,3646,"Marinette, WI-MI",45.435279,-87.769216,65174
5671,31940,45-49,1613,1751,3364,"Marinette, WI-MI",45.435279,-87.769216,65174
5672,31940,50-54,2018,2139,4157,"Marinette, WI-MI",45.435279,-87.769216,65174
5673,31940,55-59,2590,2767,5357,"Marinette, WI-MI",45.435279,-87.769216,65174
5674,31940,60-64,2921,3107,6028,"Marinette, WI-MI",45.435279,-87.769216,65174
5675,31940,65+,8467,8047,16514,"Marinette, WI-MI",45.435279,-87.769216,65174
5676,31980,15-19,2666,2405,5071,"Marion, IN",40.515758,-85.654946,66263
5677,31980,20-24,3018,2767,5785,"Marion, IN",40.515758,-85.654946,66263
5678,31980,25-29,1905,1838,3743,"Marion, IN",40.515758,-85.654946,66263
5679,31980,30-34,1862,1708,3570,"Marion, IN",40.515758,-85.654946,66263
5680,31980,35-39,1752,1572,3324,"Marion, IN",40.515758,-85.654946,66263
5681,31980,40-44,1832,1752,3584,"Marion, IN",40.515758,-85.654946,66263
5682,31980,45-49,1792,1763,3555,"Marion, IN",40.515758,-85.654946,66263
5683,31980,50-54,2005,2034,4039,"Marion, IN",40.515758,-85.654946,66263
5684,31980,55-59,2224,2149,4373,"Marion, IN",40.515758,-85.654946,66263
5685,31980,60-64,2438,2189,4627,"Marion, IN",40.515758,-85.654946,66263
5686,31980,65+,7227,5751,12978,"Marion, IN",40.515758,-85.654946,66263
5687,32000,15-19,1143,1349,2492,"Marion, NC",35.682271,-82.048044,44717
5688,32000,20-24,1154,1250,2404,"Marion, NC",35.682271,-82.048044,44717
5689,32000,25-29,1273,1439,2712,"Marion, NC",35.682271,-82.048044,44717
5690,32000,30-34,1285,1394,2679,"Marion, NC",35.682271,-82.048044,44717
5691,32000,35-39,1184,1285,2469,"Marion, NC",35.682271,-82.048044,44717
5692,32000,40-44,1262,1352,2614,"Marion, NC",35.682271,-82.048044,44717
5693,32000,45-49,1408,1510,2918,"Marion, NC",35.682271,-82.048044,44717
5694,32000,50-54,1526,1616,3142,"Marion, NC",35.682271,-82.048044,44717
5695,32000,55-59,1675,1604,3279,"Marion, NC",35.682271,-82.048044,44717
5696,32000,60-64,1706,1608,3314,"Marion, NC",35.682271,-82.048044,44717
5697,32000,65+,5211,4372,9583,"Marion, NC",35.682271,-82.048044,44717
5698,32020,15-19,1680,1925,3605,"Marion, OH",40.588034,-83.168803,65291
5699,32020,20-24,1647,2264,3911,"Marion, OH",40.588034,-83.168803,65291
5700,32020,25-29,1884,2428,4312,"Marion, OH",40.588034,-83.168803,65291
5701,32020,30-34,1929,2495,4424,"Marion, OH",40.588034,-83.168803,65291
5702,32020,35-39,1696,2416,4112,"Marion, OH",40.588034,-83.168803,65291
5703,32020,40-44,1750,2362,4112,"Marion, OH",40.588034,-83.168803,65291
5704,32020,45-49,1703,2348,4051,"Marion, OH",40.588034,-83.168803,65291
5705,32020,50-54,1880,2442,4322,"Marion, OH",40.588034,-83.168803,65291
5706,32020,55-59,1972,2338,4310,"Marion, OH",40.588034,-83.168803,65291
5707,32020,60-64,2175,2280,4455,"Marion, OH",40.588034,-83.168803,65291
5708,32020,65+,6507,5544,12051,"Marion, OH",40.588034,-83.168803,65291
5709,32100,15-19,2350,2218,4568,"Marquette, MI",46.656596,-87.584028,66103
5710,32100,20-24,3642,3700,7342,"Marquette, MI",46.656596,-87.584028,66103
5711,32100,25-29,1898,2153,4051,"Marquette, MI",46.656596,-87.584028,66103
5712,32100,30-34,1739,1925,3664,"Marquette, MI",46.656596,-87.584028,66103
5713,32100,35-39,1847,2082,3929,"Marquette, MI",46.656596,-87.584028,66103
5714,32100,40-44,1847,2041,3888,"Marquette, MI",46.656596,-87.584028,66103
5715,32100,45-49,1541,1742,3283,"Marquette, MI",46.656596,-87.584028,66103
5716,32100,50-54,1726,1897,3623,"Marquette, MI",46.656596,-87.584028,66103
5717,32100,55-59,2010,2034,4044,"Marquette, MI",46.656596,-87.584028,66103
5718,32100,60-64,2345,2229,4574,"Marquette, MI",46.656596,-87.584028,66103
5719,32100,65+,6883,6555,13438,"Marquette, MI",46.656596,-87.584028,66103
5720,32140,15-19,933,927,1860,"Marshall, MN",44.409195,-95.847268,25231
5721,32140,20-24,788,782,1570,"Marshall, MN",44.409195,-95.847268,25231
5722,32140,25-29,703,742,1445,"Marshall, MN",44.409195,-95.847268,25231
5723,32140,30-34,781,758,1539,"Marshall, MN",44.409195,-95.847268,25231
5724,32140,35-39,813,798,1611,"Marshall, MN",44.409195,-95.847268,25231
5725,32140,40-44,767,828,1595,"Marshall, MN",44.409195,-95.847268,25231
5726,32140,45-49,647,700,1347,"Marshall, MN",44.409195,-95.847268,25231
5727,32140,50-54,640,677,1317,"Marshall, MN",44.409195,-95.847268,25231
5728,32140,55-59,744,749,1493,"Marshall, MN",44.409195,-95.847268,25231
5729,32140,60-64,828,791,1619,"Marshall, MN",44.409195,-95.847268,25231
5730,32140,65+,2316,1964,4280,"Marshall, MN",44.409195,-95.847268,25231
5731,32180,15-19,812,978,1790,"Marshall, MO",39.13584,-93.204164,23289
5732,32180,20-24,768,986,1754,"Marshall, MO",39.13584,-93.204164,23289
5733,32180,25-29,646,682,1328,"Marshall, MO",39.13584,-93.204164,23289
5734,32180,30-34,676,636,1312,"Marshall, MO",39.13584,-93.204164,23289
5735,32180,35-39,703,663,1366,"Marshall, MO",39.13584,-93.204164,23289
5736,32180,40-44,604,715,1319,"Marshall, MO",39.13584,-93.204164,23289
5737,32180,45-49,655,662,1317,"Marshall, MO",39.13584,-93.204164,23289
5738,32180,50-54,680,690,1370,"Marshall, MO",39.13584,-93.204164,23289
5739,32180,55-59,742,765,1507,"Marshall, MO",39.13584,-93.204164,23289
5740,32180,60-64,812,767,1579,"Marshall, MO",39.13584,-93.204164,23289
5741,32180,65+,2364,1997,4361,"Marshall, MO",39.13584,-93.204164,23289
5742,32260,15-19,1363,1503,2866,"Marshalltown, IA",42.0417,-92.981403,39853
5743,32260,20-24,1085,1252,2337,"Marshalltown, IA",42.0417,-92.981403,39853
5744,32260,25-29,1103,1312,2415,"Marshalltown, IA",42.0417,-92.981403,39853
5745,32260,30-34,1159,1181,2340,"Marshalltown, IA",42.0417,-92.981403,39853
5746,32260,35-39,1186,1266,2452,"Marshalltown, IA",42.0417,-92.981403,39853
5747,32260,40-44,1038,1222,2260,"Marshalltown, IA",42.0417,-92.981403,39853
5748,32260,45-49,1024,1109,2133,"Marshalltown, IA",42.0417,-92.981403,39853
5749,32260,50-54,1128,1207,2335,"Marshalltown, IA",42.0417,-92.981403,39853
5750,32260,55-59,1255,1302,2557,"Marshalltown, IA",42.0417,-92.981403,39853
5751,32260,60-64,1350,1322,2672,"Marshalltown, IA",42.0417,-92.981403,39853
5752,32260,65+,3841,3380,7221,"Marshalltown, IA",42.0417,-92.981403,39853
5753,32280,15-19,1263,1214,2477,"Martin, TN",36.303596,-88.721194,33036
5754,32280,20-24,1959,1888,3847,"Martin, TN",36.303596,-88.721194,33036
5755,32280,25-29,934,1065,1999,"Martin, TN",36.303596,-88.721194,33036
5756,32280,30-34,877,911,1788,"Martin, TN",36.303596,-88.721194,33036
5757,32280,35-39,867,819,1686,"Martin, TN",36.303596,-88.721194,33036
5758,32280,40-44,917,895,1812,"Martin, TN",36.303596,-88.721194,33036
5759,32280,45-49,883,844,1727,"Martin, TN",36.303596,-88.721194,33036
5760,32280,50-54,1031,1006,2037,"Martin, TN",36.303596,-88.721194,33036
5761,32280,55-59,1123,1065,2188,"Martin, TN",36.303596,-88.721194,33036
5762,32280,60-64,1049,1029,2078,"Martin, TN",36.303596,-88.721194,33036
5763,32280,65+,3456,2769,6225,"Martin, TN",36.303596,-88.721194,33036
5764,32300,15-19,1797,1881,3678,"Martinsville, VA",36.682503,-79.872564,63765
5765,32300,20-24,1600,1679,3279,"Martinsville, VA",36.682503,-79.872564,63765
5766,32300,25-29,1679,1687,3366,"Martinsville, VA",36.682503,-79.872564,63765
5767,32300,30-34,1839,1693,3532,"Martinsville, VA",36.682503,-79.872564,63765
5768,32300,35-39,1763,1556,3319,"Martinsville, VA",36.682503,-79.872564,63765
5769,32300,40-44,1706,1659,3365,"Martinsville, VA",36.682503,-79.872564,63765
5770,32300,45-49,1813,1762,3575,"Martinsville, VA",36.682503,-79.872564,63765
5771,32300,50-54,2246,2111,4357,"Martinsville, VA",36.682503,-79.872564,63765
5772,32300,55-59,2582,2364,4946,"Martinsville, VA",36.682503,-79.872564,63765
5773,32300,60-64,2582,2384,4966,"Martinsville, VA",36.682503,-79.872564,63765
5774,32300,65+,8183,6420,14603,"Martinsville, VA",36.682503,-79.872564,63765
5775,32340,15-19,1397,1107,2504,"Maryville, MO",40.361136,-94.883146,21160
5776,32340,20-24,2154,2091,4245,"Maryville, MO",40.361136,-94.883146,21160
5777,32340,25-29,525,662,1187,"Maryville, MO",40.361136,-94.883146,21160
5778,32340,30-34,423,590,1013,"Maryville, MO",40.361136,-94.883146,21160
5779,32340,35-39,488,535,1023,"Maryville, MO",40.361136,-94.883146,21160
5780,32340,40-44,473,563,1036,"Maryville, MO",40.361136,-94.883146,21160
5781,32340,45-49,424,461,885,"Maryville, MO",40.361136,-94.883146,21160
5782,32340,50-54,456,459,915,"Maryville, MO",40.361136,-94.883146,21160
5783,32340,55-59,579,588,1167,"Maryville, MO",40.361136,-94.883146,21160
5784,32340,60-64,544,569,1113,"Maryville, MO",40.361136,-94.883146,21160
5785,32340,65+,1844,1515,3359,"Maryville, MO",40.361136,-94.883146,21160
5786,32380,15-19,1382,1531,2913,"Mason City, IA",43.213732,-93.274339,50091
5787,32380,20-24,1322,1374,2696,"Mason City, IA",43.213732,-93.274339,50091
5788,32380,25-29,1406,1422,2828,"Mason City, IA",43.213732,-93.274339,50091
5789,32380,30-34,1387,1392,2779,"Mason City, IA",43.213732,-93.274339,50091
5790,32380,35-39,1386,1508,2894,"Mason City, IA",43.213732,-93.274339,50091
5791,32380,40-44,1395,1498,2893,"Mason City, IA",43.213732,-93.274339,50091
5792,32380,45-49,1284,1277,2561,"Mason City, IA",43.213732,-93.274339,50091
5793,32380,50-54,1482,1495,2977,"Mason City, IA",43.213732,-93.274339,50091
5794,32380,55-59,1768,1734,3502,"Mason City, IA",43.213732,-93.274339,50091
5795,32380,60-64,2008,1966,3974,"Mason City, IA",43.213732,-93.274339,50091
5796,32380,65+,6223,5165,11388,"Mason City, IA",43.213732,-93.274339,50091
5797,32460,15-19,1096,1144,2240,"Mayfield, KY",36.723344,-88.649897,36615
5798,32460,20-24,921,1027,1948,"Mayfield, KY",36.723344,-88.649897,36615
5799,32460,25-29,1044,1061,2105,"Mayfield, KY",36.723344,-88.649897,36615
5800,32460,30-34,1190,1087,2277,"Mayfield, KY",36.723344,-88.649897,36615
5801,32460,35-39,1079,1057,2136,"Mayfield, KY",36.723344,-88.649897,36615
5802,32460,40-44,1135,1063,2198,"Mayfield, KY",36.723344,-88.649897,36615
5803,32460,45-49,991,1091,2082,"Mayfield, KY",36.723344,-88.649897,36615
5804,32460,50-54,1166,1134,2300,"Mayfield, KY",36.723344,-88.649897,36615
5805,32460,55-59,1303,1265,2568,"Mayfield, KY",36.723344,-88.649897,36615
5806,32460,60-64,1295,1160,2455,"Mayfield, KY",36.723344,-88.649897,36615
5807,32460,65+,3757,3177,6934,"Mayfield, KY",36.723344,-88.649897,36615
5808,32500,15-19,461,557,1018,"Maysville, KY",38.594137,-83.828125,16931
5809,32500,20-24,450,487,937,"Maysville, KY",38.594137,-83.828125,16931
5810,32500,25-29,504,514,1018,"Maysville, KY",38.594137,-83.828125,16931
5811,32500,30-34,545,542,1087,"Maysville, KY",38.594137,-83.828125,16931
5812,32500,35-39,434,442,876,"Maysville, KY",38.594137,-83.828125,16931
5813,32500,40-44,511,474,985,"Maysville, KY",38.594137,-83.828125,16931
5814,32500,45-49,509,480,989,"Maysville, KY",38.594137,-83.828125,16931
5815,32500,50-54,597,571,1168,"Maysville, KY",38.594137,-83.828125,16931
5816,32500,55-59,617,595,1212,"Maysville, KY",38.594137,-83.828125,16931
5817,32500,60-64,607,551,1158,"Maysville, KY",38.594137,-83.828125,16931
5818,32500,65+,1811,1408,3219,"Maysville, KY",38.594137,-83.828125,16931
5819,32540,15-19,1246,1385,2631,"McAlester, OK",34.92554,-95.74813,43633
5820,32540,20-24,1020,1300,2320,"McAlester, OK",34.92554,-95.74813,43633
5821,32540,25-29,1236,1601,2837,"McAlester, OK",34.92554,-95.74813,43633
5822,32540,30-34,1253,1571,2824,"McAlester, OK",34.92554,-95.74813,43633
5823,32540,35-39,1279,1551,2830,"McAlester, OK",34.92554,-95.74813,43633
5824,32540,40-44,1217,1411,2628,"McAlester, OK",34.92554,-95.74813,43633
5825,32540,45-49,1162,1297,2459,"McAlester, OK",34.92554,-95.74813,43633
5826,32540,50-54,1198,1316,2514,"McAlester, OK",34.92554,-95.74813,43633
5827,32540,55-59,1405,1424,2829,"McAlester, OK",34.92554,-95.74813,43633
5828,32540,60-64,1464,1396,2860,"McAlester, OK",34.92554,-95.74813,43633
5829,32540,65+,4742,3960,8702,"McAlester, OK",34.92554,-95.74813,43633
5830,32580,15-19,38334,39132,77466,"McAllen-Edinburg-Mission, TX",26.396384,-98.18099,880356
5831,32580,20-24,33982,34209,68191,"McAllen-Edinburg-Mission, TX",26.396384,-98.18099,880356
5832,32580,25-29,31089,31751,62840,"McAllen-Edinburg-Mission, TX",26.396384,-98.18099,880356
5833,32580,30-34,27971,28878,56849,"McAllen-Edinburg-Mission, TX",26.396384,-98.18099,880356
5834,32580,35-39,26963,27275,54238,"McAllen-Edinburg-Mission, TX",26.396384,-98.18099,880356
5835,32580,40-44,27501,26613,54114,"McAllen-Edinburg-Mission, TX",26.396384,-98.18099,880356
5836,32580,45-49,27247,25803,53050,"McAllen-Edinburg-Mission, TX",26.396384,-98.18099,880356
5837,32580,50-54,24707,22674,47381,"McAllen-Edinburg-Mission, TX",26.396384,-98.18099,880356
5838,32580,55-59,21251,19330,40581,"McAllen-Edinburg-Mission, TX",26.396384,-98.18099,880356
5839,32580,60-64,18820,16593,35413,"McAllen-Edinburg-Mission, TX",26.396384,-98.18099,880356
5840,32580,65+,55471,44446,99917,"McAllen-Edinburg-Mission, TX",26.396384,-98.18099,880356
5841,32620,15-19,1482,1559,3041,"McComb, MS",31.177516,-90.397725,39973
5842,32620,20-24,1260,1272,2532,"McComb, MS",31.177516,-90.397725,39973
5843,32620,25-29,1323,1163,2486,"McComb, MS",31.177516,-90.397725,39973
5844,32620,30-34,1191,1090,2281,"McComb, MS",31.177516,-90.397725,39973
5845,32620,35-39,1164,1068,2232,"McComb, MS",31.177516,-90.397725,39973
5846,32620,40-44,1295,1085,2380,"McComb, MS",31.177516,-90.397725,39973
5847,32620,45-49,1251,1042,2293,"McComb, MS",31.177516,-90.397725,39973
5848,32620,50-54,1211,1100,2311,"McComb, MS",31.177516,-90.397725,39973
5849,32620,55-59,1247,1178,2425,"McComb, MS",31.177516,-90.397725,39973
5850,32620,60-64,1395,1169,2564,"McComb, MS",31.177516,-90.397725,39973
5851,32620,65+,3968,3012,6980,"McComb, MS",31.177516,-90.397725,39973
5852,32660,15-19,1284,1366,2650,"McMinnville, TN",35.67825,-85.777343,41523
5853,32660,20-24,1129,1219,2348,"McMinnville, TN",35.67825,-85.777343,41523
5854,32660,25-29,1204,1302,2506,"McMinnville, TN",35.67825,-85.777343,41523
5855,32660,30-34,1312,1310,2622,"McMinnville, TN",35.67825,-85.777343,41523
5856,32660,35-39,1245,1229,2474,"McMinnville, TN",35.67825,-85.777343,41523
5857,32660,40-44,1358,1332,2690,"McMinnville, TN",35.67825,-85.777343,41523
5858,32660,45-49,1267,1376,2643,"McMinnville, TN",35.67825,-85.777343,41523
5859,32660,50-54,1288,1420,2708,"McMinnville, TN",35.67825,-85.777343,41523
5860,32660,55-59,1392,1397,2789,"McMinnville, TN",35.67825,-85.777343,41523
5861,32660,60-64,1410,1381,2791,"McMinnville, TN",35.67825,-85.777343,41523
5862,32660,65+,4087,3335,7422,"McMinnville, TN",35.67825,-85.777343,41523
5863,32700,15-19,1057,1049,2106,"McPherson, KS",38.395812,-97.647489,30146
5864,32700,20-24,854,986,1840,"McPherson, KS",38.395812,-97.647489,30146
5865,32700,25-29,795,910,1705,"McPherson, KS",38.395812,-97.647489,30146
5866,32700,30-34,834,923,1757,"McPherson, KS",38.395812,-97.647489,30146
5867,32700,35-39,1013,937,1950,"McPherson, KS",38.395812,-97.647489,30146
5868,32700,40-44,920,904,1824,"McPherson, KS",38.395812,-97.647489,30146
5869,32700,45-49,781,800,1581,"McPherson, KS",38.395812,-97.647489,30146
5870,32700,50-54,753,816,1569,"McPherson, KS",38.395812,-97.647489,30146
5871,32700,55-59,977,952,1929,"McPherson, KS",38.395812,-97.647489,30146
5872,32700,60-64,1085,1122,2207,"McPherson, KS",38.395812,-97.647489,30146
5873,32700,65+,3349,2799,6148,"McPherson, KS",38.395812,-97.647489,30146
5874,32740,15-19,2679,2770,5449,"Meadville, PA",41.687876,-80.107795,83351
5875,32740,20-24,2395,2481,4876,"Meadville, PA",41.687876,-80.107795,83351
5876,32740,25-29,2346,2240,4586,"Meadville, PA",41.687876,-80.107795,83351
5877,32740,30-34,2360,2307,4667,"Meadville, PA",41.687876,-80.107795,83351
5878,32740,35-39,2351,2243,4594,"Meadville, PA",41.687876,-80.107795,83351
5879,32740,40-44,2399,2218,4617,"Meadville, PA",41.687876,-80.107795,83351
5880,32740,45-49,2400,2243,4643,"Meadville, PA",41.687876,-80.107795,83351
5881,32740,50-54,2788,2700,5488,"Meadville, PA",41.687876,-80.107795,83351
5882,32740,55-59,3026,2942,5968,"Meadville, PA",41.687876,-80.107795,83351
5883,32740,60-64,3243,3167,6410,"Meadville, PA",41.687876,-80.107795,83351
5884,32740,65+,9472,8537,18009,"Meadville, PA",41.687876,-80.107795,83351
5885,32780,15-19,6057,6301,12358,"Medford, OR",42.411621,-122.675611,223734
5886,32780,20-24,5665,5745,11410,"Medford, OR",42.411621,-122.675611,223734
5887,32780,25-29,6661,6728,13389,"Medford, OR",42.411621,-122.675611,223734
5888,32780,30-34,7338,7248,14586,"Medford, OR",42.411621,-122.675611,223734
5889,32780,35-39,7288,7264,14552,"Medford, OR",42.411621,-122.675611,223734
5890,32780,40-44,6933,6832,13765,"Medford, OR",42.411621,-122.675611,223734
5891,32780,45-49,6086,6137,12223,"Medford, OR",42.411621,-122.675611,223734
5892,32780,50-54,6424,6604,13028,"Medford, OR",42.411621,-122.675611,223734
5893,32780,55-59,7145,6723,13868,"Medford, OR",42.411621,-122.675611,223734
5894,32780,60-64,8215,7376,15591,"Medford, OR",42.411621,-122.675611,223734
5895,32780,65+,27498,23350,50848,"Medford, OR",42.411621,-122.675611,223734
5896,32820,15-19,43835,44784,88619,"Memphis, TN-MS-AR",35.024419,-89.871971,1336103
5897,32820,20-24,43229,41995,85224,"Memphis, TN-MS-AR",35.024419,-89.871971,1336103
5898,32820,25-29,49051,46054,95105,"Memphis, TN-MS-AR",35.024419,-89.871971,1336103
5899,32820,30-34,49306,44991,94297,"Memphis, TN-MS-AR",35.024419,-89.871971,1336103
5900,32820,35-39,45507,41251,86758,"Memphis, TN-MS-AR",35.024419,-89.871971,1336103
5901,32820,40-44,44687,39971,84658,"Memphis, TN-MS-AR",35.024419,-89.871971,1336103
5902,32820,45-49,41990,37637,79627,"Memphis, TN-MS-AR",35.024419,-89.871971,1336103
5903,32820,50-54,43748,40130,83878,"Memphis, TN-MS-AR",35.024419,-89.871971,1336103
5904,32820,55-59,44402,40035,84437,"Memphis, TN-MS-AR",35.024419,-89.871971,1336103
5905,32820,60-64,43514,38138,81652,"Memphis, TN-MS-AR",35.024419,-89.871971,1336103
5906,32820,65+,112742,85014,197756,"Memphis, TN-MS-AR",35.024419,-89.871971,1336103
5907,32860,15-19,2164,2045,4209,"Menomonie, WI",44.947751,-91.897645,45547
5908,32860,20-24,2807,2933,5740,"Menomonie, WI",44.947751,-91.897645,45547
5909,32860,25-29,1286,1480,2766,"Menomonie, WI",44.947751,-91.897645,45547
5910,32860,30-34,1186,1317,2503,"Menomonie, WI",44.947751,-91.897645,45547
5911,32860,35-39,1311,1302,2613,"Menomonie, WI",44.947751,-91.897645,45547
5912,32860,40-44,1247,1319,2566,"Menomonie, WI",44.947751,-91.897645,45547
5913,32860,45-49,1136,1237,2373,"Menomonie, WI",44.947751,-91.897645,45547
5914,32860,50-54,1234,1355,2589,"Menomonie, WI",44.947751,-91.897645,45547
5915,32860,55-59,1286,1407,2693,"Menomonie, WI",44.947751,-91.897645,45547
5916,32860,60-64,1394,1497,2891,"Menomonie, WI",44.947751,-91.897645,45547
5917,32860,65+,3976,3483,7459,"Menomonie, WI",44.947751,-91.897645,45547
5918,32900,15-19,12709,13212,25921,"Merced, CA",37.194806,-120.722802,286461
5919,32900,20-24,10097,10719,20816,"Merced, CA",37.194806,-120.722802,286461
5920,32900,25-29,9960,10937,20897,"Merced, CA",37.194806,-120.722802,286461
5921,32900,30-34,9815,10884,20699,"Merced, CA",37.194806,-120.722802,286461
5922,32900,35-39,9259,10028,19287,"Merced, CA",37.194806,-120.722802,286461
5923,32900,40-44,8489,8834,17323,"Merced, CA",37.194806,-120.722802,286461
5924,32900,45-49,7963,7928,15891,"Merced, CA",37.194806,-120.722802,286461
5925,32900,50-54,7587,7855,15442,"Merced, CA",37.194806,-120.722802,286461
5926,32900,55-59,7354,7599,14953,"Merced, CA",37.194806,-120.722802,286461
5927,32900,60-64,6927,6975,13902,"Merced, CA",37.194806,-120.722802,286461
5928,32900,65+,17689,15291,32980,"Merced, CA",37.194806,-120.722802,286461
5929,32940,15-19,3121,3375,6496,"Meridian, MS",32.410674,-88.661926,96338
5930,32940,20-24,2822,3182,6004,"Meridian, MS",32.410674,-88.661926,96338
5931,32940,25-29,2984,3126,6110,"Meridian, MS",32.410674,-88.661926,96338
5932,32940,30-34,3065,3101,6166,"Meridian, MS",32.410674,-88.661926,96338
5933,32940,35-39,2820,2778,5598,"Meridian, MS",32.410674,-88.661926,96338
5934,32940,40-44,2833,2794,5627,"Meridian, MS",32.410674,-88.661926,96338
5935,32940,45-49,2887,2715,5602,"Meridian, MS",32.410674,-88.661926,96338
5936,32940,50-54,3103,2777,5880,"Meridian, MS",32.410674,-88.661926,96338
5937,32940,55-59,3202,3037,6239,"Meridian, MS",32.410674,-88.661926,96338
5938,32940,60-64,3408,2980,6388,"Meridian, MS",32.410674,-88.661926,96338
5939,32940,65+,10299,8036,18335,"Meridian, MS",32.410674,-88.661926,96338
5940,33020,15-19,708,947,1655,"Mexico, MO",39.214481,-91.843418,24982
5941,33020,20-24,737,627,1364,"Mexico, MO",39.214481,-91.843418,24982
5942,33020,25-29,930,689,1619,"Mexico, MO",39.214481,-91.843418,24982
5943,33020,30-34,938,654,1592,"Mexico, MO",39.214481,-91.843418,24982
5944,33020,35-39,952,687,1639,"Mexico, MO",39.214481,-91.843418,24982
5945,33020,40-44,842,714,1556,"Mexico, MO",39.214481,-91.843418,24982
5946,33020,45-49,845,678,1523,"Mexico, MO",39.214481,-91.843418,24982
5947,33020,50-54,752,705,1457,"Mexico, MO",39.214481,-91.843418,24982
5948,33020,55-59,864,804,1668,"Mexico, MO",39.214481,-91.843418,24982
5949,33020,60-64,896,866,1762,"Mexico, MO",39.214481,-91.843418,24982
5950,33020,65+,2588,1982,4570,"Mexico, MO",39.214481,-91.843418,24982
5951,33060,15-19,1045,1136,2181,"Miami, OK",36.835764,-94.802681,30340
5952,33060,20-24,934,1060,1994,"Miami, OK",36.835764,-94.802681,30340
5953,33060,25-29,923,927,1850,"Miami, OK",36.835764,-94.802681,30340
5954,33060,30-34,980,900,1880,"Miami, OK",36.835764,-94.802681,30340
5955,33060,35-39,847,851,1698,"Miami, OK",36.835764,-94.802681,30340
5956,33060,40-44,842,812,1654,"Miami, OK",36.835764,-94.802681,30340
5957,33060,45-49,812,829,1641,"Miami, OK",36.835764,-94.802681,30340
5958,33060,50-54,885,902,1787,"Miami, OK",36.835764,-94.802681,30340
5959,33060,55-59,968,867,1835,"Miami, OK",36.835764,-94.802681,30340
5960,33060,60-64,961,916,1877,"Miami, OK",36.835764,-94.802681,30340
5961,33060,65+,3039,2440,5479,"Miami, OK",36.835764,-94.802681,30340
5962,33100,15-19,170111,175529,345640,"Miami-Fort Lauderdale-Pompano Beach, FL",26.101828,-80.478755,6091747
5963,33100,20-24,166825,169897,336722,"Miami-Fort Lauderdale-Pompano Beach, FL",26.101828,-80.478755,6091747
5964,33100,25-29,183023,186563,369586,"Miami-Fort Lauderdale-Pompano Beach, FL",26.101828,-80.478755,6091747
5965,33100,30-34,203491,209372,412863,"Miami-Fort Lauderdale-Pompano Beach, FL",26.101828,-80.478755,6091747
5966,33100,35-39,201087,206528,407615,"Miami-Fort Lauderdale-Pompano Beach, FL",26.101828,-80.478755,6091747
5967,33100,40-44,200350,198754,399104,"Miami-Fort Lauderdale-Pompano Beach, FL",26.101828,-80.478755,6091747
5968,33100,45-49,203720,201139,404859,"Miami-Fort Lauderdale-Pompano Beach, FL",26.101828,-80.478755,6091747
5969,33100,50-54,211383,210030,421413,"Miami-Fort Lauderdale-Pompano Beach, FL",26.101828,-80.478755,6091747
5970,33100,55-59,222016,216026,438042,"Miami-Fort Lauderdale-Pompano Beach, FL",26.101828,-80.478755,6091747
5971,33100,60-64,202074,188095,390169,"Miami-Fort Lauderdale-Pompano Beach, FL",26.101828,-80.478755,6091747
5972,33100,65+,649186,505759,1154945,"Miami-Fort Lauderdale-Pompano Beach, FL",26.101828,-80.478755,6091747
5973,33140,15-19,2963,3266,6229,"Michigan City-La Porte, IN",41.549013,-86.744739,112390
5974,33140,20-24,2976,3873,6849,"Michigan City-La Porte, IN",41.549013,-86.744739,112390
5975,33140,25-29,3185,4311,7496,"Michigan City-La Porte, IN",41.549013,-86.744739,112390
5976,33140,30-34,3261,4253,7514,"Michigan City-La Porte, IN",41.549013,-86.744739,112390
5977,33140,35-39,3004,4014,7018,"Michigan City-La Porte, IN",41.549013,-86.744739,112390
5978,33140,40-44,3129,3794,6923,"Michigan City-La Porte, IN",41.549013,-86.744739,112390
5979,33140,45-49,2957,3615,6572,"Michigan City-La Porte, IN",41.549013,-86.744739,112390
5980,33140,50-54,3439,3759,7198,"Michigan City-La Porte, IN",41.549013,-86.744739,112390
5981,33140,55-59,3834,3921,7755,"Michigan City-La Porte, IN",41.549013,-86.744739,112390
5982,33140,60-64,3890,3956,7846,"Michigan City-La Porte, IN",41.549013,-86.744739,112390
5983,33140,65+,11476,9571,21047,"Michigan City-La Porte, IN",41.549013,-86.744739,112390
5984,33180,15-19,651,724,1375,"Middlesborough, KY",36.728928,-83.680718,23858
5985,33180,20-24,639,773,1412,"Middlesborough, KY",36.728928,-83.680718,23858
5986,33180,25-29,747,754,1501,"Middlesborough, KY",36.728928,-83.680718,23858
5987,33180,30-34,708,770,1478,"Middlesborough, KY",36.728928,-83.680718,23858
5988,33180,35-39,700,671,1371,"Middlesborough, KY",36.728928,-83.680718,23858
5989,33180,40-44,688,692,1380,"Middlesborough, KY",36.728928,-83.680718,23858
5990,33180,45-49,717,743,1460,"Middlesborough, KY",36.728928,-83.680718,23858
5991,33180,50-54,801,761,1562,"Middlesborough, KY",36.728928,-83.680718,23858
5992,33180,55-59,842,839,1681,"Middlesborough, KY",36.728928,-83.680718,23858
5993,33180,60-64,883,822,1705,"Middlesborough, KY",36.728928,-83.680718,23858
5994,33180,65+,2642,2071,4713,"Middlesborough, KY",36.728928,-83.680718,23858
5995,33220,15-19,2582,2754,5336,"Midland, MI",43.648203,-84.379414,83457
5996,33220,20-24,2356,2480,4836,"Midland, MI",43.648203,-84.379414,83457
5997,33220,25-29,2433,2535,4968,"Midland, MI",43.648203,-84.379414,83457
5998,33220,30-34,2621,2738,5359,"Midland, MI",43.648203,-84.379414,83457
5999,33220,35-39,2594,2739,5333,"Midland, MI",43.648203,-84.379414,83457
6000,33220,40-44,2506,2516,5022,"Midland, MI",43.648203,-84.379414,83457
6001,33220,45-49,2378,2377,4755,"Midland, MI",43.648203,-84.379414,83457
6002,33220,50-54,2703,2666,5369,"Midland, MI",43.648203,-84.379414,83457
6003,33220,55-59,2982,3053,6035,"Midland, MI",43.648203,-84.379414,83457
6004,33220,60-64,2979,2913,5892,"Midland, MI",43.648203,-84.379414,83457
6005,33220,65+,8919,7293,16212,"Midland, MI",43.648203,-84.379414,83457
6006,33260,15-19,5706,6011,11717,"Midland, TX",32.092359,-101.994539,173180
6007,33260,20-24,5137,5351,10488,"Midland, TX",32.092359,-101.994539,173180
6008,33260,25-29,6654,6996,13650,"Midland, TX",32.092359,-101.994539,173180
6009,33260,30-34,7248,7984,15232,"Midland, TX",32.092359,-101.994539,173180
6010,33260,35-39,6802,7752,14554,"Midland, TX",32.092359,-101.994539,173180
6011,33260,40-44,5449,6143,11592,"Midland, TX",32.092359,-101.994539,173180
6012,33260,45-49,4432,4772,9204,"Midland, TX",32.092359,-101.994539,173180
6013,33260,50-54,4142,4319,8461,"Midland, TX",32.092359,-101.994539,173180
6014,33260,55-59,4245,4256,8501,"Midland, TX",32.092359,-101.994539,173180
6015,33260,60-64,4186,4194,8380,"Midland, TX",32.092359,-101.994539,173180
6016,33260,65+,9982,7950,17932,"Midland, TX",32.092359,-101.994539,173180
6017,33300,15-19,2437,2318,4755,"Milledgeville, GA",33.198527,-83.091149,52411
6018,33300,20-24,2839,2971,5810,"Milledgeville, GA",33.198527,-83.091149,52411
6019,33300,25-29,1383,1800,3183,"Milledgeville, GA",33.198527,-83.091149,52411
6020,33300,30-34,1308,1722,3030,"Milledgeville, GA",33.198527,-83.091149,52411
6021,33300,35-39,1254,1564,2818,"Milledgeville, GA",33.198527,-83.091149,52411
6022,33300,40-44,1267,1650,2917,"Milledgeville, GA",33.198527,-83.091149,52411
6023,33300,45-49,1190,1538,2728,"Milledgeville, GA",33.198527,-83.091149,52411
6024,33300,50-54,1380,1661,3041,"Milledgeville, GA",33.198527,-83.091149,52411
6025,33300,55-59,1650,1768,3418,"Milledgeville, GA",33.198527,-83.091149,52411
6026,33300,60-64,1721,1799,3520,"Milledgeville, GA",33.198527,-83.091149,52411
6027,33300,65+,5019,4585,9604,"Milledgeville, GA",33.198527,-83.091149,52411
6028,33340,15-19,50282,52887,103169,"Milwaukee-Waukesha, WI",42.912643,-87.862312,1566487
6029,33340,20-24,48337,47559,95896,"Milwaukee-Waukesha, WI",42.912643,-87.862312,1566487
6030,33340,25-29,54037,53243,107280,"Milwaukee-Waukesha, WI",42.912643,-87.862312,1566487
6031,33340,30-34,54672,53213,107885,"Milwaukee-Waukesha, WI",42.912643,-87.862312,1566487
6032,33340,35-39,53765,52245,106010,"Milwaukee-Waukesha, WI",42.912643,-87.862312,1566487
6033,33340,40-44,50446,49624,100070,"Milwaukee-Waukesha, WI",42.912643,-87.862312,1566487
6034,33340,45-49,45000,44150,89150,"Milwaukee-Waukesha, WI",42.912643,-87.862312,1566487
6035,33340,50-54,48444,48072,96516,"Milwaukee-Waukesha, WI",42.912643,-87.862312,1566487
6036,33340,55-59,52625,50483,103108,"Milwaukee-Waukesha, WI",42.912643,-87.862312,1566487
6037,33340,60-64,53437,50968,104405,"Milwaukee-Waukesha, WI",42.912643,-87.862312,1566487
6038,33340,65+,142726,115581,258307,"Milwaukee-Waukesha, WI",42.912643,-87.862312,1566487
6039,33380,15-19,1011,1136,2147,"Minden, LA",32.732152,-93.339825,36184
6040,33380,20-24,963,1062,2025,"Minden, LA",32.732152,-93.339825,36184
6041,33380,25-29,1007,1125,2132,"Minden, LA",32.732152,-93.339825,36184
6042,33380,30-34,1090,1084,2174,"Minden, LA",32.732152,-93.339825,36184
6043,33380,35-39,1058,1099,2157,"Minden, LA",32.732152,-93.339825,36184
6044,33380,40-44,1043,1032,2075,"Minden, LA",32.732152,-93.339825,36184
6045,33380,45-49,1017,987,2004,"Minden, LA",32.732152,-93.339825,36184
6046,33380,50-54,1138,1120,2258,"Minden, LA",32.732152,-93.339825,36184
6047,33380,55-59,1288,1237,2525,"Minden, LA",32.732152,-93.339825,36184
6048,33380,60-64,1318,1210,2528,"Minden, LA",32.732152,-93.339825,36184
6049,33380,65+,4194,3216,7410,"Minden, LA",32.732152,-93.339825,36184
6050,33420,15-19,868,853,1721,"Mineral Wells, TX",32.752204,-98.317967,28686
6051,33420,20-24,831,836,1667,"Mineral Wells, TX",32.752204,-98.317967,28686
6052,33420,25-29,828,871,1699,"Mineral Wells, TX",32.752204,-98.317967,28686
6053,33420,30-34,904,853,1757,"Mineral Wells, TX",32.752204,-98.317967,28686
6054,33420,35-39,805,759,1564,"Mineral Wells, TX",32.752204,-98.317967,28686
6055,33420,40-44,786,748,1534,"Mineral Wells, TX",32.752204,-98.317967,28686
6056,33420,45-49,799,732,1531,"Mineral Wells, TX",32.752204,-98.317967,28686
6057,33420,50-54,883,831,1714,"Mineral Wells, TX",32.752204,-98.317967,28686
6058,33420,55-59,1067,968,2035,"Mineral Wells, TX",32.752204,-98.317967,28686
6059,33420,60-64,1110,1030,2140,"Mineral Wells, TX",32.752204,-98.317967,28686
6060,33420,65+,3041,2745,5786,"Mineral Wells, TX",32.752204,-98.317967,28686
6061,33460,15-19,116843,121415,238258,"Minneapolis-St. Paul-Bloomington, MN-WI",45.096664,-93.275361,3690512
6062,33460,20-24,107936,108235,216171,"Minneapolis-St. Paul-Bloomington, MN-WI",45.096664,-93.275361,3690512
6063,33460,25-29,124706,128559,253265,"Minneapolis-St. Paul-Bloomington, MN-WI",45.096664,-93.275361,3690512
6064,33460,30-34,130704,135614,266318,"Minneapolis-St. Paul-Bloomington, MN-WI",45.096664,-93.275361,3690512
6065,33460,35-39,135465,138858,274323,"Minneapolis-St. Paul-Bloomington, MN-WI",45.096664,-93.275361,3690512
6066,33460,40-44,122711,126993,249704,"Minneapolis-St. Paul-Bloomington, MN-WI",45.096664,-93.275361,3690512
6067,33460,45-49,106210,109958,216168,"Minneapolis-St. Paul-Bloomington, MN-WI",45.096664,-93.275361,3690512
6068,33460,50-54,115056,118026,233082,"Minneapolis-St. Paul-Bloomington, MN-WI",45.096664,-93.275361,3690512
6069,33460,55-59,121349,122141,243490,"Minneapolis-St. Paul-Bloomington, MN-WI",45.096664,-93.275361,3690512
6070,33460,60-64,118683,116888,235571,"Minneapolis-St. Paul-Bloomington, MN-WI",45.096664,-93.275361,3690512
6071,33460,65+,300866,250910,551776,"Minneapolis-St. Paul-Bloomington, MN-WI",45.096664,-93.275361,3690512
6072,33500,15-19,2240,2804,5044,"Minot, ND",48.320242,-101.19801,76586
6073,33500,20-24,2766,4316,7082,"Minot, ND",48.320242,-101.19801,76586
6074,33500,25-29,3000,3566,6566,"Minot, ND",48.320242,-101.19801,76586
6075,33500,30-34,2649,3194,5843,"Minot, ND",48.320242,-101.19801,76586
6076,33500,35-39,2524,3033,5557,"Minot, ND",48.320242,-101.19801,76586
6077,33500,40-44,2102,2330,4432,"Minot, ND",48.320242,-101.19801,76586
6078,33500,45-49,1802,1903,3705,"Minot, ND",48.320242,-101.19801,76586
6079,33500,50-54,1751,1912,3663,"Minot, ND",48.320242,-101.19801,76586
6080,33500,55-59,2033,2029,4062,"Minot, ND",48.320242,-101.19801,76586
6081,33500,60-64,2066,2156,4222,"Minot, ND",48.320242,-101.19801,76586
6082,33500,65+,5819,5083,10902,"Minot, ND",48.320242,-101.19801,76586
6083,33540,15-19,3710,3964,7674,"Missoula, MT",47.027263,-113.892691,119533
6084,33540,20-24,6067,5970,12037,"Missoula, MT",47.027263,-113.892691,119533
6085,33540,25-29,4907,4894,9801,"Missoula, MT",47.027263,-113.892691,119533
6086,33540,30-34,4340,4680,9020,"Missoula, MT",47.027263,-113.892691,119533
6087,33540,35-39,4223,4447,8670,"Missoula, MT",47.027263,-113.892691,119533
6088,33540,40-44,3909,4113,8022,"Missoula, MT",47.027263,-113.892691,119533
6089,33540,45-49,3099,3259,6358,"Missoula, MT",47.027263,-113.892691,119533
6090,33540,50-54,3056,3347,6403,"Missoula, MT",47.027263,-113.892691,119533
6091,33540,55-59,3392,3273,6665,"Missoula, MT",47.027263,-113.892691,119533
6092,33540,60-64,3582,3355,6937,"Missoula, MT",47.027263,-113.892691,119533
6093,33540,65+,10437,9559,19996,"Missoula, MT",47.027263,-113.892691,119533
6094,33580,15-19,804,852,1656,"Mitchell, SD",43.675038,-97.966937,23383
6095,33580,20-24,700,775,1475,"Mitchell, SD",43.675038,-97.966937,23383
6096,33580,25-29,673,736,1409,"Mitchell, SD",43.675038,-97.966937,23383
6097,33580,30-34,622,729,1351,"Mitchell, SD",43.675038,-97.966937,23383
6098,33580,35-39,691,676,1367,"Mitchell, SD",43.675038,-97.966937,23383
6099,33580,40-44,682,743,1425,"Mitchell, SD",43.675038,-97.966937,23383
6100,33580,45-49,577,644,1221,"Mitchell, SD",43.675038,-97.966937,23383
6101,33580,50-54,580,630,1210,"Mitchell, SD",43.675038,-97.966937,23383
6102,33580,55-59,719,746,1465,"Mitchell, SD",43.675038,-97.966937,23383
6103,33580,60-64,806,782,1588,"Mitchell, SD",43.675038,-97.966937,23383
6104,33580,65+,2470,2044,4514,"Mitchell, SD",43.675038,-97.966937,23383
6105,33620,15-19,731,788,1519,"Moberly, MO",39.439249,-92.492959,24760
6106,33620,20-24,688,921,1609,"Moberly, MO",39.439249,-92.492959,24760
6107,33620,25-29,744,1010,1754,"Moberly, MO",39.439249,-92.492959,24760
6108,33620,30-34,707,1006,1713,"Moberly, MO",39.439249,-92.492959,24760
6109,33620,35-39,699,917,1616,"Moberly, MO",39.439249,-92.492959,24760
6110,33620,40-44,713,926,1639,"Moberly, MO",39.439249,-92.492959,24760
6111,33620,45-49,645,876,1521,"Moberly, MO",39.439249,-92.492959,24760
6112,33620,50-54,751,851,1602,"Moberly, MO",39.439249,-92.492959,24760
6113,33620,55-59,770,860,1630,"Moberly, MO",39.439249,-92.492959,24760
6114,33620,60-64,785,764,1549,"Moberly, MO",39.439249,-92.492959,24760
6115,33620,65+,2343,1871,4214,"Moberly, MO",39.439249,-92.492959,24760
6116,33660,15-19,13334,13731,27065,"Mobile, AL",30.971509,-88.20787,428220
6117,33660,20-24,13713,13222,26935,"Mobile, AL",30.971509,-88.20787,428220
6118,33660,25-29,14977,14118,29095,"Mobile, AL",30.971509,-88.20787,428220
6119,33660,30-34,15638,14019,29657,"Mobile, AL",30.971509,-88.20787,428220
6120,33660,35-39,14350,12447,26797,"Mobile, AL",30.971509,-88.20787,428220
6121,33660,40-44,13453,12227,25680,"Mobile, AL",30.971509,-88.20787,428220
6122,33660,45-49,12890,11579,24469,"Mobile, AL",30.971509,-88.20787,428220
6123,33660,50-54,13499,12318,25817,"Mobile, AL",30.971509,-88.20787,428220
6124,33660,55-59,14630,13459,28089,"Mobile, AL",30.971509,-88.20787,428220
6125,33660,60-64,15068,13315,28383,"Mobile, AL",30.971509,-88.20787,428220
6126,33660,65+,41215,32163,73378,"Mobile, AL",30.971509,-88.20787,428220
6127,33700,15-19,20179,21305,41484,"Modesto, CA",37.562316,-121.002831,552999
6128,33700,20-24,17871,18637,36508,"Modesto, CA",37.562316,-121.002831,552999
6129,33700,25-29,18877,19692,38569,"Modesto, CA",37.562316,-121.002831,552999
6130,33700,30-34,19904,20445,40349,"Modesto, CA",37.562316,-121.002831,552999
6131,33700,35-39,18558,19379,37937,"Modesto, CA",37.562316,-121.002831,552999
6132,33700,40-44,17363,17997,35360,"Modesto, CA",37.562316,-121.002831,552999
6133,33700,45-49,15786,16051,31837,"Modesto, CA",37.562316,-121.002831,552999
6134,33700,50-54,15978,16212,32190,"Modesto, CA",37.562316,-121.002831,552999
6135,33700,55-59,15995,15616,31611,"Modesto, CA",37.562316,-121.002831,552999
6136,33700,60-64,15297,14710,30007,"Modesto, CA",37.562316,-121.002831,552999
6137,33700,65+,41071,33286,74357,"Modesto, CA",37.562316,-121.002831,552999
6138,33740,15-19,6784,7190,13974,"Monroe, LA",32.734255,-92.09955,204884
6139,33740,20-24,6699,6624,13323,"Monroe, LA",32.734255,-92.09955,204884
6140,33740,25-29,6674,6411,13085,"Monroe, LA",32.734255,-92.09955,204884
6141,33740,30-34,7126,6660,13786,"Monroe, LA",32.734255,-92.09955,204884
6142,33740,35-39,6681,6043,12724,"Monroe, LA",32.734255,-92.09955,204884
6143,33740,40-44,6600,6243,12843,"Monroe, LA",32.734255,-92.09955,204884
6144,33740,45-49,6045,5554,11599,"Monroe, LA",32.734255,-92.09955,204884
6145,33740,50-54,6378,5935,12313,"Monroe, LA",32.734255,-92.09955,204884
6146,33740,55-59,6617,5999,12616,"Monroe, LA",32.734255,-92.09955,204884
6147,33740,60-64,6937,6182,13119,"Monroe, LA",32.734255,-92.09955,204884
6148,33740,65+,19409,15168,34577,"Monroe, LA",32.734255,-92.09955,204884
6149,33780,15-19,4614,4692,9306,"Monroe, MI",41.916097,-83.487106,155274
6150,33780,20-24,4176,4458,8634,"Monroe, MI",41.916097,-83.487106,155274
6151,33780,25-29,4446,4724,9170,"Monroe, MI",41.916097,-83.487106,155274
6152,33780,30-34,4620,4840,9460,"Monroe, MI",41.916097,-83.487106,155274
6153,33780,35-39,4624,4579,9203,"Monroe, MI",41.916097,-83.487106,155274
6154,33780,40-44,4715,4597,9312,"Monroe, MI",41.916097,-83.487106,155274
6155,33780,45-49,4678,4799,9477,"Monroe, MI",41.916097,-83.487106,155274
6156,33780,50-54,5256,5366,10622,"Monroe, MI",41.916097,-83.487106,155274
6157,33780,55-59,5881,5779,11660,"Monroe, MI",41.916097,-83.487106,155274
6158,33780,60-64,5886,5991,11877,"Monroe, MI",41.916097,-83.487106,155274
6159,33780,65+,16103,13794,29897,"Monroe, MI",41.916097,-83.487106,155274
6160,33860,15-19,12075,12668,24743,"Montgomery, AL",32.365631,-86.404585,385798
6161,33860,20-24,12431,12409,24840,"Montgomery, AL",32.365631,-86.404585,385798
6162,33860,25-29,13297,12466,25763,"Montgomery, AL",32.365631,-86.404585,385798
6163,33860,30-34,14456,12958,27414,"Montgomery, AL",32.365631,-86.404585,385798
6164,33860,35-39,13276,11989,25265,"Montgomery, AL",32.365631,-86.404585,385798
6165,33860,40-44,12810,11419,24229,"Montgomery, AL",32.365631,-86.404585,385798
6166,33860,45-49,12383,10774,23157,"Montgomery, AL",32.365631,-86.404585,385798
6167,33860,50-54,12529,11430,23959,"Montgomery, AL",32.365631,-86.404585,385798
6168,33860,55-59,13267,11890,25157,"Montgomery, AL",32.365631,-86.404585,385798
6169,33860,60-64,13130,11328,24458,"Montgomery, AL",32.365631,-86.404585,385798
6170,33860,65+,35494,26917,62411,"Montgomery, AL",32.365631,-86.404585,385798
6171,33940,15-19,1301,1358,2659,"Montrose, CO",38.342548,-108.162237,48203
6172,33940,20-24,1063,1161,2224,"Montrose, CO",38.342548,-108.162237,48203
6173,33940,25-29,1086,1221,2307,"Montrose, CO",38.342548,-108.162237,48203
6174,33940,30-34,1258,1200,2458,"Montrose, CO",38.342548,-108.162237,48203
6175,33940,35-39,1431,1506,2937,"Montrose, CO",38.342548,-108.162237,48203
6176,33940,40-44,1393,1368,2761,"Montrose, CO",38.342548,-108.162237,48203
6177,33940,45-49,1264,1281,2545,"Montrose, CO",38.342548,-108.162237,48203
6178,33940,50-54,1372,1422,2794,"Montrose, CO",38.342548,-108.162237,48203
6179,33940,55-59,1717,1564,3281,"Montrose, CO",38.342548,-108.162237,48203
6180,33940,60-64,2095,1913,4008,"Montrose, CO",38.342548,-108.162237,48203
6181,33940,65+,6414,5935,12349,"Montrose, CO",38.342548,-108.162237,48203
6182,33980,15-19,1636,1874,3510,"Morehead City, NC",34.858343,-76.53586,68541
6183,33980,20-24,1454,1586,3040,"Morehead City, NC",34.858343,-76.53586,68541
6184,33980,25-29,1461,1762,3223,"Morehead City, NC",34.858343,-76.53586,68541
6185,33980,30-34,1728,1693,3421,"Morehead City, NC",34.858343,-76.53586,68541
6186,33980,35-39,1870,1895,3765,"Morehead City, NC",34.858343,-76.53586,68541
6187,33980,40-44,2016,1922,3938,"Morehead City, NC",34.858343,-76.53586,68541
6188,33980,45-49,1902,1889,3791,"Morehead City, NC",34.858343,-76.53586,68541
6189,33980,50-54,2404,2266,4670,"Morehead City, NC",34.858343,-76.53586,68541
6190,33980,55-59,2868,2617,5485,"Morehead City, NC",34.858343,-76.53586,68541
6191,33980,60-64,3366,2973,6339,"Morehead City, NC",34.858343,-76.53586,68541
6192,33980,65+,9624,8382,18006,"Morehead City, NC",34.858343,-76.53586,68541
6193,34020,15-19,1412,1483,2895,"Morgan City, LA",29.629349,-91.463804,48232
6194,34020,20-24,1292,1321,2613,"Morgan City, LA",29.629349,-91.463804,48232
6195,34020,25-29,1429,1494,2923,"Morgan City, LA",29.629349,-91.463804,48232
6196,34020,30-34,1514,1506,3020,"Morgan City, LA",29.629349,-91.463804,48232
6197,34020,35-39,1422,1349,2771,"Morgan City, LA",29.629349,-91.463804,48232
6198,34020,40-44,1360,1375,2735,"Morgan City, LA",29.629349,-91.463804,48232
6199,34020,45-49,1332,1345,2677,"Morgan City, LA",29.629349,-91.463804,48232
6200,34020,50-54,1540,1473,3013,"Morgan City, LA",29.629349,-91.463804,48232
6201,34020,55-59,1845,1712,3557,"Morgan City, LA",29.629349,-91.463804,48232
6202,34020,60-64,1815,1851,3666,"Morgan City, LA",29.629349,-91.463804,48232
6203,34020,65+,4683,4057,8740,"Morgan City, LA",29.629349,-91.463804,48232
6204,34060,15-19,4862,5389,10251,"Morgantown, WV",39.525155,-79.801912,140745
6205,34060,20-24,8218,8947,17165,"Morgantown, WV",39.525155,-79.801912,140745
6206,34060,25-29,4992,5932,10924,"Morgantown, WV",39.525155,-79.801912,140745
6207,34060,30-34,4952,5612,10564,"Morgantown, WV",39.525155,-79.801912,140745
6208,34060,35-39,4400,5127,9527,"Morgantown, WV",39.525155,-79.801912,140745
6209,34060,40-44,4094,4788,8882,"Morgantown, WV",39.525155,-79.801912,140745
6210,34060,45-49,3574,3993,7567,"Morgantown, WV",39.525155,-79.801912,140745
6211,34060,50-54,3751,4131,7882,"Morgantown, WV",39.525155,-79.801912,140745
6212,34060,55-59,3995,4001,7996,"Morgantown, WV",39.525155,-79.801912,140745
6213,34060,60-64,4069,4030,8099,"Morgantown, WV",39.525155,-79.801912,140745
6214,34060,65+,11486,10159,21645,"Morgantown, WV",39.525155,-79.801912,140745
6215,34100,15-19,4292,4637,8929,"Morristown, TN",36.168802,-83.422614,143855
6216,34100,20-24,4039,4172,8211,"Morristown, TN",36.168802,-83.422614,143855
6217,34100,25-29,4123,4472,8595,"Morristown, TN",36.168802,-83.422614,143855
6218,34100,30-34,4144,4197,8341,"Morristown, TN",36.168802,-83.422614,143855
6219,34100,35-39,3879,3980,7859,"Morristown, TN",36.168802,-83.422614,143855
6220,34100,40-44,4253,4266,8519,"Morristown, TN",36.168802,-83.422614,143855
6221,34100,45-49,4608,4582,9190,"Morristown, TN",36.168802,-83.422614,143855
6222,34100,50-54,5122,5076,10198,"Morristown, TN",36.168802,-83.422614,143855
6223,34100,55-59,5326,5439,10765,"Morristown, TN",36.168802,-83.422614,143855
6224,34100,60-64,5254,5094,10348,"Morristown, TN",36.168802,-83.422614,143855
6225,34100,65+,15423,12868,28291,"Morristown, TN",36.168802,-83.422614,143855
6226,34140,15-19,1797,1822,3619,"Moscow, ID",46.81892,-116.730974,40313
6227,34140,20-24,2964,3411,6375,"Moscow, ID",46.81892,-116.730974,40313
6228,34140,25-29,1457,1693,3150,"Moscow, ID",46.81892,-116.730974,40313
6229,34140,30-34,1277,1351,2628,"Moscow, ID",46.81892,-116.730974,40313
6230,34140,35-39,1142,1163,2305,"Moscow, ID",46.81892,-116.730974,40313
6231,34140,40-44,1032,1114,2146,"Moscow, ID",46.81892,-116.730974,40313
6232,34140,45-49,907,959,1866,"Moscow, ID",46.81892,-116.730974,40313
6233,34140,50-54,921,948,1869,"Moscow, ID",46.81892,-116.730974,40313
6234,34140,55-59,997,1013,2010,"Moscow, ID",46.81892,-116.730974,40313
6235,34140,60-64,1056,967,2023,"Moscow, ID",46.81892,-116.730974,40313
6236,34140,65+,3028,2906,5934,"Moscow, ID",46.81892,-116.730974,40313
6237,34180,15-19,3684,4014,7698,"Moses Lake, WA",47.213633,-119.467788,100297
6238,34180,20-24,3113,3396,6509,"Moses Lake, WA",47.213633,-119.467788,100297
6239,34180,25-29,3262,3637,6899,"Moses Lake, WA",47.213633,-119.467788,100297
6240,34180,30-34,3246,3588,6834,"Moses Lake, WA",47.213633,-119.467788,100297
6241,34180,35-39,2847,3302,6149,"Moses Lake, WA",47.213633,-119.467788,100297
6242,34180,40-44,2919,3020,5939,"Moses Lake, WA",47.213633,-119.467788,100297
6243,34180,45-49,2761,2731,5492,"Moses Lake, WA",47.213633,-119.467788,100297
6244,34180,50-54,2570,2797,5367,"Moses Lake, WA",47.213633,-119.467788,100297
6245,34180,55-59,2627,2845,5472,"Moses Lake, WA",47.213633,-119.467788,100297
6246,34180,60-64,2746,2833,5579,"Moses Lake, WA",47.213633,-119.467788,100297
6247,34180,65+,7340,6971,14311,"Moses Lake, WA",47.213633,-119.467788,100297
6248,34220,15-19,1472,1709,3181,"Moultrie, GA",31.189707,-83.769773,45812
6249,34220,20-24,1347,1495,2842,"Moultrie, GA",31.189707,-83.769773,45812
6250,34220,25-29,1399,1495,2894,"Moultrie, GA",31.189707,-83.769773,45812
6251,34220,30-34,1489,1422,2911,"Moultrie, GA",31.189707,-83.769773,45812
6252,34220,35-39,1486,1445,2931,"Moultrie, GA",31.189707,-83.769773,45812
6253,34220,40-44,1485,1509,2994,"Moultrie, GA",31.189707,-83.769773,45812
6254,34220,45-49,1368,1437,2805,"Moultrie, GA",31.189707,-83.769773,45812
6255,34220,50-54,1375,1456,2831,"Moultrie, GA",31.189707,-83.769773,45812
6256,34220,55-59,1469,1433,2902,"Moultrie, GA",31.189707,-83.769773,45812
6257,34220,60-64,1288,1226,2514,"Moultrie, GA",31.189707,-83.769773,45812
6258,34220,65+,4193,3196,7389,"Moultrie, GA",31.189707,-83.769773,45812
6259,34260,15-19,1073,1114,2187,"Mountain Home, AR",36.280268,-92.329949,42144
6260,34260,20-24,834,915,1749,"Mountain Home, AR",36.280268,-92.329949,42144
6261,34260,25-29,964,991,1955,"Mountain Home, AR",36.280268,-92.329949,42144
6262,34260,30-34,1013,1040,2053,"Mountain Home, AR",36.280268,-92.329949,42144
6263,34260,35-39,1105,1021,2126,"Mountain Home, AR",36.280268,-92.329949,42144
6264,34260,40-44,1033,1006,2039,"Mountain Home, AR",36.280268,-92.329949,42144
6265,34260,45-49,1035,988,2023,"Mountain Home, AR",36.280268,-92.329949,42144
6266,34260,50-54,1304,1250,2554,"Mountain Home, AR",36.280268,-92.329949,42144
6267,34260,55-59,1624,1361,2985,"Mountain Home, AR",36.280268,-92.329949,42144
6268,34260,60-64,1855,1602,3457,"Mountain Home, AR",36.280268,-92.329949,42144
6269,34260,65+,6847,6050,12897,"Mountain Home, AR",36.280268,-92.329949,42144
6270,34300,15-19,820,952,1772,"Mountain Home, ID",43.394698,-115.471205,28827
6271,34300,20-24,1011,1503,2514,"Mountain Home, ID",43.394698,-115.471205,28827
6272,34300,25-29,1078,1388,2466,"Mountain Home, ID",43.394698,-115.471205,28827
6273,34300,30-34,1062,1224,2286,"Mountain Home, ID",43.394698,-115.471205,28827
6274,34300,35-39,892,1027,1919,"Mountain Home, ID",43.394698,-115.471205,28827
6275,34300,40-44,750,829,1579,"Mountain Home, ID",43.394698,-115.471205,28827
6276,34300,45-49,627,710,1337,"Mountain Home, ID",43.394698,-115.471205,28827
6277,34300,50-54,691,702,1393,"Mountain Home, ID",43.394698,-115.471205,28827
6278,34300,55-59,848,858,1706,"Mountain Home, ID",43.394698,-115.471205,28827
6279,34300,60-64,802,852,1654,"Mountain Home, ID",43.394698,-115.471205,28827
6280,34300,65+,2147,2034,4181,"Mountain Home, ID",43.394698,-115.471205,28827
6281,34340,15-19,2028,2239,4267,"Mount Airy, NC",36.415416,-80.686463,71152
6282,34340,20-24,1993,2040,4033,"Mount Airy, NC",36.415416,-80.686463,71152
6283,34340,25-29,1985,2122,4107,"Mount Airy, NC",36.415416,-80.686463,71152
6284,34340,30-34,1952,2012,3964,"Mount Airy, NC",36.415416,-80.686463,71152
6285,34340,35-39,1851,1840,3691,"Mount Airy, NC",36.415416,-80.686463,71152
6286,34340,40-44,2027,1887,3914,"Mount Airy, NC",36.415416,-80.686463,71152
6287,34340,45-49,2292,2284,4576,"Mount Airy, NC",36.415416,-80.686463,71152
6288,34340,50-54,2552,2526,5078,"Mount Airy, NC",36.415416,-80.686463,71152
6289,34340,55-59,2691,2632,5323,"Mount Airy, NC",36.415416,-80.686463,71152
6290,34340,60-64,2533,2500,5033,"Mount Airy, NC",36.415416,-80.686463,71152
6291,34340,65+,8277,6636,14913,"Mount Airy, NC",36.415416,-80.686463,71152
6292,34350,15-19,849,946,1795,"Mount Gay-Shamrock, WV",37.830591,-81.940853,31909
6293,34350,20-24,799,833,1632,"Mount Gay-Shamrock, WV",37.830591,-81.940853,31909
6294,34350,25-29,880,936,1816,"Mount Gay-Shamrock, WV",37.830591,-81.940853,31909
6295,34350,30-34,854,928,1782,"Mount Gay-Shamrock, WV",37.830591,-81.940853,31909
6296,34350,35-39,857,874,1731,"Mount Gay-Shamrock, WV",37.830591,-81.940853,31909
6297,34350,40-44,1028,1054,2082,"Mount Gay-Shamrock, WV",37.830591,-81.940853,31909
6298,34350,45-49,1072,1152,2224,"Mount Gay-Shamrock, WV",37.830591,-81.940853,31909
6299,34350,50-54,1014,1047,2061,"Mount Gay-Shamrock, WV",37.830591,-81.940853,31909
6300,34350,55-59,1038,960,1998,"Mount Gay-Shamrock, WV",37.830591,-81.940853,31909
6301,34350,60-64,1252,1134,2386,"Mount Gay-Shamrock, WV",37.830591,-81.940853,31909
6302,34350,65+,3793,3169,6962,"Mount Gay-Shamrock, WV",37.830591,-81.940853,31909
6303,34380,15-19,3627,3046,6673,"Mount Pleasant, MI",43.645233,-84.839424,64813
6304,34380,20-24,6468,5622,12090,"Mount Pleasant, MI",43.645233,-84.839424,64813
6305,34380,25-29,1917,2183,4100,"Mount Pleasant, MI",43.645233,-84.839424,64813
6306,34380,30-34,1769,1884,3653,"Mount Pleasant, MI",43.645233,-84.839424,64813
6307,34380,35-39,1675,1746,3421,"Mount Pleasant, MI",43.645233,-84.839424,64813
6308,34380,40-44,1634,1707,3341,"Mount Pleasant, MI",43.645233,-84.839424,64813
6309,34380,45-49,1414,1501,2915,"Mount Pleasant, MI",43.645233,-84.839424,64813
6310,34380,50-54,1608,1620,3228,"Mount Pleasant, MI",43.645233,-84.839424,64813
6311,34380,55-59,1740,1764,3504,"Mount Pleasant, MI",43.645233,-84.839424,64813
6312,34380,60-64,1851,1724,3575,"Mount Pleasant, MI",43.645233,-84.839424,64813
6313,34380,65+,4766,4133,8899,"Mount Pleasant, MI",43.645233,-84.839424,64813
6314,34420,15-19,1699,1710,3409,"Mount Pleasant, TX",33.137799,-94.971002,43799
6315,34420,20-24,1436,1431,2867,"Mount Pleasant, TX",33.137799,-94.971002,43799
6316,34420,25-29,1379,1402,2781,"Mount Pleasant, TX",33.137799,-94.971002,43799
6317,34420,30-34,1358,1283,2641,"Mount Pleasant, TX",33.137799,-94.971002,43799
6318,34420,35-39,1210,1134,2344,"Mount Pleasant, TX",33.137799,-94.971002,43799
6319,34420,40-44,1310,1140,2450,"Mount Pleasant, TX",33.137799,-94.971002,43799
6320,34420,45-49,1228,1182,2410,"Mount Pleasant, TX",33.137799,-94.971002,43799
6321,34420,50-54,1338,1350,2688,"Mount Pleasant, TX",33.137799,-94.971002,43799
6322,34420,55-59,1331,1372,2703,"Mount Pleasant, TX",33.137799,-94.971002,43799
6323,34420,60-64,1254,1204,2458,"Mount Pleasant, TX",33.137799,-94.971002,43799
6324,34420,65+,3692,3269,6961,"Mount Pleasant, TX",33.137799,-94.971002,43799
6325,34460,15-19,1347,1535,2882,"Mount Sterling, KY",38.039616,-83.747734,47191
6326,34460,20-24,1311,1389,2700,"Mount Sterling, KY",38.039616,-83.747734,47191
6327,34460,25-29,1436,1523,2959,"Mount Sterling, KY",38.039616,-83.747734,47191
6328,34460,30-34,1443,1459,2902,"Mount Sterling, KY",38.039616,-83.747734,47191
6329,34460,35-39,1387,1311,2698,"Mount Sterling, KY",38.039616,-83.747734,47191
6330,34460,40-44,1515,1424,2939,"Mount Sterling, KY",38.039616,-83.747734,47191
6331,34460,45-49,1622,1580,3202,"Mount Sterling, KY",38.039616,-83.747734,47191
6332,34460,50-54,1653,1613,3266,"Mount Sterling, KY",38.039616,-83.747734,47191
6333,34460,55-59,1735,1667,3402,"Mount Sterling, KY",38.039616,-83.747734,47191
6334,34460,60-64,1566,1499,3065,"Mount Sterling, KY",38.039616,-83.747734,47191
6335,34460,65+,4530,3667,8197,"Mount Sterling, KY",38.039616,-83.747734,47191
6336,34500,15-19,1027,1103,2130,"Mount Vernon, IL",38.30078,-88.92421,36877
6337,34500,20-24,849,1123,1972,"Mount Vernon, IL",38.30078,-88.92421,36877
6338,34500,25-29,1026,1345,2371,"Mount Vernon, IL",38.30078,-88.92421,36877
6339,34500,30-34,1027,1274,2301,"Mount Vernon, IL",38.30078,-88.92421,36877
6340,34500,35-39,1044,1241,2285,"Mount Vernon, IL",38.30078,-88.92421,36877
6341,34500,40-44,1029,1325,2354,"Mount Vernon, IL",38.30078,-88.92421,36877
6342,34500,45-49,1003,1212,2215,"Mount Vernon, IL",38.30078,-88.92421,36877
6343,34500,50-54,1101,1232,2333,"Mount Vernon, IL",38.30078,-88.92421,36877
6344,34500,55-59,1195,1290,2485,"Mount Vernon, IL",38.30078,-88.92421,36877
6345,34500,60-64,1237,1231,2468,"Mount Vernon, IL",38.30078,-88.92421,36877
6346,34500,65+,3845,3297,7142,"Mount Vernon, IL",38.30078,-88.92421,36877
6347,34540,15-19,2390,2417,4807,"Mount Vernon, OH",40.40362,-82.422393,62897
6348,34540,20-24,2453,2423,4876,"Mount Vernon, OH",40.40362,-82.422393,62897
6349,34540,25-29,1649,1679,3328,"Mount Vernon, OH",40.40362,-82.422393,62897
6350,34540,30-34,1776,1723,3499,"Mount Vernon, OH",40.40362,-82.422393,62897
6351,34540,35-39,1787,1728,3515,"Mount Vernon, OH",40.40362,-82.422393,62897
6352,34540,40-44,1732,1788,3520,"Mount Vernon, OH",40.40362,-82.422393,62897
6353,34540,45-49,1622,1687,3309,"Mount Vernon, OH",40.40362,-82.422393,62897
6354,34540,50-54,1862,1896,3758,"Mount Vernon, OH",40.40362,-82.422393,62897
6355,34540,55-59,2054,2049,4103,"Mount Vernon, OH",40.40362,-82.422393,62897
6356,34540,60-64,2325,2169,4494,"Mount Vernon, OH",40.40362,-82.422393,62897
6357,34540,65+,6363,5481,11844,"Mount Vernon, OH",40.40362,-82.422393,62897
6358,34580,15-19,3586,3849,7435,"Mount Vernon-Anacortes, WA",48.493292,-121.81577,130696
6359,34580,20-24,3386,3479,6865,"Mount Vernon-Anacortes, WA",48.493292,-121.81577,130696
6360,34580,25-29,3945,4155,8100,"Mount Vernon-Anacortes, WA",48.493292,-121.81577,130696
6361,34580,30-34,4045,4322,8367,"Mount Vernon-Anacortes, WA",48.493292,-121.81577,130696
6362,34580,35-39,4210,4351,8561,"Mount Vernon-Anacortes, WA",48.493292,-121.81577,130696
6363,34580,40-44,3851,4049,7900,"Mount Vernon-Anacortes, WA",48.493292,-121.81577,130696
6364,34580,45-49,3488,3531,7019,"Mount Vernon-Anacortes, WA",48.493292,-121.81577,130696
6365,34580,50-54,3735,3762,7497,"Mount Vernon-Anacortes, WA",48.493292,-121.81577,130696
6366,34580,55-59,4152,4021,8173,"Mount Vernon-Anacortes, WA",48.493292,-121.81577,130696
6367,34580,60-64,4816,4456,9272,"Mount Vernon-Anacortes, WA",48.493292,-121.81577,130696
6368,34580,65+,15168,13296,28464,"Mount Vernon-Anacortes, WA",48.493292,-121.81577,130696
6369,34620,15-19,5158,4637,9795,"Muncie, IN",40.227543,-85.399262,111871
6370,34620,20-24,8156,7431,15587,"Muncie, IN",40.227543,-85.399262,111871
6371,34620,25-29,3528,3490,7018,"Muncie, IN",40.227543,-85.399262,111871
6372,34620,30-34,3048,3068,6116,"Muncie, IN",40.227543,-85.399262,111871
6373,34620,35-39,2920,2901,5821,"Muncie, IN",40.227543,-85.399262,111871
6374,34620,40-44,2932,2866,5798,"Muncie, IN",40.227543,-85.399262,111871
6375,34620,45-49,2957,2885,5842,"Muncie, IN",40.227543,-85.399262,111871
6376,34620,50-54,3260,3225,6485,"Muncie, IN",40.227543,-85.399262,111871
6377,34620,55-59,3408,3263,6671,"Muncie, IN",40.227543,-85.399262,111871
6378,34620,60-64,3545,3349,6894,"Muncie, IN",40.227543,-85.399262,111871
6379,34620,65+,10846,8442,19288,"Muncie, IN",40.227543,-85.399262,111871
6380,34660,15-19,1716,1449,3165,"Murray, KY",36.620978,-88.274086,37560
6381,34660,20-24,2660,2519,5179,"Murray, KY",36.620978,-88.274086,37560
6382,34660,25-29,1122,1204,2326,"Murray, KY",36.620978,-88.274086,37560
6383,34660,30-34,1075,1099,2174,"Murray, KY",36.620978,-88.274086,37560
6384,34660,35-39,1001,1009,2010,"Murray, KY",36.620978,-88.274086,37560
6385,34660,40-44,977,1028,2005,"Murray, KY",36.620978,-88.274086,37560
6386,34660,45-49,906,992,1898,"Murray, KY",36.620978,-88.274086,37560
6387,34660,50-54,1066,1019,2085,"Murray, KY",36.620978,-88.274086,37560
6388,34660,55-59,1122,1122,2244,"Murray, KY",36.620978,-88.274086,37560
6389,34660,60-64,1172,1068,2240,"Murray, KY",36.620978,-88.274086,37560
6390,34660,65+,3557,2975,6532,"Murray, KY",36.620978,-88.274086,37560
6391,34700,15-19,1409,1470,2879,"Muscatine, IA",41.483776,-91.118699,42688
6392,34700,20-24,1221,1250,2471,"Muscatine, IA",41.483776,-91.118699,42688
6393,34700,25-29,1250,1343,2593,"Muscatine, IA",41.483776,-91.118699,42688
6394,34700,30-34,1296,1370,2666,"Muscatine, IA",41.483776,-91.118699,42688
6395,34700,35-39,1276,1370,2646,"Muscatine, IA",41.483776,-91.118699,42688
6396,34700,40-44,1272,1344,2616,"Muscatine, IA",41.483776,-91.118699,42688
6397,34700,45-49,1181,1256,2437,"Muscatine, IA",41.483776,-91.118699,42688
6398,34700,50-54,1324,1305,2629,"Muscatine, IA",41.483776,-91.118699,42688
6399,34700,55-59,1380,1440,2820,"Muscatine, IA",41.483776,-91.118699,42688
6400,34700,60-64,1415,1443,2858,"Muscatine, IA",41.483776,-91.118699,42688
6401,34700,65+,4040,3509,7549,"Muscatine, IA",41.483776,-91.118699,42688
6402,34740,15-19,5247,5608,10855,"Muskegon, MI",43.428739,-86.420908,176511
6403,34740,20-24,4968,5261,10229,"Muskegon, MI",43.428739,-86.420908,176511
6404,34740,25-29,5601,5950,11551,"Muskegon, MI",43.428739,-86.420908,176511
6405,34740,30-34,5689,5937,11626,"Muskegon, MI",43.428739,-86.420908,176511
6406,34740,35-39,5513,5686,11199,"Muskegon, MI",43.428739,-86.420908,176511
6407,34740,40-44,5358,5495,10853,"Muskegon, MI",43.428739,-86.420908,176511
6408,34740,45-49,4828,5080,9908,"Muskegon, MI",43.428739,-86.420908,176511
6409,34740,50-54,5335,5484,10819,"Muskegon, MI",43.428739,-86.420908,176511
6410,34740,55-59,5984,5946,11930,"Muskegon, MI",43.428739,-86.420908,176511
6411,34740,60-64,6461,6166,12627,"Muskegon, MI",43.428739,-86.420908,176511
6412,34740,65+,17346,14410,31756,"Muskegon, MI",43.428739,-86.420908,176511
6413,34780,15-19,2237,2404,4641,"Muskogee, OK",35.617551,-95.383911,66146
6414,34780,20-24,2050,2239,4289,"Muskogee, OK",35.617551,-95.383911,66146
6415,34780,25-29,2027,2069,4096,"Muskogee, OK",35.617551,-95.383911,66146
6416,34780,30-34,2205,2015,4220,"Muskogee, OK",35.617551,-95.383911,66146
6417,34780,35-39,2172,2052,4224,"Muskogee, OK",35.617551,-95.383911,66146
6418,34780,40-44,2144,2051,4195,"Muskogee, OK",35.617551,-95.383911,66146
6419,34780,45-49,1926,1897,3823,"Muskogee, OK",35.617551,-95.383911,66146
6420,34780,50-54,1921,1869,3790,"Muskogee, OK",35.617551,-95.383911,66146
6421,34780,55-59,2055,2014,4069,"Muskogee, OK",35.617551,-95.383911,66146
6422,34780,60-64,2214,2012,4226,"Muskogee, OK",35.617551,-95.383911,66146
6423,34780,65+,6179,5025,11204,"Muskogee, OK",35.617551,-95.383911,66146
6424,34820,15-19,12215,12706,24921,"Myrtle Beach-Conway-North Myrtle Beach, SC-NC",33.969095,-78.612724,509794
6425,34820,20-24,11465,11227,22692,"Myrtle Beach-Conway-North Myrtle Beach, SC-NC",33.969095,-78.612724,509794
6426,34820,25-29,12803,12424,25227,"Myrtle Beach-Conway-North Myrtle Beach, SC-NC",33.969095,-78.612724,509794
6427,34820,30-34,14065,13077,27142,"Myrtle Beach-Conway-North Myrtle Beach, SC-NC",33.969095,-78.612724,509794
6428,34820,35-39,13576,12716,26292,"Myrtle Beach-Conway-North Myrtle Beach, SC-NC",33.969095,-78.612724,509794
6429,34820,40-44,13694,13137,26831,"Myrtle Beach-Conway-North Myrtle Beach, SC-NC",33.969095,-78.612724,509794
6430,34820,45-49,13942,13261,27203,"Myrtle Beach-Conway-North Myrtle Beach, SC-NC",33.969095,-78.612724,509794
6431,34820,50-54,16533,15087,31620,"Myrtle Beach-Conway-North Myrtle Beach, SC-NC",33.969095,-78.612724,509794
6432,34820,55-59,20915,17703,38618,"Myrtle Beach-Conway-North Myrtle Beach, SC-NC",33.969095,-78.612724,509794
6433,34820,60-64,25806,21488,47294,"Myrtle Beach-Conway-North Myrtle Beach, SC-NC",33.969095,-78.612724,509794
6434,34820,65+,75304,68105,143409,"Myrtle Beach-Conway-North Myrtle Beach, SC-NC",33.969095,-78.612724,509794
6435,34860,15-19,3425,2880,6305,"Nacogdoches, TX",31.62056,-94.62025,64668
6436,34860,20-24,4346,3764,8110,"Nacogdoches, TX",31.62056,-94.62025,64668
6437,34860,25-29,2029,1997,4026,"Nacogdoches, TX",31.62056,-94.62025,64668
6438,34860,30-34,1775,1727,3502,"Nacogdoches, TX",31.62056,-94.62025,64668
6439,34860,35-39,1722,1684,3406,"Nacogdoches, TX",31.62056,-94.62025,64668
6440,34860,40-44,1723,1624,3347,"Nacogdoches, TX",31.62056,-94.62025,64668
6441,34860,45-49,1600,1484,3084,"Nacogdoches, TX",31.62056,-94.62025,64668
6442,34860,50-54,1633,1595,3228,"Nacogdoches, TX",31.62056,-94.62025,64668
6443,34860,55-59,1806,1747,3553,"Nacogdoches, TX",31.62056,-94.62025,64668
6444,34860,60-64,1907,1724,3631,"Nacogdoches, TX",31.62056,-94.62025,64668
6445,34860,65+,5460,4506,9966,"Nacogdoches, TX",31.62056,-94.62025,64668
6446,34900,15-19,4240,4537,8777,"Napa, CA",38.5071,-122.325904,136207
6447,34900,20-24,3851,4147,7998,"Napa, CA",38.5071,-122.325904,136207
6448,34900,25-29,4084,4187,8271,"Napa, CA",38.5071,-122.325904,136207
6449,34900,30-34,4151,4219,8370,"Napa, CA",38.5071,-122.325904,136207
6450,34900,35-39,4263,4574,8837,"Napa, CA",38.5071,-122.325904,136207
6451,34900,40-44,4284,4577,8861,"Napa, CA",38.5071,-122.325904,136207
6452,34900,45-49,4100,4385,8485,"Napa, CA",38.5071,-122.325904,136207
6453,34900,50-54,4490,4562,9052,"Napa, CA",38.5071,-122.325904,136207
6454,34900,55-59,4586,4729,9315,"Napa, CA",38.5071,-122.325904,136207
6455,34900,60-64,4654,4521,9175,"Napa, CA",38.5071,-122.325904,136207
6456,34900,65+,14704,12825,27529,"Napa, CA",38.5071,-122.325904,136207
6457,34940,15-19,9019,9784,18803,"Naples-Marco Island, FL",26.118786,-81.400955,385980
6458,34940,20-24,8253,9026,17279,"Naples-Marco Island, FL",26.118786,-81.400955,385980
6459,34940,25-29,8398,9100,17498,"Naples-Marco Island, FL",26.118786,-81.400955,385980
6460,34940,30-34,8622,9634,18256,"Naples-Marco Island, FL",26.118786,-81.400955,385980
6461,34940,35-39,9000,9856,18856,"Naples-Marco Island, FL",26.118786,-81.400955,385980
6462,34940,40-44,9362,9672,19034,"Naples-Marco Island, FL",26.118786,-81.400955,385980
6463,34940,45-49,9843,9525,19368,"Naples-Marco Island, FL",26.118786,-81.400955,385980
6464,34940,50-54,11572,11185,22757,"Naples-Marco Island, FL",26.118786,-81.400955,385980
6465,34940,55-59,13566,12561,26127,"Naples-Marco Island, FL",26.118786,-81.400955,385980
6466,34940,60-64,14817,13460,28277,"Naples-Marco Island, FL",26.118786,-81.400955,385980
6467,34940,65+,66700,60981,127681,"Naples-Marco Island, FL",26.118786,-81.400955,385980
6468,34980,15-19,63218,65702,128920,"Nashville-Davidson--Murfreesboro--Franklin, TN",36.118182,-86.64412,2012476
6469,34980,20-24,67131,64977,132108,"Nashville-Davidson--Murfreesboro--Franklin, TN",36.118182,-86.64412,2012476
6470,34980,25-29,77905,73668,151573,"Nashville-Davidson--Murfreesboro--Franklin, TN",36.118182,-86.64412,2012476
6471,34980,30-34,79534,76767,156301,"Nashville-Davidson--Murfreesboro--Franklin, TN",36.118182,-86.64412,2012476
6472,34980,35-39,73725,72661,146386,"Nashville-Davidson--Murfreesboro--Franklin, TN",36.118182,-86.64412,2012476
6473,34980,40-44,69073,67719,136792,"Nashville-Davidson--Murfreesboro--Franklin, TN",36.118182,-86.64412,2012476
6474,34980,45-49,63328,62946,126274,"Nashville-Davidson--Murfreesboro--Franklin, TN",36.118182,-86.64412,2012476
6475,34980,50-54,64285,63886,128171,"Nashville-Davidson--Murfreesboro--Franklin, TN",36.118182,-86.64412,2012476
6476,34980,55-59,64968,62164,127132,"Nashville-Davidson--Murfreesboro--Franklin, TN",36.118182,-86.64412,2012476
6477,34980,60-64,62208,57153,119361,"Nashville-Davidson--Murfreesboro--Franklin, TN",36.118182,-86.64412,2012476
6478,34980,65+,156026,125385,281411,"Nashville-Davidson--Murfreesboro--Franklin, TN",36.118182,-86.64412,2012476
6479,35020,15-19,1327,1410,2737,"Natchez, MS-LA",31.481833,-91.525331,47118
6480,35020,20-24,1168,1544,2712,"Natchez, MS-LA",31.481833,-91.525331,47118
6481,35020,25-29,1244,1771,3015,"Natchez, MS-LA",31.481833,-91.525331,47118
6482,35020,30-34,1255,1770,3025,"Natchez, MS-LA",31.481833,-91.525331,47118
6483,35020,35-39,1284,1779,3063,"Natchez, MS-LA",31.481833,-91.525331,47118
6484,35020,40-44,1294,1729,3023,"Natchez, MS-LA",31.481833,-91.525331,47118
6485,35020,45-49,1160,1509,2669,"Natchez, MS-LA",31.481833,-91.525331,47118
6486,35020,50-54,1303,1397,2700,"Natchez, MS-LA",31.481833,-91.525331,47118
6487,35020,55-59,1546,1593,3139,"Natchez, MS-LA",31.481833,-91.525331,47118
6488,35020,60-64,1838,1635,3473,"Natchez, MS-LA",31.481833,-91.525331,47118
6489,35020,65+,5257,3992,9249,"Natchez, MS-LA",31.481833,-91.525331,47118
6490,35060,15-19,1762,1636,3398,"Natchitoches, LA",31.732509,-93.082546,37026
6491,35060,20-24,2226,2087,4313,"Natchitoches, LA",31.732509,-93.082546,37026
6492,35060,25-29,1075,1138,2213,"Natchitoches, LA",31.732509,-93.082546,37026
6493,35060,30-34,988,960,1948,"Natchitoches, LA",31.732509,-93.082546,37026
6494,35060,35-39,1029,928,1957,"Natchitoches, LA",31.732509,-93.082546,37026
6495,35060,40-44,974,927,1901,"Natchitoches, LA",31.732509,-93.082546,37026
6496,35060,45-49,920,895,1815,"Natchitoches, LA",31.732509,-93.082546,37026
6497,35060,50-54,1059,930,1989,"Natchitoches, LA",31.732509,-93.082546,37026
6498,35060,55-59,1051,1006,2057,"Natchitoches, LA",31.732509,-93.082546,37026
6499,35060,60-64,1120,992,2112,"Natchitoches, LA",31.732509,-93.082546,37026
6500,35060,65+,3594,2820,6414,"Natchitoches, LA",31.732509,-93.082546,37026
6501,35100,15-19,3258,3692,6950,"New Bern, NC",35.116829,-77.08132,122273
6502,35100,20-24,3725,6043,9768,"New Bern, NC",35.116829,-77.08132,122273
6503,35100,25-29,3635,4477,8112,"New Bern, NC",35.116829,-77.08132,122273
6504,35100,30-34,3639,3832,7471,"New Bern, NC",35.116829,-77.08132,122273
6505,35100,35-39,3358,3645,7003,"New Bern, NC",35.116829,-77.08132,122273
6506,35100,40-44,3231,3299,6530,"New Bern, NC",35.116829,-77.08132,122273
6507,35100,45-49,2984,3071,6055,"New Bern, NC",35.116829,-77.08132,122273
6508,35100,50-54,3337,3175,6512,"New Bern, NC",35.116829,-77.08132,122273
6509,35100,55-59,4064,3633,7697,"New Bern, NC",35.116829,-77.08132,122273
6510,35100,60-64,4710,4103,8813,"New Bern, NC",35.116829,-77.08132,122273
6511,35100,65+,14490,12010,26500,"New Bern, NC",35.116829,-77.08132,122273
6512,35140,15-19,1238,1313,2551,"Newberry, SC",34.289881,-81.599676,37996
6513,35140,20-24,1159,1304,2463,"Newberry, SC",34.289881,-81.599676,37996
6514,35140,25-29,1048,1057,2105,"Newberry, SC",34.289881,-81.599676,37996
6515,35140,30-34,1027,1064,2091,"Newberry, SC",34.289881,-81.599676,37996
6516,35140,35-39,978,1010,1988,"Newberry, SC",34.289881,-81.599676,37996
6517,35140,40-44,1065,1003,2068,"Newberry, SC",34.289881,-81.599676,37996
6518,35140,45-49,1129,1126,2255,"Newberry, SC",34.289881,-81.599676,37996
6519,35140,50-54,1238,1169,2407,"Newberry, SC",34.289881,-81.599676,37996
6520,35140,55-59,1390,1301,2691,"Newberry, SC",34.289881,-81.599676,37996
6521,35140,60-64,1438,1367,2805,"Newberry, SC",34.289881,-81.599676,37996
6522,35140,65+,4260,3555,7815,"Newberry, SC",34.289881,-81.599676,37996
6523,35220,15-19,1342,1575,2917,"New Castle, IN",39.929591,-85.397363,48935
6524,35220,20-24,1220,1684,2904,"New Castle, IN",39.929591,-85.397363,48935
6525,35220,25-29,1328,1904,3232,"New Castle, IN",39.929591,-85.397363,48935
6526,35220,30-34,1340,1766,3106,"New Castle, IN",39.929591,-85.397363,48935
6527,35220,35-39,1240,1605,2845,"New Castle, IN",39.929591,-85.397363,48935
6528,35220,40-44,1322,1730,3052,"New Castle, IN",39.929591,-85.397363,48935
6529,35220,45-49,1419,1762,3181,"New Castle, IN",39.929591,-85.397363,48935
6530,35220,50-54,1485,1807,3292,"New Castle, IN",39.929591,-85.397363,48935
6531,35220,55-59,1749,1843,3592,"New Castle, IN",39.929591,-85.397363,48935
6532,35220,60-64,1658,1673,3331,"New Castle, IN",39.929591,-85.397363,48935
6533,35220,65+,5124,4330,9454,"New Castle, IN",39.929591,-85.397363,48935
6534,35260,15-19,2559,2606,5165,"New Castle, PA",40.992735,-80.334446,85497
6535,35260,20-24,2327,2398,4725,"New Castle, PA",40.992735,-80.334446,85497
6536,35260,25-29,2305,2452,4757,"New Castle, PA",40.992735,-80.334446,85497
6537,35260,30-34,2257,2480,4737,"New Castle, PA",40.992735,-80.334446,85497
6538,35260,35-39,2339,2296,4635,"New Castle, PA",40.992735,-80.334446,85497
6539,35260,40-44,2481,2388,4869,"New Castle, PA",40.992735,-80.334446,85497
6540,35260,45-49,2355,2369,4724,"New Castle, PA",40.992735,-80.334446,85497
6541,35260,50-54,2848,2837,5685,"New Castle, PA",40.992735,-80.334446,85497
6542,35260,55-59,3028,2928,5956,"New Castle, PA",40.992735,-80.334446,85497
6543,35260,60-64,3488,3331,6819,"New Castle, PA",40.992735,-80.334446,85497
6544,35260,65+,10842,8633,19475,"New Castle, PA",40.992735,-80.334446,85497
6545,35300,15-19,28946,29140,58086,"New Haven-Milford, CT",41.349718,-72.900203,863700
6546,35300,20-24,28829,29111,57940,"New Haven-Milford, CT",41.349718,-72.900203,863700
6547,35300,25-29,28775,28888,57663,"New Haven-Milford, CT",41.349718,-72.900203,863700
6548,35300,30-34,29112,28354,57466,"New Haven-Milford, CT",41.349718,-72.900203,863700
6549,35300,35-39,28516,27448,55964,"New Haven-Milford, CT",41.349718,-72.900203,863700
6550,35300,40-44,26656,24976,51632,"New Haven-Milford, CT",41.349718,-72.900203,863700
6551,35300,45-49,25767,23931,49698,"New Haven-Milford, CT",41.349718,-72.900203,863700
6552,35300,50-54,29694,27950,57644,"New Haven-Milford, CT",41.349718,-72.900203,863700
6553,35300,55-59,31668,29721,61389,"New Haven-Milford, CT",41.349718,-72.900203,863700
6554,35300,60-64,30998,29029,60027,"New Haven-Milford, CT",41.349718,-72.900203,863700
6555,35300,65+,87810,68391,156201,"New Haven-Milford, CT",41.349718,-72.900203,863700
6556,35380,15-19,37029,38228,75257,"New Orleans-Metairie, LA",30.05342,-89.934502,1261726
6557,35380,20-24,35158,34474,69632,"New Orleans-Metairie, LA",30.05342,-89.934502,1261726
6558,35380,25-29,41882,39027,80909,"New Orleans-Metairie, LA",30.05342,-89.934502,1261726
6559,35380,30-34,48140,43410,91550,"New Orleans-Metairie, LA",30.05342,-89.934502,1261726
6560,35380,35-39,47657,44195,91852,"New Orleans-Metairie, LA",30.05342,-89.934502,1261726
6561,35380,40-44,42215,39936,82151,"New Orleans-Metairie, LA",30.05342,-89.934502,1261726
6562,35380,45-49,37429,35152,72581,"New Orleans-Metairie, LA",30.05342,-89.934502,1261726
6563,35380,50-54,39819,37358,77177,"New Orleans-Metairie, LA",30.05342,-89.934502,1261726
6564,35380,55-59,44030,40971,85001,"New Orleans-Metairie, LA",30.05342,-89.934502,1261726
6565,35380,60-64,45000,41126,86126,"New Orleans-Metairie, LA",30.05342,-89.934502,1261726
6566,35380,65+,120171,97465,217636,"New Orleans-Metairie, LA",30.05342,-89.934502,1261726
6567,35420,15-19,2702,2903,5605,"New Philadelphia-Dover, OH",40.44749,-81.471105,92500
6568,35420,20-24,2517,2680,5197,"New Philadelphia-Dover, OH",40.44749,-81.471105,92500
6569,35420,25-29,2670,2879,5549,"New Philadelphia-Dover, OH",40.44749,-81.471105,92500
6570,35420,30-34,2667,2655,5322,"New Philadelphia-Dover, OH",40.44749,-81.471105,92500
6571,35420,35-39,2670,2884,5554,"New Philadelphia-Dover, OH",40.44749,-81.471105,92500
6572,35420,40-44,2615,2806,5421,"New Philadelphia-Dover, OH",40.44749,-81.471105,92500
6573,35420,45-49,2566,2629,5195,"New Philadelphia-Dover, OH",40.44749,-81.471105,92500
6574,35420,50-54,2828,2874,5702,"New Philadelphia-Dover, OH",40.44749,-81.471105,92500
6575,35420,55-59,3077,3126,6203,"New Philadelphia-Dover, OH",40.44749,-81.471105,92500
6576,35420,60-64,3438,3295,6733,"New Philadelphia-Dover, OH",40.44749,-81.471105,92500
6577,35420,65+,10205,8306,18511,"New Philadelphia-Dover, OH",40.44749,-81.471105,92500
6578,35440,15-19,1137,1271,2408,"Newport, OR",44.641061,-123.911212,50862
6579,35440,20-24,987,1075,2062,"Newport, OR",44.641061,-123.911212,50862
6580,35440,25-29,1048,1129,2177,"Newport, OR",44.641061,-123.911212,50862
6581,35440,30-34,1236,1188,2424,"Newport, OR",44.641061,-123.911212,50862
6582,35440,35-39,1384,1317,2701,"Newport, OR",44.641061,-123.911212,50862
6583,35440,40-44,1452,1349,2801,"Newport, OR",44.641061,-123.911212,50862
6584,35440,45-49,1296,1288,2584,"Newport, OR",44.641061,-123.911212,50862
6585,35440,50-54,1529,1484,3013,"Newport, OR",44.641061,-123.911212,50862
6586,35440,55-59,1926,1623,3549,"Newport, OR",44.641061,-123.911212,50862
6587,35440,60-64,2587,2161,4748,"Newport, OR",44.641061,-123.911212,50862
6588,35440,65+,8387,7356,15743,"Newport, OR",44.641061,-123.911212,50862
6589,35460,15-19,958,1022,1980,"Newport, TN",35.916198,-83.119224,36418
6590,35460,20-24,928,926,1854,"Newport, TN",35.916198,-83.119224,36418
6591,35460,25-29,1008,1054,2062,"Newport, TN",35.916198,-83.119224,36418
6592,35460,30-34,1066,976,2042,"Newport, TN",35.916198,-83.119224,36418
6593,35460,35-39,1003,957,1960,"Newport, TN",35.916198,-83.119224,36418
6594,35460,40-44,1049,930,1979,"Newport, TN",35.916198,-83.119224,36418
6595,35460,45-49,1145,1112,2257,"Newport, TN",35.916198,-83.119224,36418
6596,35460,50-54,1294,1263,2557,"Newport, TN",35.916198,-83.119224,36418
6597,35460,55-59,1478,1372,2850,"Newport, TN",35.916198,-83.119224,36418
6598,35460,60-64,1513,1348,2861,"Newport, TN",35.916198,-83.119224,36418
6599,35460,65+,4239,3745,7984,"Newport, TN",35.916198,-83.119224,36418
6600,35580,15-19,836,914,1750,"New Ulm, MN",44.246541,-94.733647,25819
6601,35580,20-24,845,878,1723,"New Ulm, MN",44.246541,-94.733647,25819
6602,35580,25-29,631,697,1328,"New Ulm, MN",44.246541,-94.733647,25819
6603,35580,30-34,661,672,1333,"New Ulm, MN",44.246541,-94.733647,25819
6604,35580,35-39,775,825,1600,"New Ulm, MN",44.246541,-94.733647,25819
6605,35580,40-44,721,743,1464,"New Ulm, MN",44.246541,-94.733647,25819
6606,35580,45-49,617,655,1272,"New Ulm, MN",44.246541,-94.733647,25819
6607,35580,50-54,691,689,1380,"New Ulm, MN",44.246541,-94.733647,25819
6608,35580,55-59,895,884,1779,"New Ulm, MN",44.246541,-94.733647,25819
6609,35580,60-64,989,974,1963,"New Ulm, MN",44.246541,-94.733647,25819
6610,35580,65+,3002,2560,5562,"New Ulm, MN",44.246541,-94.733647,25819
6611,35620,15-19,576791,601554,1178345,"New York-Newark-Jersey City, NY-NJ-PA",40.77493,-73.873758,19768458
6612,35620,20-24,588543,579790,1168333,"New York-Newark-Jersey City, NY-NJ-PA",40.77493,-73.873758,19768458
6613,35620,25-29,697481,677770,1375251,"New York-Newark-Jersey City, NY-NJ-PA",40.77493,-73.873758,19768458
6614,35620,30-34,718020,718590,1436610,"New York-Newark-Jersey City, NY-NJ-PA",40.77493,-73.873758,19768458
6615,35620,35-39,675778,676493,1352271,"New York-Newark-Jersey City, NY-NJ-PA",40.77493,-73.873758,19768458
6616,35620,40-44,644954,631551,1276505,"New York-Newark-Jersey City, NY-NJ-PA",40.77493,-73.873758,19768458
6617,35620,45-49,621447,600311,1221758,"New York-Newark-Jersey City, NY-NJ-PA",40.77493,-73.873758,19768458
6618,35620,50-54,672978,645928,1318906,"New York-Newark-Jersey City, NY-NJ-PA",40.77493,-73.873758,19768458
6619,35620,55-59,696127,660695,1356822,"New York-Newark-Jersey City, NY-NJ-PA",40.77493,-73.873758,19768458
6620,35620,60-64,660273,614145,1274418,"New York-Newark-Jersey City, NY-NJ-PA",40.77493,-73.873758,19768458
6621,35620,65+,1877581,1434807,3312388,"New York-Newark-Jersey City, NY-NJ-PA",40.77493,-73.873758,19768458
6622,35660,15-19,4604,4959,9563,"Niles, MI",41.791382,-86.742543,153101
6623,35660,20-24,4324,4423,8747,"Niles, MI",41.791382,-86.742543,153101
6624,35660,25-29,4264,4414,8678,"Niles, MI",41.791382,-86.742543,153101
6625,35660,30-34,4432,4457,8889,"Niles, MI",41.791382,-86.742543,153101
6626,35660,35-39,4645,4486,9131,"Niles, MI",41.791382,-86.742543,153101
6627,35660,40-44,4456,4459,8915,"Niles, MI",41.791382,-86.742543,153101
6628,35660,45-49,4237,4347,8584,"Niles, MI",41.791382,-86.742543,153101
6629,35660,50-54,4994,4821,9815,"Niles, MI",41.791382,-86.742543,153101
6630,35660,55-59,5365,5344,10709,"Niles, MI",41.791382,-86.742543,153101
6631,35660,60-64,5777,5558,11335,"Niles, MI",41.791382,-86.742543,153101
6632,35660,65+,17356,14450,31806,"Niles, MI",41.791382,-86.742543,153101
6633,35700,15-19,1845,1778,3623,"Nogales, AZ",31.525733,-110.845228,47883
6634,35700,20-24,1414,1548,2962,"Nogales, AZ",31.525733,-110.845228,47883
6635,35700,25-29,1478,1406,2884,"Nogales, AZ",31.525733,-110.845228,47883
6636,35700,30-34,1356,1361,2717,"Nogales, AZ",31.525733,-110.845228,47883
6637,35700,35-39,1332,1224,2556,"Nogales, AZ",31.525733,-110.845228,47883
6638,35700,40-44,1429,1249,2678,"Nogales, AZ",31.525733,-110.845228,47883
6639,35700,45-49,1444,1229,2673,"Nogales, AZ",31.525733,-110.845228,47883
6640,35700,50-54,1393,1304,2697,"Nogales, AZ",31.525733,-110.845228,47883
6641,35700,55-59,1438,1300,2738,"Nogales, AZ",31.525733,-110.845228,47883
6642,35700,60-64,1531,1400,2931,"Nogales, AZ",31.525733,-110.845228,47883
6643,35700,65+,4955,4220,9175,"Nogales, AZ",31.525733,-110.845228,47883
6644,35740,15-19,1676,1802,3478,"Norfolk, NE",42.04313,-97.487952,48466
6645,35740,20-24,1333,1449,2782,"Norfolk, NE",42.04313,-97.487952,48466
6646,35740,25-29,1358,1431,2789,"Norfolk, NE",42.04313,-97.487952,48466
6647,35740,30-34,1369,1513,2882,"Norfolk, NE",42.04313,-97.487952,48466
6648,35740,35-39,1484,1673,3157,"Norfolk, NE",42.04313,-97.487952,48466
6649,35740,40-44,1422,1475,2897,"Norfolk, NE",42.04313,-97.487952,48466
6650,35740,45-49,1219,1290,2509,"Norfolk, NE",42.04313,-97.487952,48466
6651,35740,50-54,1260,1279,2539,"Norfolk, NE",42.04313,-97.487952,48466
6652,35740,55-59,1561,1613,3174,"Norfolk, NE",42.04313,-97.487952,48466
6653,35740,60-64,1711,1785,3496,"Norfolk, NE",42.04313,-97.487952,48466
6654,35740,65+,4480,3973,8453,"Norfolk, NE",42.04313,-97.487952,48466
6655,35820,15-19,1169,1193,2362,"North Platte, NE",41.230781,-100.783339,35199
6656,35820,20-24,856,878,1734,"North Platte, NE",41.230781,-100.783339,35199
6657,35820,25-29,877,978,1855,"North Platte, NE",41.230781,-100.783339,35199
6658,35820,30-34,956,955,1911,"North Platte, NE",41.230781,-100.783339,35199
6659,35820,35-39,1131,1083,2214,"North Platte, NE",41.230781,-100.783339,35199
6660,35820,40-44,1141,1149,2290,"North Platte, NE",41.230781,-100.783339,35199
6661,35820,45-49,1012,1071,2083,"North Platte, NE",41.230781,-100.783339,35199
6662,35820,50-54,986,1103,2089,"North Platte, NE",41.230781,-100.783339,35199
6663,35820,55-59,1087,1096,2183,"North Platte, NE",41.230781,-100.783339,35199
6664,35820,60-64,1287,1240,2527,"North Platte, NE",41.230781,-100.783339,35199
6665,35820,65+,3915,3382,7297,"North Platte, NE",41.230781,-100.783339,35199
6666,35840,15-19,19259,20456,39715,"North Port-Sarasota-Bradenton, FL",27.329055,-82.414533,859760
6667,35840,20-24,18272,18898,37170,"North Port-Sarasota-Bradenton, FL",27.329055,-82.414533,859760
6668,35840,25-29,19261,19500,38761,"North Port-Sarasota-Bradenton, FL",27.329055,-82.414533,859760
6669,35840,30-34,20492,20313,40805,"North Port-Sarasota-Bradenton, FL",27.329055,-82.414533,859760
6670,35840,35-39,20673,20133,40806,"North Port-Sarasota-Bradenton, FL",27.329055,-82.414533,859760
6671,35840,40-44,21130,20237,41367,"North Port-Sarasota-Bradenton, FL",27.329055,-82.414533,859760
6672,35840,45-49,22105,20681,42786,"North Port-Sarasota-Bradenton, FL",27.329055,-82.414533,859760
6673,35840,50-54,27121,25008,52129,"North Port-Sarasota-Bradenton, FL",27.329055,-82.414533,859760
6674,35840,55-59,32455,28937,61392,"North Port-Sarasota-Bradenton, FL",27.329055,-82.414533,859760
6675,35840,60-64,38129,33013,71142,"North Port-Sarasota-Bradenton, FL",27.329055,-82.414533,859760
6676,35840,65+,151935,131677,283612,"North Port-Sarasota-Bradenton, FL",27.329055,-82.414533,859760
6677,35860,15-19,816,857,1673,"North Vernon, IN",38.996229,-85.628103,27409
6678,35860,20-24,757,830,1587,"North Vernon, IN",38.996229,-85.628103,27409
6679,35860,25-29,912,921,1833,"North Vernon, IN",38.996229,-85.628103,27409
6680,35860,30-34,819,854,1673,"North Vernon, IN",38.996229,-85.628103,27409
6681,35860,35-39,723,774,1497,"North Vernon, IN",38.996229,-85.628103,27409
6682,35860,40-44,747,791,1538,"North Vernon, IN",38.996229,-85.628103,27409
6683,35860,45-49,874,902,1776,"North Vernon, IN",38.996229,-85.628103,27409
6684,35860,50-54,969,1060,2029,"North Vernon, IN",38.996229,-85.628103,27409
6685,35860,55-59,994,1011,2005,"North Vernon, IN",38.996229,-85.628103,27409
6686,35860,60-64,910,1002,1912,"North Vernon, IN",38.996229,-85.628103,27409
6687,35860,65+,2512,2142,4654,"North Vernon, IN",38.996229,-85.628103,27409
6688,35900,15-19,1858,2034,3892,"North Wilkesboro, NC",36.208883,-81.166095,65806
6689,35900,20-24,1773,1856,3629,"North Wilkesboro, NC",36.208883,-81.166095,65806
6690,35900,25-29,1790,1883,3673,"North Wilkesboro, NC",36.208883,-81.166095,65806
6691,35900,30-34,1844,1771,3615,"North Wilkesboro, NC",36.208883,-81.166095,65806
6692,35900,35-39,1643,1726,3369,"North Wilkesboro, NC",36.208883,-81.166095,65806
6693,35900,40-44,1809,1878,3687,"North Wilkesboro, NC",36.208883,-81.166095,65806
6694,35900,45-49,2041,2053,4094,"North Wilkesboro, NC",36.208883,-81.166095,65806
6695,35900,50-54,2210,2280,4490,"North Wilkesboro, NC",36.208883,-81.166095,65806
6696,35900,55-59,2464,2448,4912,"North Wilkesboro, NC",36.208883,-81.166095,65806
6697,35900,60-64,2489,2455,4944,"North Wilkesboro, NC",36.208883,-81.166095,65806
6698,35900,65+,8109,6737,14846,"North Wilkesboro, NC",36.208883,-81.166095,65806
6699,35940,15-19,1876,2020,3896,"Norwalk, OH",41.14508,-82.594641,58367
6700,35940,20-24,1621,1682,3303,"Norwalk, OH",41.14508,-82.594641,58367
6701,35940,25-29,1696,1879,3575,"Norwalk, OH",41.14508,-82.594641,58367
6702,35940,30-34,1660,1765,3425,"Norwalk, OH",41.14508,-82.594641,58367
6703,35940,35-39,1690,1733,3423,"Norwalk, OH",41.14508,-82.594641,58367
6704,35940,40-44,1759,1727,3486,"Norwalk, OH",41.14508,-82.594641,58367
6705,35940,45-49,1662,1774,3436,"Norwalk, OH",41.14508,-82.594641,58367
6706,35940,50-54,1861,1924,3785,"Norwalk, OH",41.14508,-82.594641,58367
6707,35940,55-59,2083,2039,4122,"Norwalk, OH",41.14508,-82.594641,58367
6708,35940,60-64,2100,1961,4061,"Norwalk, OH",41.14508,-82.594641,58367
6709,35940,65+,5773,4763,10536,"Norwalk, OH",41.14508,-82.594641,58367
6710,35980,15-19,8008,8673,16681,"Norwich-New London, CT",41.472652,-72.108634,268805
6711,35980,20-24,8112,10932,19044,"Norwich-New London, CT",41.472652,-72.108634,268805
6712,35980,25-29,8174,9861,18035,"Norwich-New London, CT",41.472652,-72.108634,268805
6713,35980,30-34,8296,9199,17495,"Norwich-New London, CT",41.472652,-72.108634,268805
6714,35980,35-39,8363,8277,16640,"Norwich-New London, CT",41.472652,-72.108634,268805
6715,35980,40-44,7551,7546,15097,"Norwich-New London, CT",41.472652,-72.108634,268805
6716,35980,45-49,7383,7110,14493,"Norwich-New London, CT",41.472652,-72.108634,268805
6717,35980,50-54,8921,8644,17565,"Norwich-New London, CT",41.472652,-72.108634,268805
6718,35980,55-59,10195,9890,20085,"Norwich-New London, CT",41.472652,-72.108634,268805
6719,35980,60-64,10164,9893,20057,"Norwich-New London, CT",41.472652,-72.108634,268805
6720,35980,65+,27909,23934,51843,"Norwich-New London, CT",41.472652,-72.108634,268805
6721,36020,15-19,1808,1970,3778,"Oak Harbor, WA",48.158554,-122.670649,87432
6722,36020,20-24,2383,3253,5636,"Oak Harbor, WA",48.158554,-122.670649,87432
6723,36020,25-29,2820,3352,6172,"Oak Harbor, WA",48.158554,-122.670649,87432
6724,36020,30-34,2717,3121,5838,"Oak Harbor, WA",48.158554,-122.670649,87432
6725,36020,35-39,2589,2870,5459,"Oak Harbor, WA",48.158554,-122.670649,87432
6726,36020,40-44,2175,2296,4471,"Oak Harbor, WA",48.158554,-122.670649,87432
6727,36020,45-49,1927,1902,3829,"Oak Harbor, WA",48.158554,-122.670649,87432
6728,36020,50-54,2243,2150,4393,"Oak Harbor, WA",48.158554,-122.670649,87432
6729,36020,55-59,2859,2595,5454,"Oak Harbor, WA",48.158554,-122.670649,87432
6730,36020,60-64,3495,2999,6494,"Oak Harbor, WA",48.158554,-122.670649,87432
6731,36020,65+,12078,10658,22736,"Oak Harbor, WA",48.158554,-122.670649,87432
6732,36100,15-19,9526,10094,19620,"Ocala, FL",29.202805,-82.0431,385915
6733,36100,20-24,9072,9326,18398,"Ocala, FL",29.202805,-82.0431,385915
6734,36100,25-29,10363,10194,20557,"Ocala, FL",29.202805,-82.0431,385915
6735,36100,30-34,11280,10729,22009,"Ocala, FL",29.202805,-82.0431,385915
6736,36100,35-39,10523,9920,20443,"Ocala, FL",29.202805,-82.0431,385915
6737,36100,40-44,10140,9371,19511,"Ocala, FL",29.202805,-82.0431,385915
6738,36100,45-49,10132,9336,19468,"Ocala, FL",29.202805,-82.0431,385915
6739,36100,50-54,11560,10598,22158,"Ocala, FL",29.202805,-82.0431,385915
6740,36100,55-59,13270,11770,25040,"Ocala, FL",29.202805,-82.0431,385915
6741,36100,60-64,15215,13063,28278,"Ocala, FL",29.202805,-82.0431,385915
6742,36100,65+,59672,51215,110887,"Ocala, FL",29.202805,-82.0431,385915
6743,36140,15-19,2244,2493,4737,"Ocean City, NJ",39.085841,-74.846354,95661
6744,36140,20-24,2210,2591,4801,"Ocean City, NJ",39.085841,-74.846354,95661
6745,36140,25-29,2390,2674,5064,"Ocean City, NJ",39.085841,-74.846354,95661
6746,36140,30-34,2282,2544,4826,"Ocean City, NJ",39.085841,-74.846354,95661
6747,36140,35-39,2342,2410,4752,"Ocean City, NJ",39.085841,-74.846354,95661
6748,36140,40-44,2325,2249,4574,"Ocean City, NJ",39.085841,-74.846354,95661
6749,36140,45-49,2228,2266,4494,"Ocean City, NJ",39.085841,-74.846354,95661
6750,36140,50-54,2885,2903,5788,"Ocean City, NJ",39.085841,-74.846354,95661
6751,36140,55-59,3916,3541,7457,"Ocean City, NJ",39.085841,-74.846354,95661
6752,36140,60-64,4554,4049,8603,"Ocean City, NJ",39.085841,-74.846354,95661
6753,36140,65+,14694,12299,26993,"Ocean City, NJ",39.085841,-74.846354,95661
6754,36220,15-19,6121,6370,12491,"Odessa, TX",31.865301,-102.542507,161091
6755,36220,20-24,5382,5675,11057,"Odessa, TX",31.865301,-102.542507,161091
6756,36220,25-29,5775,6358,12133,"Odessa, TX",31.865301,-102.542507,161091
6757,36220,30-34,6019,7007,13026,"Odessa, TX",31.865301,-102.542507,161091
6758,36220,35-39,5619,6520,12139,"Odessa, TX",31.865301,-102.542507,161091
6759,36220,40-44,4786,5494,10280,"Odessa, TX",31.865301,-102.542507,161091
6760,36220,45-49,4345,4622,8967,"Odessa, TX",31.865301,-102.542507,161091
6761,36220,50-54,4044,4216,8260,"Odessa, TX",31.865301,-102.542507,161091
6762,36220,55-59,3866,3933,7799,"Odessa, TX",31.865301,-102.542507,161091
6763,36220,60-64,3653,3649,7302,"Odessa, TX",31.865301,-102.542507,161091
6764,36220,65+,8556,7144,15700,"Odessa, TX",31.865301,-102.542507,161091
6765,36260,15-19,26715,29407,56122,"Ogden-Clearfield, UT",41.622623,-113.060252,706696
6766,36260,20-24,23069,25196,48265,"Ogden-Clearfield, UT",41.622623,-113.060252,706696
6767,36260,25-29,24412,25536,49948,"Ogden-Clearfield, UT",41.622623,-113.060252,706696
6768,36260,30-34,24610,24821,49431,"Ogden-Clearfield, UT",41.622623,-113.060252,706696
6769,36260,35-39,25396,26217,51613,"Ogden-Clearfield, UT",41.622623,-113.060252,706696
6770,36260,40-44,25410,26763,52173,"Ogden-Clearfield, UT",41.622623,-113.060252,706696
6771,36260,45-49,20436,21153,41589,"Ogden-Clearfield, UT",41.622623,-113.060252,706696
6772,36260,50-54,17873,18328,36201,"Ogden-Clearfield, UT",41.622623,-113.060252,706696
6773,36260,55-59,17115,17610,34725,"Ogden-Clearfield, UT",41.622623,-113.060252,706696
6774,36260,60-64,17204,17409,34613,"Ogden-Clearfield, UT",41.622623,-113.060252,706696
6775,36260,65+,42710,38026,80736,"Ogden-Clearfield, UT",41.622623,-113.060252,706696
6776,36300,15-19,4470,4830,9300,"Ogdensburg-Massena, NY",44.488112,-75.074311,108051
6777,36300,20-24,4150,4971,9121,"Ogdensburg-Massena, NY",44.488112,-75.074311,108051
6778,36300,25-29,2574,3199,5773,"Ogdensburg-Massena, NY",44.488112,-75.074311,108051
6779,36300,30-34,2958,3430,6388,"Ogdensburg-Massena, NY",44.488112,-75.074311,108051
6780,36300,35-39,2915,3383,6298,"Ogdensburg-Massena, NY",44.488112,-75.074311,108051
6781,36300,40-44,2936,3120,6056,"Ogdensburg-Massena, NY",44.488112,-75.074311,108051
6782,36300,45-49,2830,3097,5927,"Ogdensburg-Massena, NY",44.488112,-75.074311,108051
6783,36300,50-54,3191,3527,6718,"Ogdensburg-Massena, NY",44.488112,-75.074311,108051
6784,36300,55-59,3780,3677,7457,"Ogdensburg-Massena, NY",44.488112,-75.074311,108051
6785,36300,60-64,3877,3857,7734,"Ogdensburg-Massena, NY",44.488112,-75.074311,108051
6786,36300,65+,10355,9295,19650,"Ogdensburg-Massena, NY",44.488112,-75.074311,108051
6787,36340,15-19,1252,1517,2769,"Oil City, PA",41.400714,-79.765813,49938
6788,36340,20-24,1176,1239,2415,"Oil City, PA",41.400714,-79.765813,49938
6789,36340,25-29,1156,1313,2469,"Oil City, PA",41.400714,-79.765813,49938
6790,36340,30-34,1278,1299,2577,"Oil City, PA",41.400714,-79.765813,49938
6791,36340,35-39,1377,1350,2727,"Oil City, PA",41.400714,-79.765813,49938
6792,36340,40-44,1413,1397,2810,"Oil City, PA",41.400714,-79.765813,49938
6793,36340,45-49,1369,1473,2842,"Oil City, PA",41.400714,-79.765813,49938
6794,36340,50-54,1652,1669,3321,"Oil City, PA",41.400714,-79.765813,49938
6795,36340,55-59,1922,1928,3850,"Oil City, PA",41.400714,-79.765813,49938
6796,36340,60-64,2275,2238,4513,"Oil City, PA",41.400714,-79.765813,49938
6797,36340,65+,6482,5569,12051,"Oil City, PA",41.400714,-79.765813,49938
6798,36380,15-19,1018,1338,2356,"Okeechobee, FL",27.385592,-80.887388,40266
6799,36380,20-24,970,1196,2166,"Okeechobee, FL",27.385592,-80.887388,40266
6800,36380,25-29,1075,1455,2530,"Okeechobee, FL",27.385592,-80.887388,40266
6801,36380,30-34,1205,1449,2654,"Okeechobee, FL",27.385592,-80.887388,40266
6802,36380,35-39,1033,1438,2471,"Okeechobee, FL",27.385592,-80.887388,40266
6803,36380,40-44,1082,1465,2547,"Okeechobee, FL",27.385592,-80.887388,40266
6804,36380,45-49,1167,1438,2605,"Okeechobee, FL",27.385592,-80.887388,40266
6805,36380,50-54,1038,1498,2536,"Okeechobee, FL",27.385592,-80.887388,40266
6806,36380,55-59,1217,1414,2631,"Okeechobee, FL",27.385592,-80.887388,40266
6807,36380,60-64,1276,1264,2540,"Okeechobee, FL",27.385592,-80.887388,40266
6808,36380,65+,4103,3963,8066,"Okeechobee, FL",27.385592,-80.887388,40266
6809,36420,15-19,48683,50867,99550,"Oklahoma City, OK",35.430968,-97.506966,1441647
6810,36420,20-24,51586,52754,104340,"Oklahoma City, OK",35.430968,-97.506966,1441647
6811,36420,25-29,50246,51680,101926,"Oklahoma City, OK",35.430968,-97.506966,1441647
6812,36420,30-34,52276,51273,103549,"Oklahoma City, OK",35.430968,-97.506966,1441647
6813,36420,35-39,51916,52250,104166,"Oklahoma City, OK",35.430968,-97.506966,1441647
6814,36420,40-44,47171,47322,94493,"Oklahoma City, OK",35.430968,-97.506966,1441647
6815,36420,45-49,41636,41606,83242,"Oklahoma City, OK",35.430968,-97.506966,1441647
6816,36420,50-54,40552,40835,81387,"Oklahoma City, OK",35.430968,-97.506966,1441647
6817,36420,55-59,42882,41124,84006,"Oklahoma City, OK",35.430968,-97.506966,1441647
6818,36420,60-64,43766,40894,84660,"Oklahoma City, OK",35.430968,-97.506966,1441647
6819,36420,65+,115989,94832,210821,"Oklahoma City, OK",35.430968,-97.506966,1441647
6820,36460,15-19,2563,2643,5206,"Olean, NY",42.239099,-78.662332,76426
6821,36460,20-24,2233,2449,4682,"Olean, NY",42.239099,-78.662332,76426
6822,36460,25-29,1953,2015,3968,"Olean, NY",42.239099,-78.662332,76426
6823,36460,30-34,2068,2115,4183,"Olean, NY",42.239099,-78.662332,76426
6824,36460,35-39,2118,2224,4342,"Olean, NY",42.239099,-78.662332,76426
6825,36460,40-44,2139,2159,4298,"Olean, NY",42.239099,-78.662332,76426
6826,36460,45-49,2110,2081,4191,"Olean, NY",42.239099,-78.662332,76426
6827,36460,50-54,2404,2445,4849,"Olean, NY",42.239099,-78.662332,76426
6828,36460,55-59,2766,2811,5577,"Olean, NY",42.239099,-78.662332,76426
6829,36460,60-64,2962,2909,5871,"Olean, NY",42.239099,-78.662332,76426
6830,36460,65+,8110,7375,15485,"Olean, NY",42.239099,-78.662332,76426
6831,36500,15-19,8161,8500,16661,"Olympia-Lacey-Tumwater, WA",46.935822,-122.830152,297977
6832,36500,20-24,8424,8588,17012,"Olympia-Lacey-Tumwater, WA",46.935822,-122.830152,297977
6833,36500,25-29,10111,10653,20764,"Olympia-Lacey-Tumwater, WA",46.935822,-122.830152,297977
6834,36500,30-34,11013,11280,22293,"Olympia-Lacey-Tumwater, WA",46.935822,-122.830152,297977
6835,36500,35-39,11101,11029,22130,"Olympia-Lacey-Tumwater, WA",46.935822,-122.830152,297977
6836,36500,40-44,10216,10157,20373,"Olympia-Lacey-Tumwater, WA",46.935822,-122.830152,297977
6837,36500,45-49,8725,8648,17373,"Olympia-Lacey-Tumwater, WA",46.935822,-122.830152,297977
6838,36500,50-54,9045,8992,18037,"Olympia-Lacey-Tumwater, WA",46.935822,-122.830152,297977
6839,36500,55-59,9369,8632,18001,"Olympia-Lacey-Tumwater, WA",46.935822,-122.830152,297977
6840,36500,60-64,9904,8977,18881,"Olympia-Lacey-Tumwater, WA",46.935822,-122.830152,297977
6841,36500,65+,29845,24235,54080,"Olympia-Lacey-Tumwater, WA",46.935822,-122.830152,297977
6842,36540,15-19,32372,33977,66349,"Omaha-Council Bluffs, NE-IA",41.290459,-95.99997,971637
6843,36540,20-24,29407,30126,59533,"Omaha-Council Bluffs, NE-IA",41.290459,-95.99997,971637
6844,36540,25-29,33160,33745,66905,"Omaha-Council Bluffs, NE-IA",41.290459,-95.99997,971637
6845,36540,30-34,33691,34267,67958,"Omaha-Council Bluffs, NE-IA",41.290459,-95.99997,971637
6846,36540,35-39,35033,35753,70786,"Omaha-Council Bluffs, NE-IA",41.290459,-95.99997,971637
6847,36540,40-44,32032,33073,65105,"Omaha-Council Bluffs, NE-IA",41.290459,-95.99997,971637
6848,36540,45-49,27939,28548,56487,"Omaha-Council Bluffs, NE-IA",41.290459,-95.99997,971637
6849,36540,50-54,27943,28734,56677,"Omaha-Council Bluffs, NE-IA",41.290459,-95.99997,971637
6850,36540,55-59,29609,29758,59367,"Omaha-Council Bluffs, NE-IA",41.290459,-95.99997,971637
6851,36540,60-64,29495,28483,57978,"Omaha-Council Bluffs, NE-IA",41.290459,-95.99997,971637
6852,36540,65+,77011,63509,140520,"Omaha-Council Bluffs, NE-IA",41.290459,-95.99997,971637
6853,36580,15-19,2695,2151,4846,"Oneonta, NY",42.629776,-75.028841,58123
6854,36580,20-24,3337,2985,6322,"Oneonta, NY",42.629776,-75.028841,58123
6855,36580,25-29,1498,1504,3002,"Oneonta, NY",42.629776,-75.028841,58123
6856,36580,30-34,1397,1456,2853,"Oneonta, NY",42.629776,-75.028841,58123
6857,36580,35-39,1454,1533,2987,"Oneonta, NY",42.629776,-75.028841,58123
6858,36580,40-44,1420,1493,2913,"Oneonta, NY",42.629776,-75.028841,58123
6859,36580,45-49,1415,1409,2824,"Oneonta, NY",42.629776,-75.028841,58123
6860,36580,50-54,1750,1762,3512,"Oneonta, NY",42.629776,-75.028841,58123
6861,36580,55-59,2034,2026,4060,"Oneonta, NY",42.629776,-75.028841,58123
6862,36580,60-64,2270,2219,4489,"Oneonta, NY",42.629776,-75.028841,58123
6863,36580,65+,6877,5953,12830,"Oneonta, NY",42.629776,-75.028841,58123
6864,36620,15-19,1893,2109,4002,"Ontario, OR-ID",43.225869,-117.619933,58043
6865,36620,20-24,1514,1969,3483,"Ontario, OR-ID",43.225869,-117.619933,58043
6866,36620,25-29,1563,2113,3676,"Ontario, OR-ID",43.225869,-117.619933,58043
6867,36620,30-34,1654,2005,3659,"Ontario, OR-ID",43.225869,-117.619933,58043
6868,36620,35-39,1544,2024,3568,"Ontario, OR-ID",43.225869,-117.619933,58043
6869,36620,40-44,1564,1882,3446,"Ontario, OR-ID",43.225869,-117.619933,58043
6870,36620,45-49,1461,1849,3310,"Ontario, OR-ID",43.225869,-117.619933,58043
6871,36620,50-54,1529,1793,3322,"Ontario, OR-ID",43.225869,-117.619933,58043
6872,36620,55-59,1604,1729,3333,"Ontario, OR-ID",43.225869,-117.619933,58043
6873,36620,60-64,1733,1737,3470,"Ontario, OR-ID",43.225869,-117.619933,58043
6874,36620,65+,5306,4984,10290,"Ontario, OR-ID",43.225869,-117.619933,58043
6875,36660,15-19,2703,2940,5643,"Opelousas, LA",30.583441,-91.989274,82071
6876,36660,20-24,2404,2462,4866,"Opelousas, LA",30.583441,-91.989274,82071
6877,36660,25-29,2536,2414,4950,"Opelousas, LA",30.583441,-91.989274,82071
6878,36660,30-34,2651,2464,5115,"Opelousas, LA",30.583441,-91.989274,82071
6879,36660,35-39,2599,2388,4987,"Opelousas, LA",30.583441,-91.989274,82071
6880,36660,40-44,2391,2251,4642,"Opelousas, LA",30.583441,-91.989274,82071
6881,36660,45-49,2205,2045,4250,"Opelousas, LA",30.583441,-91.989274,82071
6882,36660,50-54,2481,2348,4829,"Opelousas, LA",30.583441,-91.989274,82071
6883,36660,55-59,2850,2593,5443,"Opelousas, LA",30.583441,-91.989274,82071
6884,36660,60-64,2819,2562,5381,"Opelousas, LA",30.583441,-91.989274,82071
6885,36660,65+,7677,6171,13848,"Opelousas, LA",30.583441,-91.989274,82071
6886,36700,15-19,2915,2970,5885,"Orangeburg, SC",33.436135,-80.802913,82962
6887,36700,20-24,2907,2694,5601,"Orangeburg, SC",33.436135,-80.802913,82962
6888,36700,25-29,2424,2219,4643,"Orangeburg, SC",33.436135,-80.802913,82962
6889,36700,30-34,2558,2194,4752,"Orangeburg, SC",33.436135,-80.802913,82962
6890,36700,35-39,2429,2013,4442,"Orangeburg, SC",33.436135,-80.802913,82962
6891,36700,40-44,2306,2026,4332,"Orangeburg, SC",33.436135,-80.802913,82962
6892,36700,45-49,2320,1927,4247,"Orangeburg, SC",33.436135,-80.802913,82962
6893,36700,50-54,2652,2318,4970,"Orangeburg, SC",33.436135,-80.802913,82962
6894,36700,55-59,3211,2779,5990,"Orangeburg, SC",33.436135,-80.802913,82962
6895,36700,60-64,3075,2734,5809,"Orangeburg, SC",33.436135,-80.802913,82962
6896,36700,65+,9817,7528,17345,"Orangeburg, SC",33.436135,-80.802913,82962
6897,36740,15-19,83126,85383,168509,"Orlando-Kissimmee-Sanford, FL",28.434396,-81.356084,2691925
6898,36740,20-24,88801,85752,174553,"Orlando-Kissimmee-Sanford, FL",28.434396,-81.356084,2691925
6899,36740,25-29,97541,97135,194676,"Orlando-Kissimmee-Sanford, FL",28.434396,-81.356084,2691925
6900,36740,30-34,100779,102044,202823,"Orlando-Kissimmee-Sanford, FL",28.434396,-81.356084,2691925
6901,36740,35-39,97064,98008,195072,"Orlando-Kissimmee-Sanford, FL",28.434396,-81.356084,2691925
6902,36740,40-44,94807,93567,188374,"Orlando-Kissimmee-Sanford, FL",28.434396,-81.356084,2691925
6903,36740,45-49,88954,85772,174726,"Orlando-Kissimmee-Sanford, FL",28.434396,-81.356084,2691925
6904,36740,50-54,87611,85940,173551,"Orlando-Kissimmee-Sanford, FL",28.434396,-81.356084,2691925
6905,36740,55-59,86564,83761,170325,"Orlando-Kissimmee-Sanford, FL",28.434396,-81.356084,2691925
6906,36740,60-64,80842,74963,155805,"Orlando-Kissimmee-Sanford, FL",28.434396,-81.356084,2691925
6907,36740,65+,230868,187163,418031,"Orlando-Kissimmee-Sanford, FL",28.434396,-81.356084,2691925
6908,36780,15-19,5666,5708,11374,"Oshkosh-Neenah, WI",44.085707,-88.668149,171623
6909,36780,20-24,7254,7315,14569,"Oshkosh-Neenah, WI",44.085707,-88.668149,171623
6910,36780,25-29,5441,6306,11747,"Oshkosh-Neenah, WI",44.085707,-88.668149,171623
6911,36780,30-34,5111,5960,11071,"Oshkosh-Neenah, WI",44.085707,-88.668149,171623
6912,36780,35-39,5198,5908,11106,"Oshkosh-Neenah, WI",44.085707,-88.668149,171623
6913,36780,40-44,4900,5585,10485,"Oshkosh-Neenah, WI",44.085707,-88.668149,171623
6914,36780,45-49,4494,5180,9674,"Oshkosh-Neenah, WI",44.085707,-88.668149,171623
6915,36780,50-54,5105,5566,10671,"Oshkosh-Neenah, WI",44.085707,-88.668149,171623
6916,36780,55-59,5754,5896,11650,"Oshkosh-Neenah, WI",44.085707,-88.668149,171623
6917,36780,60-64,5764,5709,11473,"Oshkosh-Neenah, WI",44.085707,-88.668149,171623
6918,36780,65+,15893,13305,29198,"Oshkosh-Neenah, WI",44.085707,-88.668149,171623
6919,36820,15-19,701,970,1671,"Oskaloosa, IA",41.330797,-92.636366,21984
6920,36820,20-24,660,875,1535,"Oskaloosa, IA",41.330797,-92.636366,21984
6921,36820,25-29,590,652,1242,"Oskaloosa, IA",41.330797,-92.636366,21984
6922,36820,30-34,605,625,1230,"Oskaloosa, IA",41.330797,-92.636366,21984
6923,36820,35-39,652,674,1326,"Oskaloosa, IA",41.330797,-92.636366,21984
6924,36820,40-44,638,699,1337,"Oskaloosa, IA",41.330797,-92.636366,21984
6925,36820,45-49,591,627,1218,"Oskaloosa, IA",41.330797,-92.636366,21984
6926,36820,50-54,611,630,1241,"Oskaloosa, IA",41.330797,-92.636366,21984
6927,36820,55-59,618,708,1326,"Oskaloosa, IA",41.330797,-92.636366,21984
6928,36820,60-64,776,796,1572,"Oskaloosa, IA",41.330797,-92.636366,21984
6929,36820,65+,2128,1853,3981,"Oskaloosa, IA",41.330797,-92.636366,21984
6930,36830,15-19,862,1007,1869,"Othello, WA",47.011238,-118.512861,20621
6931,36830,20-24,690,780,1470,"Othello, WA",47.011238,-118.512861,20621
6932,36830,25-29,609,658,1267,"Othello, WA",47.011238,-118.512861,20621
6933,36830,30-34,598,648,1246,"Othello, WA",47.011238,-118.512861,20621
6934,36830,35-39,540,615,1155,"Othello, WA",47.011238,-118.512861,20621
6935,36830,40-44,560,546,1106,"Othello, WA",47.011238,-118.512861,20621
6936,36830,45-49,487,496,983,"Othello, WA",47.011238,-118.512861,20621
6937,36830,50-54,475,516,991,"Othello, WA",47.011238,-118.512861,20621
6938,36830,55-59,484,510,994,"Othello, WA",47.011238,-118.512861,20621
6939,36830,60-64,499,461,960,"Othello, WA",47.011238,-118.512861,20621
6940,36830,65+,1255,1155,2410,"Othello, WA",47.011238,-118.512861,20621
6941,36837,15-19,4371,4792,9163,"Ottawa, IL",41.356488,-89.173385,147414
6942,36837,20-24,3867,4468,8335,"Ottawa, IL",41.356488,-89.173385,147414
6943,36837,25-29,3992,4475,8467,"Ottawa, IL",41.356488,-89.173385,147414
6944,36837,30-34,4092,4486,8578,"Ottawa, IL",41.356488,-89.173385,147414
6945,36837,35-39,4286,4789,9075,"Ottawa, IL",41.356488,-89.173385,147414
6946,36837,40-44,4229,4679,8908,"Ottawa, IL",41.356488,-89.173385,147414
6947,36837,45-49,3995,4336,8331,"Ottawa, IL",41.356488,-89.173385,147414
6948,36837,50-54,4648,4754,9402,"Ottawa, IL",41.356488,-89.173385,147414
6949,36837,55-59,5226,5380,10606,"Ottawa, IL",41.356488,-89.173385,147414
6950,36837,60-64,5662,5659,11321,"Ottawa, IL",41.356488,-89.173385,147414
6951,36837,65+,16206,13886,30092,"Ottawa, IL",41.356488,-89.173385,147414
6952,36840,15-19,886,962,1848,"Ottawa, KS",38.558019,-95.278962,25986
6953,36840,20-24,698,814,1512,"Ottawa, KS",38.558019,-95.278962,25986
6954,36840,25-29,795,753,1548,"Ottawa, KS",38.558019,-95.278962,25986
6955,36840,30-34,802,768,1570,"Ottawa, KS",38.558019,-95.278962,25986
6956,36840,35-39,798,824,1622,"Ottawa, KS",38.558019,-95.278962,25986
6957,36840,40-44,705,808,1513,"Ottawa, KS",38.558019,-95.278962,25986
6958,36840,45-49,719,722,1441,"Ottawa, KS",38.558019,-95.278962,25986
6959,36840,50-54,754,847,1601,"Ottawa, KS",38.558019,-95.278962,25986
6960,36840,55-59,940,932,1872,"Ottawa, KS",38.558019,-95.278962,25986
6961,36840,60-64,941,954,1895,"Ottawa, KS",38.558019,-95.278962,25986
6962,36840,65+,2456,2135,4591,"Ottawa, KS",38.558019,-95.278962,25986
6963,36900,15-19,1137,1190,2327,"Ottumwa, IA",41.031275,-92.409466,35256
6964,36900,20-24,996,1030,2026,"Ottumwa, IA",41.031275,-92.409466,35256
6965,36900,25-29,1098,1179,2277,"Ottumwa, IA",41.031275,-92.409466,35256
6966,36900,30-34,1071,1169,2240,"Ottumwa, IA",41.031275,-92.409466,35256
6967,36900,35-39,1039,1157,2196,"Ottumwa, IA",41.031275,-92.409466,35256
6968,36900,40-44,1029,1140,2169,"Ottumwa, IA",41.031275,-92.409466,35256
6969,36900,45-49,951,1047,1998,"Ottumwa, IA",41.031275,-92.409466,35256
6970,36900,50-54,980,1067,2047,"Ottumwa, IA",41.031275,-92.409466,35256
6971,36900,55-59,1139,1081,2220,"Ottumwa, IA",41.031275,-92.409466,35256
6972,36900,60-64,1224,1191,2415,"Ottumwa, IA",41.031275,-92.409466,35256
6973,36900,65+,3525,2978,6503,"Ottumwa, IA",41.031275,-92.409466,35256
6974,36940,15-19,1241,1339,2580,"Owatonna, MN",44.015261,-93.220453,37349
6975,36940,20-24,932,1019,1951,"Owatonna, MN",44.015261,-93.220453,37349
6976,36940,25-29,977,1079,2056,"Owatonna, MN",44.015261,-93.220453,37349
6977,36940,30-34,1045,1122,2167,"Owatonna, MN",44.015261,-93.220453,37349
6978,36940,35-39,1222,1282,2504,"Owatonna, MN",44.015261,-93.220453,37349
6979,36940,40-44,1112,1140,2252,"Owatonna, MN",44.015261,-93.220453,37349
6980,36940,45-49,1034,1080,2114,"Owatonna, MN",44.015261,-93.220453,37349
6981,36940,50-54,1130,1225,2355,"Owatonna, MN",44.015261,-93.220453,37349
6982,36940,55-59,1241,1286,2527,"Owatonna, MN",44.015261,-93.220453,37349
6983,36940,60-64,1239,1230,2469,"Owatonna, MN",44.015261,-93.220453,37349
6984,36940,65+,3702,3208,6910,"Owatonna, MN",44.015261,-93.220453,37349
6985,36980,15-19,3928,4084,8012,"Owensboro, KY",37.693723,-87.077058,121227
6986,36980,20-24,3456,3561,7017,"Owensboro, KY",37.693723,-87.077058,121227
6987,36980,25-29,3788,3742,7530,"Owensboro, KY",37.693723,-87.077058,121227
6988,36980,30-34,3845,3817,7662,"Owensboro, KY",37.693723,-87.077058,121227
6989,36980,35-39,3740,3704,7444,"Owensboro, KY",37.693723,-87.077058,121227
6990,36980,40-44,3637,3678,7315,"Owensboro, KY",37.693723,-87.077058,121227
6991,36980,45-49,3502,3410,6912,"Owensboro, KY",37.693723,-87.077058,121227
6992,36980,50-54,3694,3774,7468,"Owensboro, KY",37.693723,-87.077058,121227
6993,36980,55-59,4080,3914,7994,"Owensboro, KY",37.693723,-87.077058,121227
6994,36980,60-64,4198,3893,8091,"Owensboro, KY",37.693723,-87.077058,121227
6995,36980,65+,11827,9625,21452,"Owensboro, KY",37.693723,-87.077058,121227
6996,37060,15-19,2791,2585,5376,"Oxford, MS",34.353078,-89.485385,56884
6997,37060,20-24,4158,4050,8208,"Oxford, MS",34.353078,-89.485385,56884
6998,37060,25-29,1898,2087,3985,"Oxford, MS",34.353078,-89.485385,56884
6999,37060,30-34,1861,1771,3632,"Oxford, MS",34.353078,-89.485385,56884
7000,37060,35-39,1826,1828,3654,"Oxford, MS",34.353078,-89.485385,56884
7001,37060,40-44,1724,1683,3407,"Oxford, MS",34.353078,-89.485385,56884
7002,37060,45-49,1496,1457,2953,"Oxford, MS",34.353078,-89.485385,56884
7003,37060,50-54,1579,1462,3041,"Oxford, MS",34.353078,-89.485385,56884
7004,37060,55-59,1512,1363,2875,"Oxford, MS",34.353078,-89.485385,56884
7005,37060,60-64,1598,1446,3044,"Oxford, MS",34.353078,-89.485385,56884
7006,37060,65+,4415,3508,7923,"Oxford, MS",34.353078,-89.485385,56884
7007,37100,15-19,27561,28486,56047,"Oxnard-Thousand Oaks-Ventura, CA",34.358748,-119.133145,839784
7008,37100,20-24,26333,27027,53360,"Oxnard-Thousand Oaks-Ventura, CA",34.358748,-119.133145,839784
7009,37100,25-29,27498,28767,56265,"Oxnard-Thousand Oaks-Ventura, CA",34.358748,-119.133145,839784
7010,37100,30-34,27273,28774,56047,"Oxnard-Thousand Oaks-Ventura, CA",34.358748,-119.133145,839784
7011,37100,35-39,26669,28216,54885,"Oxnard-Thousand Oaks-Ventura, CA",34.358748,-119.133145,839784
7012,37100,40-44,26134,26662,52796,"Oxnard-Thousand Oaks-Ventura, CA",34.358748,-119.133145,839784
7013,37100,45-49,25723,25281,51004,"Oxnard-Thousand Oaks-Ventura, CA",34.358748,-119.133145,839784
7014,37100,50-54,27823,28014,55837,"Oxnard-Thousand Oaks-Ventura, CA",34.358748,-119.133145,839784
7015,37100,55-59,28367,28187,56554,"Oxnard-Thousand Oaks-Ventura, CA",34.358748,-119.133145,839784
7016,37100,60-64,27966,27122,55088,"Oxnard-Thousand Oaks-Ventura, CA",34.358748,-119.133145,839784
7017,37100,65+,76090,64142,140232,"Oxnard-Thousand Oaks-Ventura, CA",34.358748,-119.133145,839784
7018,37120,15-19,1381,1481,2862,"Ozark, AL",31.430654,-85.609476,49342
7019,37120,20-24,1459,1645,3104,"Ozark, AL",31.430654,-85.609476,49342
7020,37120,25-29,1714,1901,3615,"Ozark, AL",31.430654,-85.609476,49342
7021,37120,30-34,1792,1812,3604,"Ozark, AL",31.430654,-85.609476,49342
7022,37120,35-39,1531,1398,2929,"Ozark, AL",31.430654,-85.609476,49342
7023,37120,40-44,1467,1342,2809,"Ozark, AL",31.430654,-85.609476,49342
7024,37120,45-49,1439,1301,2740,"Ozark, AL",31.430654,-85.609476,49342
7025,37120,50-54,1481,1402,2883,"Ozark, AL",31.430654,-85.609476,49342
7026,37120,55-59,1609,1522,3131,"Ozark, AL",31.430654,-85.609476,49342
7027,37120,60-64,1688,1612,3300,"Ozark, AL",31.430654,-85.609476,49342
7028,37120,65+,4817,3933,8750,"Ozark, AL",31.430654,-85.609476,49342
7029,37140,15-19,2833,2909,5742,"Paducah, KY-IL",37.134181,-88.656668,98068
7030,37140,20-24,2570,2496,5066,"Paducah, KY-IL",37.134181,-88.656668,98068
7031,37140,25-29,2826,2835,5661,"Paducah, KY-IL",37.134181,-88.656668,98068
7032,37140,30-34,3026,2731,5757,"Paducah, KY-IL",37.134181,-88.656668,98068
7033,37140,35-39,2837,2818,5655,"Paducah, KY-IL",37.134181,-88.656668,98068
7034,37140,40-44,3058,2933,5991,"Paducah, KY-IL",37.134181,-88.656668,98068
7035,37140,45-49,3014,2922,5936,"Paducah, KY-IL",37.134181,-88.656668,98068
7036,37140,50-54,3092,3129,6221,"Paducah, KY-IL",37.134181,-88.656668,98068
7037,37140,55-59,3484,3259,6743,"Paducah, KY-IL",37.134181,-88.656668,98068
7038,37140,60-64,3707,3364,7071,"Paducah, KY-IL",37.134181,-88.656668,98068
7039,37140,65+,11611,9023,20634,"Paducah, KY-IL",37.134181,-88.656668,98068
7040,37220,15-19,1206,1286,2492,"Pahrump, NV",37.965864,-116.459011,53450
7041,37220,20-24,1013,1358,2371,"Pahrump, NV",37.965864,-116.459011,53450
7042,37220,25-29,1178,1470,2648,"Pahrump, NV",37.965864,-116.459011,53450
7043,37220,30-34,1180,1403,2583,"Pahrump, NV",37.965864,-116.459011,53450
7044,37220,35-39,1233,1258,2491,"Pahrump, NV",37.965864,-116.459011,53450
7045,37220,40-44,1185,1333,2518,"Pahrump, NV",37.965864,-116.459011,53450
7046,37220,45-49,1247,1272,2519,"Pahrump, NV",37.965864,-116.459011,53450
7047,37220,50-54,1603,1571,3174,"Pahrump, NV",37.965864,-116.459011,53450
7048,37220,55-59,2057,2113,4170,"Pahrump, NV",37.965864,-116.459011,53450
7049,37220,60-64,2426,2433,4859,"Pahrump, NV",37.965864,-116.459011,53450
7050,37220,65+,8052,8320,16372,"Pahrump, NV",37.965864,-116.459011,53450
7051,37260,15-19,1984,2138,4122,"Palatka, FL",29.593896,-81.732039,74167
7052,37260,20-24,1804,1982,3786,"Palatka, FL",29.593896,-81.732039,74167
7053,37260,25-29,1994,2162,4156,"Palatka, FL",29.593896,-81.732039,74167
7054,37260,30-34,2088,2113,4201,"Palatka, FL",29.593896,-81.732039,74167
7055,37260,35-39,1984,1907,3891,"Palatka, FL",29.593896,-81.732039,74167
7056,37260,40-44,1916,1838,3754,"Palatka, FL",29.593896,-81.732039,74167
7057,37260,45-49,1908,1832,3740,"Palatka, FL",29.593896,-81.732039,74167
7058,37260,50-54,2201,2119,4320,"Palatka, FL",29.593896,-81.732039,74167
7059,37260,55-59,2792,2647,5439,"Palatka, FL",29.593896,-81.732039,74167
7060,37260,60-64,3144,2876,6020,"Palatka, FL",29.593896,-81.732039,74167
7061,37260,65+,9132,8449,17581,"Palatka, FL",29.593896,-81.732039,74167
7062,37300,15-19,1395,1644,3039,"Palestine, TX",31.841261,-95.661727,58402
7063,37300,20-24,1220,2245,3465,"Palestine, TX",31.841261,-95.661727,58402
7064,37300,25-29,1297,3136,4433,"Palestine, TX",31.841261,-95.661727,58402
7065,37300,30-34,1263,3616,4879,"Palestine, TX",31.841261,-95.661727,58402
7066,37300,35-39,1300,3561,4861,"Palestine, TX",31.841261,-95.661727,58402
7067,37300,40-44,1288,3565,4853,"Palestine, TX",31.841261,-95.661727,58402
7068,37300,45-49,1303,3143,4446,"Palestine, TX",31.841261,-95.661727,58402
7069,37300,50-54,1317,2631,3948,"Palestine, TX",31.841261,-95.661727,58402
7070,37300,55-59,1383,2096,3479,"Palestine, TX",31.841261,-95.661727,58402
7071,37300,60-64,1490,1724,3214,"Palestine, TX",31.841261,-95.661727,58402
7072,37300,65+,4595,4127,8722,"Palestine, TX",31.841261,-95.661727,58402
7073,37340,15-19,15597,16971,32568,"Palm Bay-Melbourne-Titusville, FL",28.298311,-80.700333,616628
7074,37340,20-24,14540,16382,30922,"Palm Bay-Melbourne-Titusville, FL",28.298311,-80.700333,616628
7075,37340,25-29,16467,17902,34369,"Palm Bay-Melbourne-Titusville, FL",28.298311,-80.700333,616628
7076,37340,30-34,17639,18393,36032,"Palm Bay-Melbourne-Titusville, FL",28.298311,-80.700333,616628
7077,37340,35-39,17838,17509,35347,"Palm Bay-Melbourne-Titusville, FL",28.298311,-80.700333,616628
7078,37340,40-44,16948,16669,33617,"Palm Bay-Melbourne-Titusville, FL",28.298311,-80.700333,616628
7079,37340,45-49,17038,16040,33078,"Palm Bay-Melbourne-Titusville, FL",28.298311,-80.700333,616628
7080,37340,50-54,20088,19135,39223,"Palm Bay-Melbourne-Titusville, FL",28.298311,-80.700333,616628
7081,37340,55-59,25022,23414,48436,"Palm Bay-Melbourne-Titusville, FL",28.298311,-80.700333,616628
7082,37340,60-64,26992,25333,52325,"Palm Bay-Melbourne-Titusville, FL",28.298311,-80.700333,616628
7083,37340,65+,80107,69236,149343,"Palm Bay-Melbourne-Titusville, FL",28.298311,-80.700333,616628
7084,37420,15-19,736,742,1478,"Pampa, TX",35.617393,-100.810553,21827
7085,37420,20-24,528,631,1159,"Pampa, TX",35.617393,-100.810553,21827
7086,37420,25-29,574,841,1415,"Pampa, TX",35.617393,-100.810553,21827
7087,37420,30-34,618,854,1472,"Pampa, TX",35.617393,-100.810553,21827
7088,37420,35-39,642,853,1495,"Pampa, TX",35.617393,-100.810553,21827
7089,37420,40-44,584,894,1478,"Pampa, TX",35.617393,-100.810553,21827
7090,37420,45-49,486,812,1298,"Pampa, TX",35.617393,-100.810553,21827
7091,37420,50-54,577,804,1381,"Pampa, TX",35.617393,-100.810553,21827
7092,37420,55-59,546,712,1258,"Pampa, TX",35.617393,-100.810553,21827
7093,37420,60-64,626,666,1292,"Pampa, TX",35.617393,-100.810553,21827
7094,37420,65+,1992,1659,3651,"Pampa, TX",35.617393,-100.810553,21827
7095,37460,15-19,4775,4961,9736,"Panama City, FL",30.15914,-85.534395,179168
7096,37460,20-24,4737,5176,9913,"Panama City, FL",30.15914,-85.534395,179168
7097,37460,25-29,5436,5871,11307,"Panama City, FL",30.15914,-85.534395,179168
7098,37460,30-34,6044,6241,12285,"Panama City, FL",30.15914,-85.534395,179168
7099,37460,35-39,5819,5978,11797,"Panama City, FL",30.15914,-85.534395,179168
7100,37460,40-44,5386,5599,10985,"Panama City, FL",30.15914,-85.534395,179168
7101,37460,45-49,5306,5149,10455,"Panama City, FL",30.15914,-85.534395,179168
7102,37460,50-54,6021,5920,11941,"Panama City, FL",30.15914,-85.534395,179168
7103,37460,55-59,6724,6743,13467,"Panama City, FL",30.15914,-85.534395,179168
7104,37460,60-64,6851,6491,13342,"Panama City, FL",30.15914,-85.534395,179168
7105,37460,65+,17758,15340,33098,"Panama City, FL",30.15914,-85.534395,179168
7106,37500,15-19,1474,1617,3091,"Paragould, AR",36.120607,-90.566346,46317
7107,37500,20-24,1326,1388,2714,"Paragould, AR",36.120607,-90.566346,46317
7108,37500,25-29,1502,1525,3027,"Paragould, AR",36.120607,-90.566346,46317
7109,37500,30-34,1595,1541,3136,"Paragould, AR",36.120607,-90.566346,46317
7110,37500,35-39,1453,1494,2947,"Paragould, AR",36.120607,-90.566346,46317
7111,37500,40-44,1471,1541,3012,"Paragould, AR",36.120607,-90.566346,46317
7112,37500,45-49,1455,1460,2915,"Paragould, AR",36.120607,-90.566346,46317
7113,37500,50-54,1483,1514,2997,"Paragould, AR",36.120607,-90.566346,46317
7114,37500,55-59,1508,1479,2987,"Paragould, AR",36.120607,-90.566346,46317
7115,37500,60-64,1408,1338,2746,"Paragould, AR",36.120607,-90.566346,46317
7116,37500,65+,4179,3312,7491,"Paragould, AR",36.120607,-90.566346,46317
7117,37540,15-19,897,957,1854,"Paris, TN",36.325295,-88.300288,32239
7118,37540,20-24,699,830,1529,"Paris, TN",36.325295,-88.300288,32239
7119,37540,25-29,818,887,1705,"Paris, TN",36.325295,-88.300288,32239
7120,37540,30-34,879,854,1733,"Paris, TN",36.325295,-88.300288,32239
7121,37540,35-39,904,804,1708,"Paris, TN",36.325295,-88.300288,32239
7122,37540,40-44,911,943,1854,"Paris, TN",36.325295,-88.300288,32239
7123,37540,45-49,922,910,1832,"Paris, TN",36.325295,-88.300288,32239
7124,37540,50-54,1048,1071,2119,"Paris, TN",36.325295,-88.300288,32239
7125,37540,55-59,1303,1157,2460,"Paris, TN",36.325295,-88.300288,32239
7126,37540,60-64,1288,1230,2518,"Paris, TN",36.325295,-88.300288,32239
7127,37540,65+,4184,3425,7609,"Paris, TN",36.325295,-88.300288,32239
7128,37580,15-19,1555,1595,3150,"Paris, TX",33.667263,-95.570348,50098
7129,37580,20-24,1461,1464,2925,"Paris, TX",33.667263,-95.570348,50098
7130,37580,25-29,1544,1508,3052,"Paris, TX",33.667263,-95.570348,50098
7131,37580,30-34,1661,1558,3219,"Paris, TX",33.667263,-95.570348,50098
7132,37580,35-39,1475,1359,2834,"Paris, TX",33.667263,-95.570348,50098
7133,37580,40-44,1417,1376,2793,"Paris, TX",33.667263,-95.570348,50098
7134,37580,45-49,1442,1323,2765,"Paris, TX",33.667263,-95.570348,50098
7135,37580,50-54,1677,1555,3232,"Paris, TX",33.667263,-95.570348,50098
7136,37580,55-59,1675,1614,3289,"Paris, TX",33.667263,-95.570348,50098
7137,37580,60-64,1694,1604,3298,"Paris, TX",33.667263,-95.570348,50098
7138,37580,65+,5279,4208,9487,"Paris, TX",33.667263,-95.570348,50098
7139,37620,15-19,2463,2625,5088,"Parkersburg-Vienna, WV",39.141531,-81.460402,88687
7140,37620,20-24,2322,2327,4649,"Parkersburg-Vienna, WV",39.141531,-81.460402,88687
7141,37620,25-29,2481,2485,4966,"Parkersburg-Vienna, WV",39.141531,-81.460402,88687
7142,37620,30-34,2611,2488,5099,"Parkersburg-Vienna, WV",39.141531,-81.460402,88687
7143,37620,35-39,2556,2557,5113,"Parkersburg-Vienna, WV",39.141531,-81.460402,88687
7144,37620,40-44,2700,2710,5410,"Parkersburg-Vienna, WV",39.141531,-81.460402,88687
7145,37620,45-49,2705,2721,5426,"Parkersburg-Vienna, WV",39.141531,-81.460402,88687
7146,37620,50-54,2959,2976,5935,"Parkersburg-Vienna, WV",39.141531,-81.460402,88687
7147,37620,55-59,3255,3113,6368,"Parkersburg-Vienna, WV",39.141531,-81.460402,88687
7148,37620,60-64,3390,3249,6639,"Parkersburg-Vienna, WV",39.141531,-81.460402,88687
7149,37620,65+,10264,8428,18692,"Parkersburg-Vienna, WV",39.141531,-81.460402,88687
7150,37660,15-19,572,686,1258,"Parsons, KS",37.191468,-95.297473,19912
7151,37660,20-24,505,534,1039,"Parsons, KS",37.191468,-95.297473,19912
7152,37660,25-29,526,570,1096,"Parsons, KS",37.191468,-95.297473,19912
7153,37660,30-34,556,605,1161,"Parsons, KS",37.191468,-95.297473,19912
7154,37660,35-39,580,577,1157,"Parsons, KS",37.191468,-95.297473,19912
7155,37660,40-44,522,531,1053,"Parsons, KS",37.191468,-95.297473,19912
7156,37660,45-49,505,523,1028,"Parsons, KS",37.191468,-95.297473,19912
7157,37660,50-54,586,607,1193,"Parsons, KS",37.191468,-95.297473,19912
7158,37660,55-59,713,738,1451,"Parsons, KS",37.191468,-95.297473,19912
7159,37660,60-64,703,738,1441,"Parsons, KS",37.191468,-95.297473,19912
7160,37660,65+,2190,1801,3991,"Parsons, KS",37.191468,-95.297473,19912
7161,37740,15-19,1312,1431,2743,"Payson, AZ",33.789618,-110.81187,53589
7162,37740,20-24,1107,1208,2315,"Payson, AZ",33.789618,-110.81187,53589
7163,37740,25-29,1239,1321,2560,"Payson, AZ",33.789618,-110.81187,53589
7164,37740,30-34,1400,1321,2721,"Payson, AZ",33.789618,-110.81187,53589
7165,37740,35-39,1245,1391,2636,"Payson, AZ",33.789618,-110.81187,53589
7166,37740,40-44,1165,1224,2389,"Payson, AZ",33.789618,-110.81187,53589
7167,37740,45-49,1144,1139,2283,"Payson, AZ",33.789618,-110.81187,53589
7168,37740,50-54,1465,1442,2907,"Payson, AZ",33.789618,-110.81187,53589
7169,37740,55-59,1896,1767,3663,"Payson, AZ",33.789618,-110.81187,53589
7170,37740,60-64,2492,2244,4736,"Payson, AZ",33.789618,-110.81187,53589
7171,37740,65+,8128,7889,16017,"Payson, AZ",33.789618,-110.81187,53589
7172,37770,15-19,582,701,1283,"Pearsall, TX",28.869383,-99.109005,18436
7173,37770,20-24,539,1335,1874,"Pearsall, TX",28.869383,-99.109005,18436
7174,37770,25-29,490,1457,1947,"Pearsall, TX",28.869383,-99.109005,18436
7175,37770,30-34,403,1198,1601,"Pearsall, TX",28.869383,-99.109005,18436
7176,37770,35-39,424,918,1342,"Pearsall, TX",28.869383,-99.109005,18436
7177,37770,40-44,422,663,1085,"Pearsall, TX",28.869383,-99.109005,18436
7178,37770,45-49,424,546,970,"Pearsall, TX",28.869383,-99.109005,18436
7179,37770,50-54,400,527,927,"Pearsall, TX",28.869383,-99.109005,18436
7180,37770,55-59,449,459,908,"Pearsall, TX",28.869383,-99.109005,18436
7181,37770,60-64,368,379,747,"Pearsall, TX",28.869383,-99.109005,18436
7182,37770,65+,1236,1011,2247,"Pearsall, TX",28.869383,-99.109005,18436
7183,37780,15-19,406,519,925,"Pecos, TX",31.42675,-103.666001,14544
7184,37780,20-24,348,956,1304,"Pecos, TX",31.42675,-103.666001,14544
7185,37780,25-29,351,790,1141,"Pecos, TX",31.42675,-103.666001,14544
7186,37780,30-34,378,952,1330,"Pecos, TX",31.42675,-103.666001,14544
7187,37780,35-39,369,981,1350,"Pecos, TX",31.42675,-103.666001,14544
7188,37780,40-44,343,665,1008,"Pecos, TX",31.42675,-103.666001,14544
7189,37780,45-49,306,718,1024,"Pecos, TX",31.42675,-103.666001,14544
7190,37780,50-54,301,433,734,"Pecos, TX",31.42675,-103.666001,14544
7191,37780,55-59,289,367,656,"Pecos, TX",31.42675,-103.666001,14544
7192,37780,60-64,280,310,590,"Pecos, TX",31.42675,-103.666001,14544
7193,37780,65+,910,769,1679,"Pecos, TX",31.42675,-103.666001,14544
7194,37800,15-19,1218,1312,2530,"Pella, IA",41.331433,-93.093868,33380
7195,37800,20-24,1120,1233,2353,"Pella, IA",41.331433,-93.093868,33380
7196,37800,25-29,822,911,1733,"Pella, IA",41.331433,-93.093868,33380
7197,37800,30-34,833,900,1733,"Pella, IA",41.331433,-93.093868,33380
7198,37800,35-39,977,1028,2005,"Pella, IA",41.331433,-93.093868,33380
7199,37800,40-44,1030,1044,2074,"Pella, IA",41.331433,-93.093868,33380
7200,37800,45-49,892,952,1844,"Pella, IA",41.331433,-93.093868,33380
7201,37800,50-54,971,1005,1976,"Pella, IA",41.331433,-93.093868,33380
7202,37800,55-59,1122,1182,2304,"Pella, IA",41.331433,-93.093868,33380
7203,37800,60-64,1108,1167,2275,"Pella, IA",41.331433,-93.093868,33380
7204,37800,65+,3352,2847,6199,"Pella, IA",41.331433,-93.093868,33380
7205,37860,15-19,15551,18359,33910,"Pensacola-Ferry Pass-Brent, FL",30.608557,-87.158547,516388
7206,37860,20-24,16140,19131,35271,"Pensacola-Ferry Pass-Brent, FL",30.608557,-87.158547,516388
7207,37860,25-29,17033,19325,36358,"Pensacola-Ferry Pass-Brent, FL",30.608557,-87.158547,516388
7208,37860,30-34,17778,19003,36781,"Pensacola-Ferry Pass-Brent, FL",30.608557,-87.158547,516388
7209,37860,35-39,16457,17375,33832,"Pensacola-Ferry Pass-Brent, FL",30.608557,-87.158547,516388
7210,37860,40-44,15087,15557,30644,"Pensacola-Ferry Pass-Brent, FL",30.608557,-87.158547,516388
7211,37860,45-49,14205,14560,28765,"Pensacola-Ferry Pass-Brent, FL",30.608557,-87.158547,516388
7212,37860,50-54,15799,15315,31114,"Pensacola-Ferry Pass-Brent, FL",30.608557,-87.158547,516388
7213,37860,55-59,18029,16991,35020,"Pensacola-Ferry Pass-Brent, FL",30.608557,-87.158547,516388
7214,37860,60-64,18447,17094,35541,"Pensacola-Ferry Pass-Brent, FL",30.608557,-87.158547,516388
7215,37860,65+,48178,39646,87824,"Pensacola-Ferry Pass-Brent, FL",30.608557,-87.158547,516388
7216,37900,15-19,12510,13036,25546,"Peoria, IL",40.708887,-89.697466,398224
7217,37900,20-24,11099,11488,22587,"Peoria, IL",40.708887,-89.697466,398224
7218,37900,25-29,11747,12130,23877,"Peoria, IL",40.708887,-89.697466,398224
7219,37900,30-34,12124,12493,24617,"Peoria, IL",40.708887,-89.697466,398224
7220,37900,35-39,12520,12874,25394,"Peoria, IL",40.708887,-89.697466,398224
7221,37900,40-44,12365,12976,25341,"Peoria, IL",40.708887,-89.697466,398224
7222,37900,45-49,11569,11692,23261,"Peoria, IL",40.708887,-89.697466,398224
7223,37900,50-54,12252,12322,24574,"Peoria, IL",40.708887,-89.697466,398224
7224,37900,55-59,12796,12691,25487,"Peoria, IL",40.708887,-89.697466,398224
7225,37900,60-64,13720,12782,26502,"Peoria, IL",40.708887,-89.697466,398224
7226,37900,65+,41761,34102,75863,"Peoria, IL",40.708887,-89.697466,398224
7227,37940,15-19,1025,1180,2205,"Peru, IN",40.772883,-86.044258,36081
7228,37940,20-24,863,1369,2232,"Peru, IN",40.772883,-86.044258,36081
7229,37940,25-29,922,1456,2378,"Peru, IN",40.772883,-86.044258,36081
7230,37940,30-34,981,1473,2454,"Peru, IN",40.772883,-86.044258,36081
7231,37940,35-39,899,1430,2329,"Peru, IN",40.772883,-86.044258,36081
7232,37940,40-44,970,1393,2363,"Peru, IN",40.772883,-86.044258,36081
7233,37940,45-49,1031,1294,2325,"Peru, IN",40.772883,-86.044258,36081
7234,37940,50-54,1056,1324,2380,"Peru, IN",40.772883,-86.044258,36081
7235,37940,55-59,1145,1281,2426,"Peru, IN",40.772883,-86.044258,36081
7236,37940,60-64,1142,1174,2316,"Peru, IN",40.772883,-86.044258,36081
7237,37940,65+,3472,3028,6500,"Peru, IN",40.772883,-86.044258,36081
7238,37980,15-19,194456,200704,395160,"Philadelphia-Camden-Wilmington, PA-NJ-DE-MD",39.894958,-75.311982,6228601
7239,37980,20-24,187955,189699,377654,"Philadelphia-Camden-Wilmington, PA-NJ-DE-MD",39.894958,-75.311982,6228601
7240,37980,25-29,213390,211164,424554,"Philadelphia-Camden-Wilmington, PA-NJ-DE-MD",39.894958,-75.311982,6228601
7241,37980,30-34,230070,225034,455104,"Philadelphia-Camden-Wilmington, PA-NJ-DE-MD",39.894958,-75.311982,6228601
7242,37980,35-39,214281,210682,424963,"Philadelphia-Camden-Wilmington, PA-NJ-DE-MD",39.894958,-75.311982,6228601
7243,37980,40-44,199033,191770,390803,"Philadelphia-Camden-Wilmington, PA-NJ-DE-MD",39.894958,-75.311982,6228601
7244,37980,45-49,183737,177412,361149,"Philadelphia-Camden-Wilmington, PA-NJ-DE-MD",39.894958,-75.311982,6228601
7245,37980,50-54,206750,197659,404409,"Philadelphia-Camden-Wilmington, PA-NJ-DE-MD",39.894958,-75.311982,6228601
7246,37980,55-59,220146,206550,426696,"Philadelphia-Camden-Wilmington, PA-NJ-DE-MD",39.894958,-75.311982,6228601
7247,37980,60-64,217704,201470,419174,"Philadelphia-Camden-Wilmington, PA-NJ-DE-MD",39.894958,-75.311982,6228601
7248,37980,65+,590125,457261,1047386,"Philadelphia-Camden-Wilmington, PA-NJ-DE-MD",39.894958,-75.311982,6228601
7249,38060,15-19,161715,170167,331882,"Phoenix-Mesa-Chandler, AZ",33.185765,-112.067862,4946145
7250,38060,20-24,156363,164761,321124,"Phoenix-Mesa-Chandler, AZ",33.185765,-112.067862,4946145
7251,38060,25-29,173352,182360,355712,"Phoenix-Mesa-Chandler, AZ",33.185765,-112.067862,4946145
7252,38060,30-34,174533,184159,358692,"Phoenix-Mesa-Chandler, AZ",33.185765,-112.067862,4946145
7253,38060,35-39,164559,173200,337759,"Phoenix-Mesa-Chandler, AZ",33.185765,-112.067862,4946145
7254,38060,40-44,157436,162012,319448,"Phoenix-Mesa-Chandler, AZ",33.185765,-112.067862,4946145
7255,38060,45-49,150173,150598,300771,"Phoenix-Mesa-Chandler, AZ",33.185765,-112.067862,4946145
7256,38060,50-54,151756,153212,304968,"Phoenix-Mesa-Chandler, AZ",33.185765,-112.067862,4946145
7257,38060,55-59,149953,146153,296106,"Phoenix-Mesa-Chandler, AZ",33.185765,-112.067862,4946145
7258,38060,60-64,146692,137836,284528,"Phoenix-Mesa-Chandler, AZ",33.185765,-112.067862,4946145
7259,38060,65+,435436,368293,803729,"Phoenix-Mesa-Chandler, AZ",33.185765,-112.067862,4946145
7260,38100,15-19,1819,1987,3806,"Picayune, MS",30.774793,-89.586904,56503
7261,38100,20-24,1562,1699,3261,"Picayune, MS",30.774793,-89.586904,56503
7262,38100,25-29,1680,1643,3323,"Picayune, MS",30.774793,-89.586904,56503
7263,38100,30-34,1715,1662,3377,"Picayune, MS",30.774793,-89.586904,56503
7264,38100,35-39,1611,1647,3258,"Picayune, MS",30.774793,-89.586904,56503
7265,38100,40-44,1704,1566,3270,"Picayune, MS",30.774793,-89.586904,56503
7266,38100,45-49,1701,1659,3360,"Picayune, MS",30.774793,-89.586904,56503
7267,38100,50-54,1818,1779,3597,"Picayune, MS",30.774793,-89.586904,56503
7268,38100,55-59,2000,1970,3970,"Picayune, MS",30.774793,-89.586904,56503
7269,38100,60-64,1911,1857,3768,"Picayune, MS",30.774793,-89.586904,56503
7270,38100,65+,5907,5045,10952,"Picayune, MS",30.774793,-89.586904,56503
7271,38180,15-19,598,625,1223,"Pierre, SD",44.404897,-100.484817,20726
7272,38180,20-24,591,531,1122,"Pierre, SD",44.404897,-100.484817,20726
7273,38180,25-29,631,578,1209,"Pierre, SD",44.404897,-100.484817,20726
7274,38180,30-34,677,635,1312,"Pierre, SD",44.404897,-100.484817,20726
7275,38180,35-39,684,720,1404,"Pierre, SD",44.404897,-100.484817,20726
7276,38180,40-44,640,602,1242,"Pierre, SD",44.404897,-100.484817,20726
7277,38180,45-49,572,574,1146,"Pierre, SD",44.404897,-100.484817,20726
7278,38180,50-54,620,558,1178,"Pierre, SD",44.404897,-100.484817,20726
7279,38180,55-59,702,665,1367,"Pierre, SD",44.404897,-100.484817,20726
7280,38180,60-64,723,709,1432,"Pierre, SD",44.404897,-100.484817,20726
7281,38180,65+,1959,1874,3833,"Pierre, SD",44.404897,-100.484817,20726
7282,38220,15-19,2752,2945,5697,"Pine Bluff, AR",34.081204,-91.945765,86412
7283,38220,20-24,2631,3319,5950,"Pine Bluff, AR",34.081204,-91.945765,86412
7284,38220,25-29,2409,3217,5626,"Pine Bluff, AR",34.081204,-91.945765,86412
7285,38220,30-34,2439,3252,5691,"Pine Bluff, AR",34.081204,-91.945765,86412
7286,38220,35-39,2300,3056,5356,"Pine Bluff, AR",34.081204,-91.945765,86412
7287,38220,40-44,2488,2906,5394,"Pine Bluff, AR",34.081204,-91.945765,86412
7288,38220,45-49,2321,2726,5047,"Pine Bluff, AR",34.081204,-91.945765,86412
7289,38220,50-54,2547,2858,5405,"Pine Bluff, AR",34.081204,-91.945765,86412
7290,38220,55-59,2892,2861,5753,"Pine Bluff, AR",34.081204,-91.945765,86412
7291,38220,60-64,2974,2858,5832,"Pine Bluff, AR",34.081204,-91.945765,86412
7292,38220,65+,8835,7111,15946,"Pine Bluff, AR",34.081204,-91.945765,86412
7293,38240,15-19,2694,2817,5511,"Pinehurst-Southern Pines, NC",35.308272,-79.492725,102763
7294,38240,20-24,2215,2269,4484,"Pinehurst-Southern Pines, NC",35.308272,-79.492725,102763
7295,38240,25-29,2717,2686,5403,"Pinehurst-Southern Pines, NC",35.308272,-79.492725,102763
7296,38240,30-34,3417,3306,6723,"Pinehurst-Southern Pines, NC",35.308272,-79.492725,102763
7297,38240,35-39,3410,3542,6952,"Pinehurst-Southern Pines, NC",35.308272,-79.492725,102763
7298,38240,40-44,2906,2975,5881,"Pinehurst-Southern Pines, NC",35.308272,-79.492725,102763
7299,38240,45-49,2913,2673,5586,"Pinehurst-Southern Pines, NC",35.308272,-79.492725,102763
7300,38240,50-54,2921,2811,5732,"Pinehurst-Southern Pines, NC",35.308272,-79.492725,102763
7301,38240,55-59,3369,3091,6460,"Pinehurst-Southern Pines, NC",35.308272,-79.492725,102763
7302,38240,60-64,3717,3356,7073,"Pinehurst-Southern Pines, NC",35.308272,-79.492725,102763
7303,38240,65+,13302,11005,24307,"Pinehurst-Southern Pines, NC",35.308272,-79.492725,102763
7304,38260,15-19,1533,1662,3195,"Pittsburg, KS",37.505821,-94.853897,39110
7305,38260,20-24,2478,2750,5228,"Pittsburg, KS",37.505821,-94.853897,39110
7306,38260,25-29,1162,1269,2431,"Pittsburg, KS",37.505821,-94.853897,39110
7307,38260,30-34,1033,1050,2083,"Pittsburg, KS",37.505821,-94.853897,39110
7308,38260,35-39,1132,1136,2268,"Pittsburg, KS",37.505821,-94.853897,39110
7309,38260,40-44,1099,1119,2218,"Pittsburg, KS",37.505821,-94.853897,39110
7310,38260,45-49,988,962,1950,"Pittsburg, KS",37.505821,-94.853897,39110
7311,38260,50-54,1007,1043,2050,"Pittsburg, KS",37.505821,-94.853897,39110
7312,38260,55-59,1030,1112,2142,"Pittsburg, KS",37.505821,-94.853897,39110
7313,38260,60-64,1149,1094,2243,"Pittsburg, KS",37.505821,-94.853897,39110
7314,38260,65+,3487,2737,6224,"Pittsburg, KS",37.505821,-94.853897,39110
7315,38300,15-19,66245,68925,135170,"Pittsburgh, PA",40.439525,-79.836097,2353538
7316,38300,20-24,65496,66204,131700,"Pittsburgh, PA",40.439525,-79.836097,2353538
7317,38300,25-29,73015,76457,149472,"Pittsburgh, PA",40.439525,-79.836097,2353538
7318,38300,30-34,79304,82244,161548,"Pittsburgh, PA",40.439525,-79.836097,2353538
7319,38300,35-39,74963,78621,153584,"Pittsburgh, PA",40.439525,-79.836097,2353538
7320,38300,40-44,68596,70826,139422,"Pittsburgh, PA",40.439525,-79.836097,2353538
7321,38300,45-49,64702,65313,130015,"Pittsburgh, PA",40.439525,-79.836097,2353538
7322,38300,50-54,75870,74988,150858,"Pittsburgh, PA",40.439525,-79.836097,2353538
7323,38300,55-59,84084,80392,164476,"Pittsburgh, PA",40.439525,-79.836097,2353538
7324,38300,60-64,92251,87347,179598,"Pittsburgh, PA",40.439525,-79.836097,2353538
7325,38300,65+,273277,218324,491601,"Pittsburgh, PA",40.439525,-79.836097,2353538
7326,38340,15-19,3951,3898,7849,"Pittsfield, MA",42.371493,-73.217928,128657
7327,38340,20-24,4004,3937,7941,"Pittsfield, MA",42.371493,-73.217928,128657
7328,38340,25-29,3452,3536,6988,"Pittsfield, MA",42.371493,-73.217928,128657
7329,38340,30-34,3454,3526,6980,"Pittsfield, MA",42.371493,-73.217928,128657
7330,38340,35-39,3614,3686,7300,"Pittsfield, MA",42.371493,-73.217928,128657
7331,38340,40-44,3517,3586,7103,"Pittsfield, MA",42.371493,-73.217928,128657
7332,38340,45-49,3429,3390,6819,"Pittsfield, MA",42.371493,-73.217928,128657
7333,38340,50-54,4271,4146,8417,"Pittsfield, MA",42.371493,-73.217928,128657
7334,38340,55-59,5170,4928,10098,"Pittsfield, MA",42.371493,-73.217928,128657
7335,38340,60-64,5613,5214,10827,"Pittsfield, MA",42.371493,-73.217928,128657
7336,38340,65+,17277,14409,31686,"Pittsfield, MA",42.371493,-73.217928,128657
7337,38380,15-19,1234,1359,2593,"Plainview, TX",34.068436,-101.822888,32220
7338,38380,20-24,1057,1525,2582,"Plainview, TX",34.068436,-101.822888,32220
7339,38380,25-29,900,1345,2245,"Plainview, TX",34.068436,-101.822888,32220
7340,38380,30-34,950,1287,2237,"Plainview, TX",34.068436,-101.822888,32220
7341,38380,35-39,958,1197,2155,"Plainview, TX",34.068436,-101.822888,32220
7342,38380,40-44,906,1057,1963,"Plainview, TX",34.068436,-101.822888,32220
7343,38380,45-49,828,978,1806,"Plainview, TX",34.068436,-101.822888,32220
7344,38380,50-54,813,945,1758,"Plainview, TX",34.068436,-101.822888,32220
7345,38380,55-59,884,906,1790,"Plainview, TX",34.068436,-101.822888,32220
7346,38380,60-64,858,854,1712,"Plainview, TX",34.068436,-101.822888,32220
7347,38380,65+,2356,2052,4408,"Plainview, TX",34.068436,-101.822888,32220
7348,38420,15-19,2183,2687,4870,"Platteville, WI",42.870028,-90.694229,52110
7349,38420,20-24,2406,3474,5880,"Platteville, WI",42.870028,-90.694229,52110
7350,38420,25-29,1363,1551,2914,"Platteville, WI",42.870028,-90.694229,52110
7351,38420,30-34,1222,1501,2723,"Platteville, WI",42.870028,-90.694229,52110
7352,38420,35-39,1305,1457,2762,"Platteville, WI",42.870028,-90.694229,52110
7353,38420,40-44,1305,1455,2760,"Platteville, WI",42.870028,-90.694229,52110
7354,38420,45-49,1197,1287,2484,"Platteville, WI",42.870028,-90.694229,52110
7355,38420,50-54,1315,1392,2707,"Platteville, WI",42.870028,-90.694229,52110
7356,38420,55-59,1583,1612,3195,"Platteville, WI",42.870028,-90.694229,52110
7357,38420,60-64,1749,1791,3540,"Platteville, WI",42.870028,-90.694229,52110
7358,38420,65+,5008,4295,9303,"Platteville, WI",42.870028,-90.694229,52110
7359,38460,15-19,2657,2623,5280,"Plattsburgh, NY",44.752712,-73.705643,79596
7360,38460,20-24,3515,3528,7043,"Plattsburgh, NY",44.752712,-73.705643,79596
7361,38460,25-29,2136,2721,4857,"Plattsburgh, NY",44.752712,-73.705643,79596
7362,38460,30-34,2086,2806,4892,"Plattsburgh, NY",44.752712,-73.705643,79596
7363,38460,35-39,2253,2799,5052,"Plattsburgh, NY",44.752712,-73.705643,79596
7364,38460,40-44,2173,2723,4896,"Plattsburgh, NY",44.752712,-73.705643,79596
7365,38460,45-49,2074,2498,4572,"Plattsburgh, NY",44.752712,-73.705643,79596
7366,38460,50-54,2292,2638,4930,"Plattsburgh, NY",44.752712,-73.705643,79596
7367,38460,55-59,2911,2932,5843,"Plattsburgh, NY",44.752712,-73.705643,79596
7368,38460,60-64,2890,2930,5820,"Plattsburgh, NY",44.752712,-73.705643,79596
7369,38460,65+,7675,6846,14521,"Plattsburgh, NY",44.752712,-73.705643,79596
7370,38500,15-19,1625,1701,3326,"Plymouth, IN",41.325003,-86.269036,46121
7371,38500,20-24,1277,1400,2677,"Plymouth, IN",41.325003,-86.269036,46121
7372,38500,25-29,1226,1385,2611,"Plymouth, IN",41.325003,-86.269036,46121
7373,38500,30-34,1238,1266,2504,"Plymouth, IN",41.325003,-86.269036,46121
7374,38500,35-39,1289,1314,2603,"Plymouth, IN",41.325003,-86.269036,46121
7375,38500,40-44,1337,1376,2713,"Plymouth, IN",41.325003,-86.269036,46121
7376,38500,45-49,1325,1378,2703,"Plymouth, IN",41.325003,-86.269036,46121
7377,38500,50-54,1456,1446,2902,"Plymouth, IN",41.325003,-86.269036,46121
7378,38500,55-59,1532,1597,3129,"Plymouth, IN",41.325003,-86.269036,46121
7379,38500,60-64,1504,1582,3086,"Plymouth, IN",41.325003,-86.269036,46121
7380,38500,65+,4675,3940,8615,"Plymouth, IN",41.325003,-86.269036,46121
7381,38540,15-19,3508,3725,7233,"Pocatello, ID",42.689761,-112.57753,96213
7382,38540,20-24,3297,3509,6806,"Pocatello, ID",42.689761,-112.57753,96213
7383,38540,25-29,3232,3315,6547,"Pocatello, ID",42.689761,-112.57753,96213
7384,38540,30-34,3404,3368,6772,"Pocatello, ID",42.689761,-112.57753,96213
7385,38540,35-39,3302,3452,6754,"Pocatello, ID",42.689761,-112.57753,96213
7386,38540,40-44,3150,3123,6273,"Pocatello, ID",42.689761,-112.57753,96213
7387,38540,45-49,2546,2597,5143,"Pocatello, ID",42.689761,-112.57753,96213
7388,38540,50-54,2490,2445,4935,"Pocatello, ID",42.689761,-112.57753,96213
7389,38540,55-59,2570,2457,5027,"Pocatello, ID",42.689761,-112.57753,96213
7390,38540,60-64,2816,2712,5528,"Pocatello, ID",42.689761,-112.57753,96213
7391,38540,65+,7668,6968,14636,"Pocatello, ID",42.689761,-112.57753,96213
7392,38580,15-19,1606,1717,3323,"Point Pleasant, WV-OH",38.798396,-82.180553,54315
7393,38580,20-24,1409,1544,2953,"Point Pleasant, WV-OH",38.798396,-82.180553,54315
7394,38580,25-29,1541,1536,3077,"Point Pleasant, WV-OH",38.798396,-82.180553,54315
7395,38580,30-34,1565,1479,3044,"Point Pleasant, WV-OH",38.798396,-82.180553,54315
7396,38580,35-39,1629,1489,3118,"Point Pleasant, WV-OH",38.798396,-82.180553,54315
7397,38580,40-44,1690,1600,3290,"Point Pleasant, WV-OH",38.798396,-82.180553,54315
7398,38580,45-49,1660,1599,3259,"Point Pleasant, WV-OH",38.798396,-82.180553,54315
7399,38580,50-54,1649,1705,3354,"Point Pleasant, WV-OH",38.798396,-82.180553,54315
7400,38580,55-59,1883,1822,3705,"Point Pleasant, WV-OH",38.798396,-82.180553,54315
7401,38580,60-64,2161,1994,4155,"Point Pleasant, WV-OH",38.798396,-82.180553,54315
7402,38580,65+,6124,5111,11235,"Point Pleasant, WV-OH",38.798396,-82.180553,54315
7403,38620,15-19,1503,1586,3089,"Ponca City, OK",36.814885,-97.143862,43732
7404,38620,20-24,1218,1328,2546,"Ponca City, OK",36.814885,-97.143862,43732
7405,38620,25-29,1325,1379,2704,"Ponca City, OK",36.814885,-97.143862,43732
7406,38620,30-34,1294,1318,2612,"Ponca City, OK",36.814885,-97.143862,43732
7407,38620,35-39,1226,1359,2585,"Ponca City, OK",36.814885,-97.143862,43732
7408,38620,40-44,1250,1355,2605,"Ponca City, OK",36.814885,-97.143862,43732
7409,38620,45-49,1130,1142,2272,"Ponca City, OK",36.814885,-97.143862,43732
7410,38620,50-54,1102,1221,2323,"Ponca City, OK",36.814885,-97.143862,43732
7411,38620,55-59,1315,1325,2640,"Ponca City, OK",36.814885,-97.143862,43732
7412,38620,60-64,1405,1420,2825,"Ponca City, OK",36.814885,-97.143862,43732
7413,38620,65+,4670,3809,8479,"Ponca City, OK",36.814885,-97.143862,43732
7414,38700,15-19,979,1183,2162,"Pontiac, IL",40.894376,-88.552852,35664
7415,38700,20-24,964,1114,2078,"Pontiac, IL",40.894376,-88.552852,35664
7416,38700,25-29,1075,1101,2176,"Pontiac, IL",40.894376,-88.552852,35664
7417,38700,30-34,1064,1173,2237,"Pontiac, IL",40.894376,-88.552852,35664
7418,38700,35-39,1126,1151,2277,"Pontiac, IL",40.894376,-88.552852,35664
7419,38700,40-44,1024,1133,2157,"Pontiac, IL",40.894376,-88.552852,35664
7420,38700,45-49,933,1076,2009,"Pontiac, IL",40.894376,-88.552852,35664
7421,38700,50-54,1037,1104,2141,"Pontiac, IL",40.894376,-88.552852,35664
7422,38700,55-59,1217,1223,2440,"Pontiac, IL",40.894376,-88.552852,35664
7423,38700,60-64,1301,1378,2679,"Pontiac, IL",40.894376,-88.552852,35664
7424,38700,65+,3770,3193,6963,"Pontiac, IL",40.894376,-88.552852,35664
7425,38740,15-19,1586,1713,3299,"Poplar Bluff, MO",36.68765,-90.62285,52718
7426,38740,20-24,1372,1466,2838,"Poplar Bluff, MO",36.68765,-90.62285,52718
7427,38740,25-29,1580,1564,3144,"Poplar Bluff, MO",36.68765,-90.62285,52718
7428,38740,30-34,1640,1560,3200,"Poplar Bluff, MO",36.68765,-90.62285,52718
7429,38740,35-39,1586,1571,3157,"Poplar Bluff, MO",36.68765,-90.62285,52718
7430,38740,40-44,1624,1489,3113,"Poplar Bluff, MO",36.68765,-90.62285,52718
7431,38740,45-49,1534,1497,3031,"Poplar Bluff, MO",36.68765,-90.62285,52718
7432,38740,50-54,1614,1558,3172,"Poplar Bluff, MO",36.68765,-90.62285,52718
7433,38740,55-59,1853,1733,3586,"Poplar Bluff, MO",36.68765,-90.62285,52718
7434,38740,60-64,1804,1756,3560,"Poplar Bluff, MO",36.68765,-90.62285,52718
7435,38740,65+,5636,4656,10292,"Poplar Bluff, MO",36.68765,-90.62285,52718
7436,38780,15-19,832,870,1702,"Portales, NM",34.021207,-103.483004,19019
7437,38780,20-24,1203,1137,2340,"Portales, NM",34.021207,-103.483004,19019
7438,38780,25-29,702,745,1447,"Portales, NM",34.021207,-103.483004,19019
7439,38780,30-34,502,555,1057,"Portales, NM",34.021207,-103.483004,19019
7440,38780,35-39,495,562,1057,"Portales, NM",34.021207,-103.483004,19019
7441,38780,40-44,480,494,974,"Portales, NM",34.021207,-103.483004,19019
7442,38780,45-49,484,469,953,"Portales, NM",34.021207,-103.483004,19019
7443,38780,50-54,469,471,940,"Portales, NM",34.021207,-103.483004,19019
7444,38780,55-59,427,471,898,"Portales, NM",34.021207,-103.483004,19019
7445,38780,60-64,535,431,966,"Portales, NM",34.021207,-103.483004,19019
7446,38780,65+,1518,1330,2848,"Portales, NM",34.021207,-103.483004,19019
7447,38820,15-19,1692,1769,3461,"Port Angeles, WA",48.110903,-123.88986,78209
7448,38820,20-24,1549,1969,3518,"Port Angeles, WA",48.110903,-123.88986,78209
7449,38820,25-29,1769,2069,3838,"Port Angeles, WA",48.110903,-123.88986,78209
7450,38820,30-34,2103,2281,4384,"Port Angeles, WA",48.110903,-123.88986,78209
7451,38820,35-39,2143,2247,4390,"Port Angeles, WA",48.110903,-123.88986,78209
7452,38820,40-44,2030,2171,4201,"Port Angeles, WA",48.110903,-123.88986,78209
7453,38820,45-49,1804,1794,3598,"Port Angeles, WA",48.110903,-123.88986,78209
7454,38820,50-54,2060,2005,4065,"Port Angeles, WA",48.110903,-123.88986,78209
7455,38820,55-59,2606,2355,4961,"Port Angeles, WA",48.110903,-123.88986,78209
7456,38820,60-64,3649,3204,6853,"Port Angeles, WA",48.110903,-123.88986,78209
7457,38820,65+,12901,11336,24237,"Port Angeles, WA",48.110903,-123.88986,78209
7458,38860,15-19,15210,16105,31315,"Portland-South Portland, ME",43.651417,-70.418375,556893
7459,38860,20-24,15208,15185,30393,"Portland-South Portland, ME",43.651417,-70.418375,556893
7460,38860,25-29,17668,17613,35281,"Portland-South Portland, ME",43.651417,-70.418375,556893
7461,38860,30-34,19067,18873,37940,"Portland-South Portland, ME",43.651417,-70.418375,556893
7462,38860,35-39,18500,18708,37208,"Portland-South Portland, ME",43.651417,-70.418375,556893
7463,38860,40-44,16812,16947,33759,"Portland-South Portland, ME",43.651417,-70.418375,556893
7464,38860,45-49,16228,15815,32043,"Portland-South Portland, ME",43.651417,-70.418375,556893
7465,38860,50-54,18923,18598,37521,"Portland-South Portland, ME",43.651417,-70.418375,556893
7466,38860,55-59,21316,20181,41497,"Portland-South Portland, ME",43.651417,-70.418375,556893
7467,38860,60-64,22413,20418,42831,"Portland-South Portland, ME",43.651417,-70.418375,556893
7468,38860,65+,62927,51875,114802,"Portland-South Portland, ME",43.651417,-70.418375,556893
7469,38900,15-19,71264,74332,145596,"Portland-Vancouver-Hillsboro, OR-WA",45.600622,-122.484378,2511612
7470,38900,20-24,71240,71620,142860,"Portland-Vancouver-Hillsboro, OR-WA",45.600622,-122.484378,2511612
7471,38900,25-29,90275,90734,181009,"Portland-Vancouver-Hillsboro, OR-WA",45.600622,-122.484378,2511612
7472,38900,30-34,99177,101650,200827,"Portland-Vancouver-Hillsboro, OR-WA",45.600622,-122.484378,2511612
7473,38900,35-39,97033,99670,196703,"Portland-Vancouver-Hillsboro, OR-WA",45.600622,-122.484378,2511612
7474,38900,40-44,92305,94144,186449,"Portland-Vancouver-Hillsboro, OR-WA",45.600622,-122.484378,2511612
7475,38900,45-49,81772,84735,166507,"Portland-Vancouver-Hillsboro, OR-WA",45.600622,-122.484378,2511612
7476,38900,50-54,80680,84126,164806,"Portland-Vancouver-Hillsboro, OR-WA",45.600622,-122.484378,2511612
7477,38900,55-59,76049,76517,152566,"Portland-Vancouver-Hillsboro, OR-WA",45.600622,-122.484378,2511612
7478,38900,60-64,75821,72954,148775,"Portland-Vancouver-Hillsboro, OR-WA",45.600622,-122.484378,2511612
7479,38900,65+,217675,181213,398888,"Portland-Vancouver-Hillsboro, OR-WA",45.600622,-122.484378,2511612
7480,38920,15-19,629,693,1322,"Port Lavaca, TX",28.441719,-96.579574,19727
7481,38920,20-24,530,655,1185,"Port Lavaca, TX",28.441719,-96.579574,19727
7482,38920,25-29,531,624,1155,"Port Lavaca, TX",28.441719,-96.579574,19727
7483,38920,30-34,556,654,1210,"Port Lavaca, TX",28.441719,-96.579574,19727
7484,38920,35-39,561,613,1174,"Port Lavaca, TX",28.441719,-96.579574,19727
7485,38920,40-44,603,588,1191,"Port Lavaca, TX",28.441719,-96.579574,19727
7486,38920,45-49,499,538,1037,"Port Lavaca, TX",28.441719,-96.579574,19727
7487,38920,50-54,559,570,1129,"Port Lavaca, TX",28.441719,-96.579574,19727
7488,38920,55-59,659,712,1371,"Port Lavaca, TX",28.441719,-96.579574,19727
7489,38920,60-64,643,680,1323,"Port Lavaca, TX",28.441719,-96.579574,19727
7490,38920,65+,1878,1878,3756,"Port Lavaca, TX",28.441719,-96.579574,19727
7491,38940,15-19,12480,13898,26378,"Port St. Lucie, FL",27.228046,-80.425388,503521
7492,38940,20-24,11738,12615,24353,"Port St. Lucie, FL",27.228046,-80.425388,503521
7493,38940,25-29,12338,13190,25528,"Port St. Lucie, FL",27.228046,-80.425388,503521
7494,38940,30-34,13891,14274,28165,"Port St. Lucie, FL",27.228046,-80.425388,503521
7495,38940,35-39,13724,13974,27698,"Port St. Lucie, FL",27.228046,-80.425388,503521
7496,38940,40-44,13365,13951,27316,"Port St. Lucie, FL",27.228046,-80.425388,503521
7497,38940,45-49,13893,13495,27388,"Port St. Lucie, FL",27.228046,-80.425388,503521
7498,38940,50-54,15836,15194,31030,"Port St. Lucie, FL",27.228046,-80.425388,503521
7499,38940,55-59,18537,17400,35937,"Port St. Lucie, FL",27.228046,-80.425388,503521
7500,38940,60-64,20064,18235,38299,"Port St. Lucie, FL",27.228046,-80.425388,503521
7501,38940,65+,71865,63236,135101,"Port St. Lucie, FL",27.228046,-80.425388,503521
7502,39020,15-19,2250,2461,4711,"Portsmouth, OH",38.814889,-82.998675,73346
7503,39020,20-24,2052,2443,4495,"Portsmouth, OH",38.814889,-82.998675,73346
7504,39020,25-29,2101,2448,4549,"Portsmouth, OH",38.814889,-82.998675,73346
7505,39020,30-34,2220,2539,4759,"Portsmouth, OH",38.814889,-82.998675,73346
7506,39020,35-39,2133,2236,4369,"Portsmouth, OH",38.814889,-82.998675,73346
7507,39020,40-44,2256,2260,4516,"Portsmouth, OH",38.814889,-82.998675,73346
7508,39020,45-49,2324,2246,4570,"Portsmouth, OH",38.814889,-82.998675,73346
7509,39020,50-54,2338,2310,4648,"Portsmouth, OH",38.814889,-82.998675,73346
7510,39020,55-59,2491,2350,4841,"Portsmouth, OH",38.814889,-82.998675,73346
7511,39020,60-64,2663,2380,5043,"Portsmouth, OH",38.814889,-82.998675,73346
7512,39020,65+,7663,6107,13770,"Portsmouth, OH",38.814889,-82.998675,73346
7513,39060,15-19,3831,4330,8161,"Pottsville, PA",40.703682,-76.217788,143264
7514,39060,20-24,3423,4093,7516,"Pottsville, PA",40.703682,-76.217788,143264
7515,39060,25-29,3630,4837,8467,"Pottsville, PA",40.703682,-76.217788,143264
7516,39060,30-34,3780,4913,8693,"Pottsville, PA",40.703682,-76.217788,143264
7517,39060,35-39,3998,4768,8766,"Pottsville, PA",40.703682,-76.217788,143264
7518,39060,40-44,3955,4717,8672,"Pottsville, PA",40.703682,-76.217788,143264
7519,39060,45-49,4049,4870,8919,"Pottsville, PA",40.703682,-76.217788,143264
7520,39060,50-54,4791,5337,10128,"Pottsville, PA",40.703682,-76.217788,143264
7521,39060,55-59,5042,5449,10491,"Pottsville, PA",40.703682,-76.217788,143264
7522,39060,60-64,5219,5355,10574,"Pottsville, PA",40.703682,-76.217788,143264
7523,39060,65+,16181,13517,29698,"Pottsville, PA",40.703682,-76.217788,143264
7524,39100,15-19,24678,26853,51531,"Poughkeepsie-Newburgh-Middletown, NY",41.575274,-74.033873,701637
7525,39100,20-24,23209,26577,49786,"Poughkeepsie-Newburgh-Middletown, NY",41.575274,-74.033873,701637
7526,39100,25-29,19938,22026,41964,"Poughkeepsie-Newburgh-Middletown, NY",41.575274,-74.033873,701637
7527,39100,30-34,20594,21693,42287,"Poughkeepsie-Newburgh-Middletown, NY",41.575274,-74.033873,701637
7528,39100,35-39,21185,21878,43063,"Poughkeepsie-Newburgh-Middletown, NY",41.575274,-74.033873,701637
7529,39100,40-44,21085,21839,42924,"Poughkeepsie-Newburgh-Middletown, NY",41.575274,-74.033873,701637
7530,39100,45-49,20701,21198,41899,"Poughkeepsie-Newburgh-Middletown, NY",41.575274,-74.033873,701637
7531,39100,50-54,23945,24210,48155,"Poughkeepsie-Newburgh-Middletown, NY",41.575274,-74.033873,701637
7532,39100,55-59,25632,25419,51051,"Poughkeepsie-Newburgh-Middletown, NY",41.575274,-74.033873,701637
7533,39100,60-64,23253,23380,46633,"Poughkeepsie-Newburgh-Middletown, NY",41.575274,-74.033873,701637
7534,39100,65+,62017,51552,113569,"Poughkeepsie-Newburgh-Middletown, NY",41.575274,-74.033873,701637
7535,39150,15-19,5394,6259,11653,"Prescott Valley-Prescott, AZ",34.631071,-112.577225,242253
7536,39150,20-24,4758,5613,10371,"Prescott Valley-Prescott, AZ",34.631071,-112.577225,242253
7537,39150,25-29,5211,5578,10789,"Prescott Valley-Prescott, AZ",34.631071,-112.577225,242253
7538,39150,30-34,5491,5596,11087,"Prescott Valley-Prescott, AZ",34.631071,-112.577225,242253
7539,39150,35-39,5391,5546,10937,"Prescott Valley-Prescott, AZ",34.631071,-112.577225,242253
7540,39150,40-44,5234,5520,10754,"Prescott Valley-Prescott, AZ",34.631071,-112.577225,242253
7541,39150,45-49,5512,5414,10926,"Prescott Valley-Prescott, AZ",34.631071,-112.577225,242253
7542,39150,50-54,6831,6383,13214,"Prescott Valley-Prescott, AZ",34.631071,-112.577225,242253
7543,39150,55-59,9158,8026,17184,"Prescott Valley-Prescott, AZ",34.631071,-112.577225,242253
7544,39150,60-64,12316,10517,22833,"Prescott Valley-Prescott, AZ",34.631071,-112.577225,242253
7545,39150,65+,42633,38943,81576,"Prescott Valley-Prescott, AZ",34.631071,-112.577225,242253
7546,39220,15-19,853,761,1614,"Price, UT",39.673284,-110.588484,20372
7547,39220,20-24,647,667,1314,"Price, UT",39.673284,-110.588484,20372
7548,39220,25-29,549,588,1137,"Price, UT",39.673284,-110.588484,20372
7549,39220,30-34,588,596,1184,"Price, UT",39.673284,-110.588484,20372
7550,39220,35-39,668,640,1308,"Price, UT",39.673284,-110.588484,20372
7551,39220,40-44,650,667,1317,"Price, UT",39.673284,-110.588484,20372
7552,39220,45-49,557,554,1111,"Price, UT",39.673284,-110.588484,20372
7553,39220,50-54,507,504,1011,"Price, UT",39.673284,-110.588484,20372
7554,39220,55-59,559,509,1068,"Price, UT",39.673284,-110.588484,20372
7555,39220,60-64,633,679,1312,"Price, UT",39.673284,-110.588484,20372
7556,39220,65+,1972,1814,3786,"Price, UT",39.673284,-110.588484,20372
7557,39260,15-19,589,691,1280,"Prineville, OR",44.163054,-120.371585,25739
7558,39260,20-24,572,582,1154,"Prineville, OR",44.163054,-120.371585,25739
7559,39260,25-29,645,608,1253,"Prineville, OR",44.163054,-120.371585,25739
7560,39260,30-34,748,760,1508,"Prineville, OR",44.163054,-120.371585,25739
7561,39260,35-39,711,773,1484,"Prineville, OR",44.163054,-120.371585,25739
7562,39260,40-44,752,722,1474,"Prineville, OR",44.163054,-120.371585,25739
7563,39260,45-49,703,750,1453,"Prineville, OR",44.163054,-120.371585,25739
7564,39260,50-54,775,753,1528,"Prineville, OR",44.163054,-120.371585,25739
7565,39260,55-59,896,835,1731,"Prineville, OR",44.163054,-120.371585,25739
7566,39260,60-64,1066,1043,2109,"Prineville, OR",44.163054,-120.371585,25739
7567,39260,65+,3275,3215,6490,"Prineville, OR",44.163054,-120.371585,25739
7568,39300,15-19,54590,55216,109806,"Providence-Warwick, RI-MA",41.70684,-71.286687,1675774
7569,39300,20-24,55445,56201,111646,"Providence-Warwick, RI-MA",41.70684,-71.286687,1675774
7570,39300,25-29,54315,56024,110339,"Providence-Warwick, RI-MA",41.70684,-71.286687,1675774
7571,39300,30-34,58558,59276,117834,"Providence-Warwick, RI-MA",41.70684,-71.286687,1675774
7572,39300,35-39,54008,54651,108659,"Providence-Warwick, RI-MA",41.70684,-71.286687,1675774
7573,39300,40-44,50685,50499,101184,"Providence-Warwick, RI-MA",41.70684,-71.286687,1675774
7574,39300,45-49,49552,47730,97282,"Providence-Warwick, RI-MA",41.70684,-71.286687,1675774
7575,39300,50-54,57538,55372,112910,"Providence-Warwick, RI-MA",41.70684,-71.286687,1675774
7576,39300,55-59,61937,59179,121116,"Providence-Warwick, RI-MA",41.70684,-71.286687,1675774
7577,39300,60-64,60762,56406,117168,"Providence-Warwick, RI-MA",41.70684,-71.286687,1675774
7578,39300,65+,167428,132753,300181,"Providence-Warwick, RI-MA",41.70684,-71.286687,1675774
7579,39340,15-19,33246,33337,66583,"Provo-Orem, UT",39.872067,-112.359059,697141
7580,39340,20-24,41970,43722,85692,"Provo-Orem, UT",39.872067,-112.359059,697141
7581,39340,25-29,28086,30759,58845,"Provo-Orem, UT",39.872067,-112.359059,697141
7582,39340,30-34,22106,23030,45136,"Provo-Orem, UT",39.872067,-112.359059,697141
7583,39340,35-39,21227,22089,43316,"Provo-Orem, UT",39.872067,-112.359059,697141
7584,39340,40-44,21777,22871,44648,"Provo-Orem, UT",39.872067,-112.359059,697141
7585,39340,45-49,17182,17928,35110,"Provo-Orem, UT",39.872067,-112.359059,697141
7586,39340,50-54,14029,14664,28693,"Provo-Orem, UT",39.872067,-112.359059,697141
7587,39340,55-59,12008,12415,24423,"Provo-Orem, UT",39.872067,-112.359059,697141
7588,39340,60-64,11488,11317,22805,"Provo-Orem, UT",39.872067,-112.359059,697141
7589,39340,65+,29600,25727,55327,"Provo-Orem, UT",39.872067,-112.359059,697141
7590,39380,15-19,5312,5771,11083,"Pueblo, CO",38.162765,-104.484668,169622
7591,39380,20-24,4953,5353,10306,"Pueblo, CO",38.162765,-104.484668,169622
7592,39380,25-29,5411,5687,11098,"Pueblo, CO",38.162765,-104.484668,169622
7593,39380,30-34,5557,5653,11210,"Pueblo, CO",38.162765,-104.484668,169622
7594,39380,35-39,5456,5542,10998,"Pueblo, CO",38.162765,-104.484668,169622
7595,39380,40-44,5202,5280,10482,"Pueblo, CO",38.162765,-104.484668,169622
7596,39380,45-49,4705,4764,9469,"Pueblo, CO",38.162765,-104.484668,169622
7597,39380,50-54,4959,4969,9928,"Pueblo, CO",38.162765,-104.484668,169622
7598,39380,55-59,5361,5187,10548,"Pueblo, CO",38.162765,-104.484668,169622
7599,39380,60-64,5891,5354,11245,"Pueblo, CO",38.162765,-104.484668,169622
7600,39380,65+,17674,14710,32384,"Pueblo, CO",38.162765,-104.484668,169622
7601,39420,15-19,3281,3042,6323,"Pullman, WA",46.905944,-117.53539,47873
7602,39420,20-24,5410,5752,11162,"Pullman, WA",46.905944,-117.53539,47873
7603,39420,25-29,1741,1944,3685,"Pullman, WA",46.905944,-117.53539,47873
7604,39420,30-34,1319,1648,2967,"Pullman, WA",46.905944,-117.53539,47873
7605,39420,35-39,1133,1303,2436,"Pullman, WA",46.905944,-117.53539,47873
7606,39420,40-44,1070,1110,2180,"Pullman, WA",46.905944,-117.53539,47873
7607,39420,45-49,906,910,1816,"Pullman, WA",46.905944,-117.53539,47873
7608,39420,50-54,904,932,1836,"Pullman, WA",46.905944,-117.53539,47873
7609,39420,55-59,999,969,1968,"Pullman, WA",46.905944,-117.53539,47873
7610,39420,60-64,1069,1096,2165,"Pullman, WA",46.905944,-117.53539,47873
7611,39420,65+,2786,2565,5351,"Pullman, WA",46.905944,-117.53539,47873
7612,39460,15-19,3227,3581,6808,"Punta Gorda, FL",26.906396,-82.003657,194843
7613,39460,20-24,3195,3736,6931,"Punta Gorda, FL",26.906396,-82.003657,194843
7614,39460,25-29,3525,3932,7457,"Punta Gorda, FL",26.906396,-82.003657,194843
7615,39460,30-34,3668,4054,7722,"Punta Gorda, FL",26.906396,-82.003657,194843
7616,39460,35-39,3733,3883,7616,"Punta Gorda, FL",26.906396,-82.003657,194843
7617,39460,40-44,3698,3849,7547,"Punta Gorda, FL",26.906396,-82.003657,194843
7618,39460,45-49,4113,3902,8015,"Punta Gorda, FL",26.906396,-82.003657,194843
7619,39460,50-54,5895,5109,11004,"Punta Gorda, FL",26.906396,-82.003657,194843
7620,39460,55-59,8003,6926,14929,"Punta Gorda, FL",26.906396,-82.003657,194843
7621,39460,60-64,10192,8932,19124,"Punta Gorda, FL",26.906396,-82.003657,194843
7622,39460,65+,40903,38090,78993,"Punta Gorda, FL",26.906396,-82.003657,194843
7623,39500,15-19,2300,2442,4742,"Quincy, IL-MO",40.027165,-91.389838,74954
7624,39500,20-24,2148,2279,4427,"Quincy, IL-MO",40.027165,-91.389838,74954
7625,39500,25-29,2090,2139,4229,"Quincy, IL-MO",40.027165,-91.389838,74954
7626,39500,30-34,2271,2238,4509,"Quincy, IL-MO",40.027165,-91.389838,74954
7627,39500,35-39,2257,2272,4529,"Quincy, IL-MO",40.027165,-91.389838,74954
7628,39500,40-44,2134,2225,4359,"Quincy, IL-MO",40.027165,-91.389838,74954
7629,39500,45-49,1948,2007,3955,"Quincy, IL-MO",40.027165,-91.389838,74954
7630,39500,50-54,2266,2170,4436,"Quincy, IL-MO",40.027165,-91.389838,74954
7631,39500,55-59,2538,2540,5078,"Quincy, IL-MO",40.027165,-91.389838,74954
7632,39500,60-64,2683,2633,5316,"Quincy, IL-MO",40.027165,-91.389838,74954
7633,39500,65+,8329,7069,15398,"Quincy, IL-MO",40.027165,-91.389838,74954
7634,39540,15-19,6020,6386,12406,"Racine, WI",42.780392,-87.771599,196896
7635,39540,20-24,5532,6316,11848,"Racine, WI",42.780392,-87.771599,196896
7636,39540,25-29,5666,6137,11803,"Racine, WI",42.780392,-87.771599,196896
7637,39540,30-34,5787,5954,11741,"Racine, WI",42.780392,-87.771599,196896
7638,39540,35-39,6205,6270,12475,"Racine, WI",42.780392,-87.771599,196896
7639,39540,40-44,6048,6135,12183,"Racine, WI",42.780392,-87.771599,196896
7640,39540,45-49,5543,5799,11342,"Racine, WI",42.780392,-87.771599,196896
7641,39540,50-54,6562,6428,12990,"Racine, WI",42.780392,-87.771599,196896
7642,39540,55-59,7294,7272,14566,"Racine, WI",42.780392,-87.771599,196896
7643,39540,60-64,7199,6975,14174,"Racine, WI",42.780392,-87.771599,196896
7644,39540,65+,18720,15670,34390,"Racine, WI",42.780392,-87.771599,196896
7645,39580,15-19,49273,51247,100520,"Raleigh-Cary, NC",35.756746,-78.460441,1448411
7646,39580,20-24,44356,43773,88129,"Raleigh-Cary, NC",35.756746,-78.460441,1448411
7647,39580,25-29,50445,48807,99252,"Raleigh-Cary, NC",35.756746,-78.460441,1448411
7648,39580,30-34,54163,51830,105993,"Raleigh-Cary, NC",35.756746,-78.460441,1448411
7649,39580,35-39,54072,52126,106198,"Raleigh-Cary, NC",35.756746,-78.460441,1448411
7650,39580,40-44,54086,51761,105847,"Raleigh-Cary, NC",35.756746,-78.460441,1448411
7651,39580,45-49,51459,50551,102010,"Raleigh-Cary, NC",35.756746,-78.460441,1448411
7652,39580,50-54,51279,50746,102025,"Raleigh-Cary, NC",35.756746,-78.460441,1448411
7653,39580,55-59,46902,45538,92440,"Raleigh-Cary, NC",35.756746,-78.460441,1448411
7654,39580,60-64,41807,39182,80989,"Raleigh-Cary, NC",35.756746,-78.460441,1448411
7655,39580,65+,105374,82705,188079,"Raleigh-Cary, NC",35.756746,-78.460441,1448411
7656,39660,15-19,4007,4624,8631,"Rapid City, SD",44.314673,-102.785719,141979
7657,39660,20-24,3883,5001,8884,"Rapid City, SD",44.314673,-102.785719,141979
7658,39660,25-29,4320,4965,9285,"Rapid City, SD",44.314673,-102.785719,141979
7659,39660,30-34,4638,4822,9460,"Rapid City, SD",44.314673,-102.785719,141979
7660,39660,35-39,4440,4690,9130,"Rapid City, SD",44.314673,-102.785719,141979
7661,39660,40-44,4180,4302,8482,"Rapid City, SD",44.314673,-102.785719,141979
7662,39660,45-49,3585,3718,7303,"Rapid City, SD",44.314673,-102.785719,141979
7663,39660,50-54,3779,3847,7626,"Rapid City, SD",44.314673,-102.785719,141979
7664,39660,55-59,4675,4616,9291,"Rapid City, SD",44.314673,-102.785719,141979
7665,39660,60-64,5362,5411,10773,"Rapid City, SD",44.314673,-102.785719,141979
7666,39660,65+,13710,12788,26498,"Rapid City, SD",44.314673,-102.785719,141979
7667,39700,15-19,680,850,1530,"Raymondville, TX",26.481861,-97.594731,20316
7668,39700,20-24,646,1241,1887,"Raymondville, TX",26.481861,-97.594731,20316
7669,39700,25-29,636,1195,1831,"Raymondville, TX",26.481861,-97.594731,20316
7670,39700,30-34,532,995,1527,"Raymondville, TX",26.481861,-97.594731,20316
7671,39700,35-39,523,945,1468,"Raymondville, TX",26.481861,-97.594731,20316
7672,39700,40-44,518,772,1290,"Raymondville, TX",26.481861,-97.594731,20316
7673,39700,45-49,492,656,1148,"Raymondville, TX",26.481861,-97.594731,20316
7674,39700,50-54,472,545,1017,"Raymondville, TX",26.481861,-97.594731,20316
7675,39700,55-59,497,419,916,"Raymondville, TX",26.481861,-97.594731,20316
7676,39700,60-64,465,475,940,"Raymondville, TX",26.481861,-97.594731,20316
7677,39700,65+,1562,1276,2838,"Raymondville, TX",26.481861,-97.594731,20316
7678,39740,15-19,14890,15212,30102,"Reading, PA",40.413957,-75.92686,429342
7679,39740,20-24,13531,13832,27363,"Reading, PA",40.413957,-75.92686,429342
7680,39740,25-29,12696,13507,26203,"Reading, PA",40.413957,-75.92686,429342
7681,39740,30-34,13524,13940,27464,"Reading, PA",40.413957,-75.92686,429342
7682,39740,35-39,13174,13165,26339,"Reading, PA",40.413957,-75.92686,429342
7683,39740,40-44,12695,12615,25310,"Reading, PA",40.413957,-75.92686,429342
7684,39740,45-49,12473,12354,24827,"Reading, PA",40.413957,-75.92686,429342
7685,39740,50-54,14140,14029,28169,"Reading, PA",40.413957,-75.92686,429342
7686,39740,55-59,15383,15241,30624,"Reading, PA",40.413957,-75.92686,429342
7687,39740,60-64,14474,14611,29085,"Reading, PA",40.413957,-75.92686,429342
7688,39740,65+,41541,34563,76104,"Reading, PA",40.413957,-75.92686,429342
7689,39780,15-19,1990,2224,4214,"Red Bluff, CA",40.126157,-122.232274,65498
7690,39780,20-24,1719,1713,3432,"Red Bluff, CA",40.126157,-122.232274,65498
7691,39780,25-29,1874,1958,3832,"Red Bluff, CA",40.126157,-122.232274,65498
7692,39780,30-34,1964,2007,3971,"Red Bluff, CA",40.126157,-122.232274,65498
7693,39780,35-39,1922,2039,3961,"Red Bluff, CA",40.126157,-122.232274,65498
7694,39780,40-44,1845,1863,3708,"Red Bluff, CA",40.126157,-122.232274,65498
7695,39780,45-49,1654,1777,3431,"Red Bluff, CA",40.126157,-122.232274,65498
7696,39780,50-54,1830,1868,3698,"Red Bluff, CA",40.126157,-122.232274,65498
7697,39780,55-59,2321,2147,4468,"Red Bluff, CA",40.126157,-122.232274,65498
7698,39780,60-64,2382,2278,4660,"Red Bluff, CA",40.126157,-122.232274,65498
7699,39780,65+,7012,6204,13216,"Red Bluff, CA",40.126157,-122.232274,65498
7700,39820,15-19,5207,5501,10708,"Redding, CA",40.760514,-122.043556,182139
7701,39820,20-24,4617,5067,9684,"Redding, CA",40.760514,-122.043556,182139
7702,39820,25-29,5329,5561,10890,"Redding, CA",40.760514,-122.043556,182139
7703,39820,30-34,6100,6084,12184,"Redding, CA",40.760514,-122.043556,182139
7704,39820,35-39,5944,5996,11940,"Redding, CA",40.760514,-122.043556,182139
7705,39820,40-44,5248,5434,10682,"Redding, CA",40.760514,-122.043556,182139
7706,39820,45-49,4603,4600,9203,"Redding, CA",40.760514,-122.043556,182139
7707,39820,50-54,5416,5120,10536,"Redding, CA",40.760514,-122.043556,182139
7708,39820,55-59,6287,5822,12109,"Redding, CA",40.760514,-122.043556,182139
7709,39820,60-64,6805,6273,13078,"Redding, CA",40.760514,-122.043556,182139
7710,39820,65+,20662,17655,38317,"Redding, CA",40.760514,-122.043556,182139
7711,39860,15-19,1346,1533,2879,"Red Wing, MN",44.406178,-92.716,47968
7712,39860,20-24,1162,1218,2380,"Red Wing, MN",44.406178,-92.716,47968
7713,39860,25-29,1303,1360,2663,"Red Wing, MN",44.406178,-92.716,47968
7714,39860,30-34,1310,1406,2716,"Red Wing, MN",44.406178,-92.716,47968
7715,39860,35-39,1535,1542,3077,"Red Wing, MN",44.406178,-92.716,47968
7716,39860,40-44,1442,1463,2905,"Red Wing, MN",44.406178,-92.716,47968
7717,39860,45-49,1308,1349,2657,"Red Wing, MN",44.406178,-92.716,47968
7718,39860,50-54,1422,1465,2887,"Red Wing, MN",44.406178,-92.716,47968
7719,39860,55-59,1791,1779,3570,"Red Wing, MN",44.406178,-92.716,47968
7720,39860,60-64,1847,1870,3717,"Red Wing, MN",44.406178,-92.716,47968
7721,39860,65+,5270,4570,9840,"Red Wing, MN",44.406178,-92.716,47968
7722,39900,15-19,14277,15201,29478,"Reno, NV",40.500795,-119.731161,497535
7723,39900,20-24,15227,15974,31201,"Reno, NV",40.500795,-119.731161,497535
7724,39900,25-29,17691,18922,36613,"Reno, NV",40.500795,-119.731161,497535
7725,39900,30-34,18387,19970,38357,"Reno, NV",40.500795,-119.731161,497535
7726,39900,35-39,16597,18013,34610,"Reno, NV",40.500795,-119.731161,497535
7727,39900,40-44,14942,15582,30524,"Reno, NV",40.500795,-119.731161,497535
7728,39900,45-49,13779,14434,28213,"Reno, NV",40.500795,-119.731161,497535
7729,39900,50-54,15011,16062,31073,"Reno, NV",40.500795,-119.731161,497535
7730,39900,55-59,15873,16032,31905,"Reno, NV",40.500795,-119.731161,497535
7731,39900,60-64,16243,16363,32606,"Reno, NV",40.500795,-119.731161,497535
7732,39900,65+,44840,41317,86157,"Reno, NV",40.500795,-119.731161,497535
7733,39940,15-19,4089,3006,7095,"Rexburg, ID",44.142753,-111.508107,67473
7734,39940,20-24,6081,6831,12912,"Rexburg, ID",44.142753,-111.508107,67473
7735,39940,25-29,2861,3896,6757,"Rexburg, ID",44.142753,-111.508107,67473
7736,39940,30-34,1509,1748,3257,"Rexburg, ID",44.142753,-111.508107,67473
7737,39940,35-39,1465,1574,3039,"Rexburg, ID",44.142753,-111.508107,67473
7738,39940,40-44,1455,1651,3106,"Rexburg, ID",44.142753,-111.508107,67473
7739,39940,45-49,1304,1393,2697,"Rexburg, ID",44.142753,-111.508107,67473
7740,39940,50-54,1198,1246,2444,"Rexburg, ID",44.142753,-111.508107,67473
7741,39940,55-59,1230,1289,2519,"Rexburg, ID",44.142753,-111.508107,67473
7742,39940,60-64,1322,1304,2626,"Rexburg, ID",44.142753,-111.508107,67473
7743,39940,65+,3360,3223,6583,"Rexburg, ID",44.142753,-111.508107,67473
7744,39980,15-19,2110,2245,4355,"Richmond, IN",39.863091,-85.006735,66456
7745,39980,20-24,2237,2248,4485,"Richmond, IN",39.863091,-85.006735,66456
7746,39980,25-29,1924,2014,3938,"Richmond, IN",39.863091,-85.006735,66456
7747,39980,30-34,1902,1915,3817,"Richmond, IN",39.863091,-85.006735,66456
7748,39980,35-39,1933,1812,3745,"Richmond, IN",39.863091,-85.006735,66456
7749,39980,40-44,1932,1911,3843,"Richmond, IN",39.863091,-85.006735,66456
7750,39980,45-49,1920,1953,3873,"Richmond, IN",39.863091,-85.006735,66456
7751,39980,50-54,2152,2106,4258,"Richmond, IN",39.863091,-85.006735,66456
7752,39980,55-59,2318,2231,4549,"Richmond, IN",39.863091,-85.006735,66456
7753,39980,60-64,2298,2236,4534,"Richmond, IN",39.863091,-85.006735,66456
7754,39980,65+,7291,5568,12859,"Richmond, IN",39.863091,-85.006735,66456
7755,40060,15-19,40959,41838,82797,"Richmond, VA",37.411324,-77.441816,1324062
7756,40060,20-24,40180,39388,79568,"Richmond, VA",37.411324,-77.441816,1324062
7757,40060,25-29,47250,45696,92946,"Richmond, VA",37.411324,-77.441816,1324062
7758,40060,30-34,50219,47908,98127,"Richmond, VA",37.411324,-77.441816,1324062
7759,40060,35-39,46745,46163,92908,"Richmond, VA",37.411324,-77.441816,1324062
7760,40060,40-44,43059,41962,85021,"Richmond, VA",37.411324,-77.441816,1324062
7761,40060,45-49,40217,38378,78595,"Richmond, VA",37.411324,-77.441816,1324062
7762,40060,50-54,44138,41994,86132,"Richmond, VA",37.411324,-77.441816,1324062
7763,40060,55-59,46895,43026,89921,"Richmond, VA",37.411324,-77.441816,1324062
7764,40060,60-64,46017,40713,86730,"Richmond, VA",37.411324,-77.441816,1324062
7765,40060,65+,122265,95434,217699,"Richmond, VA",37.411324,-77.441816,1324062
7766,40080,15-19,4783,4337,9120,"Richmond-Berea, KY",37.717206,-84.168436,108758
7767,40080,20-24,6201,5795,11996,"Richmond-Berea, KY",37.717206,-84.168436,108758
7768,40080,25-29,3618,3819,7437,"Richmond-Berea, KY",37.717206,-84.168436,108758
7769,40080,30-34,3239,3323,6562,"Richmond-Berea, KY",37.717206,-84.168436,108758
7770,40080,35-39,3140,3048,6188,"Richmond-Berea, KY",37.717206,-84.168436,108758
7771,40080,40-44,3250,3356,6606,"Richmond-Berea, KY",37.717206,-84.168436,108758
7772,40080,45-49,3226,3131,6357,"Richmond-Berea, KY",37.717206,-84.168436,108758
7773,40080,50-54,3419,3315,6734,"Richmond-Berea, KY",37.717206,-84.168436,108758
7774,40080,55-59,3426,3223,6649,"Richmond-Berea, KY",37.717206,-84.168436,108758
7775,40080,60-64,3251,2982,6233,"Richmond-Berea, KY",37.717206,-84.168436,108758
7776,40080,65+,8965,7219,16184,"Richmond-Berea, KY",37.717206,-84.168436,108758
7777,40100,15-19,2819,2742,5561,"Rio Grande City-Roma, TX",26.530903,-98.740235,66049
7778,40100,20-24,2566,2677,5243,"Rio Grande City-Roma, TX",26.530903,-98.740235,66049
7779,40100,25-29,2397,2459,4856,"Rio Grande City-Roma, TX",26.530903,-98.740235,66049
7780,40100,30-34,1934,2186,4120,"Rio Grande City-Roma, TX",26.530903,-98.740235,66049
7781,40100,35-39,1894,2034,3928,"Rio Grande City-Roma, TX",26.530903,-98.740235,66049
7782,40100,40-44,1894,1846,3740,"Rio Grande City-Roma, TX",26.530903,-98.740235,66049
7783,40100,45-49,1905,1837,3742,"Rio Grande City-Roma, TX",26.530903,-98.740235,66049
7784,40100,50-54,1909,1724,3633,"Rio Grande City-Roma, TX",26.530903,-98.740235,66049
7785,40100,55-59,1634,1375,3009,"Rio Grande City-Roma, TX",26.530903,-98.740235,66049
7786,40100,60-64,1467,1220,2687,"Rio Grande City-Roma, TX",26.530903,-98.740235,66049
7787,40100,65+,4235,3261,7496,"Rio Grande City-Roma, TX",26.530903,-98.740235,66049
7788,40140,15-19,164506,173867,338373,"Riverside-San Bernardino-Ontario, CA",34.538476,-116.134541,4653105
7789,40140,20-24,154792,163281,318073,"Riverside-San Bernardino-Ontario, CA",34.538476,-116.134541,4653105
7790,40140,25-29,164275,172025,336300,"Riverside-San Bernardino-Ontario, CA",34.538476,-116.134541,4653105
7791,40140,30-34,167458,174401,341859,"Riverside-San Bernardino-Ontario, CA",34.538476,-116.134541,4653105
7792,40140,35-39,158194,166346,324540,"Riverside-San Bernardino-Ontario, CA",34.538476,-116.134541,4653105
7793,40140,40-44,149805,152805,302610,"Riverside-San Bernardino-Ontario, CA",34.538476,-116.134541,4653105
7794,40140,45-49,140487,139711,280198,"Riverside-San Bernardino-Ontario, CA",34.538476,-116.134541,4653105
7795,40140,50-54,140108,142294,282402,"Riverside-San Bernardino-Ontario, CA",34.538476,-116.134541,4653105
7796,40140,55-59,138080,137953,276033,"Riverside-San Bernardino-Ontario, CA",34.538476,-116.134541,4653105
7797,40140,60-64,130291,127801,258092,"Riverside-San Bernardino-Ontario, CA",34.538476,-116.134541,4653105
7798,40140,65+,341013,289350,630363,"Riverside-San Bernardino-Ontario, CA",34.538476,-116.134541,4653105
7799,40180,15-19,1264,1413,2677,"Riverton, WY",43.054831,-108.608935,39336
7800,40180,20-24,978,1142,2120,"Riverton, WY",43.054831,-108.608935,39336
7801,40180,25-29,1017,1042,2059,"Riverton, WY",43.054831,-108.608935,39336
7802,40180,30-34,1144,1161,2305,"Riverton, WY",43.054831,-108.608935,39336
7803,40180,35-39,1271,1247,2518,"Riverton, WY",43.054831,-108.608935,39336
7804,40180,40-44,1130,1206,2336,"Riverton, WY",43.054831,-108.608935,39336
7805,40180,45-49,972,1020,1992,"Riverton, WY",43.054831,-108.608935,39336
7806,40180,50-54,1073,1128,2201,"Riverton, WY",43.054831,-108.608935,39336
7807,40180,55-59,1167,1220,2387,"Riverton, WY",43.054831,-108.608935,39336
7808,40180,60-64,1427,1398,2825,"Riverton, WY",43.054831,-108.608935,39336
7809,40180,65+,4031,3663,7694,"Riverton, WY",43.054831,-108.608935,39336
7810,40220,15-19,9231,9471,18702,"Roanoke, VA",37.286226,-79.946935,314496
7811,40220,20-24,8918,8718,17636,"Roanoke, VA",37.286226,-79.946935,314496
7812,40220,25-29,9628,9432,19060,"Roanoke, VA",37.286226,-79.946935,314496
7813,40220,30-34,10001,9558,19559,"Roanoke, VA",37.286226,-79.946935,314496
7814,40220,35-39,9392,9437,18829,"Roanoke, VA",37.286226,-79.946935,314496
7815,40220,40-44,9228,8961,18189,"Roanoke, VA",37.286226,-79.946935,314496
7816,40220,45-49,9366,9149,18515,"Roanoke, VA",37.286226,-79.946935,314496
7817,40220,50-54,10536,10422,20958,"Roanoke, VA",37.286226,-79.946935,314496
7818,40220,55-59,11507,11014,22521,"Roanoke, VA",37.286226,-79.946935,314496
7819,40220,60-64,11603,11015,22618,"Roanoke, VA",37.286226,-79.946935,314496
7820,40220,65+,36745,29123,65868,"Roanoke, VA",37.286226,-79.946935,314496
7821,40260,15-19,1776,1958,3734,"Roanoke Rapids, NC",36.320576,-77.542757,65401
7822,40260,20-24,1641,1726,3367,"Roanoke Rapids, NC",36.320576,-77.542757,65401
7823,40260,25-29,1713,1872,3585,"Roanoke Rapids, NC",36.320576,-77.542757,65401
7824,40260,30-34,1877,1889,3766,"Roanoke Rapids, NC",36.320576,-77.542757,65401
7825,40260,35-39,1710,1702,3412,"Roanoke Rapids, NC",36.320576,-77.542757,65401
7826,40260,40-44,1691,1714,3405,"Roanoke Rapids, NC",36.320576,-77.542757,65401
7827,40260,45-49,1769,1658,3427,"Roanoke Rapids, NC",36.320576,-77.542757,65401
7828,40260,50-54,2120,1997,4117,"Roanoke Rapids, NC",36.320576,-77.542757,65401
7829,40260,55-59,2631,2418,5049,"Roanoke Rapids, NC",36.320576,-77.542757,65401
7830,40260,60-64,2763,2456,5219,"Roanoke Rapids, NC",36.320576,-77.542757,65401
7831,40260,65+,8728,6676,15404,"Roanoke Rapids, NC",36.320576,-77.542757,65401
7832,40300,15-19,1595,1666,3261,"Rochelle, IL",42.041884,-89.320176,51449
7833,40300,20-24,1371,1394,2765,"Rochelle, IL",42.041884,-89.320176,51449
7834,40300,25-29,1394,1480,2874,"Rochelle, IL",42.041884,-89.320176,51449
7835,40300,30-34,1490,1497,2987,"Rochelle, IL",42.041884,-89.320176,51449
7836,40300,35-39,1566,1584,3150,"Rochelle, IL",42.041884,-89.320176,51449
7837,40300,40-44,1501,1583,3084,"Rochelle, IL",42.041884,-89.320176,51449
7838,40300,45-49,1466,1509,2975,"Rochelle, IL",42.041884,-89.320176,51449
7839,40300,50-54,1709,1740,3449,"Rochelle, IL",42.041884,-89.320176,51449
7840,40300,55-59,1822,1943,3765,"Rochelle, IL",42.041884,-89.320176,51449
7841,40300,60-64,1958,1899,3857,"Rochelle, IL",42.041884,-89.320176,51449
7842,40300,65+,5257,4701,9958,"Rochelle, IL",42.041884,-89.320176,51449
7843,40340,15-19,7028,7386,14414,"Rochester, MN",43.94981,-92.33066,227151
7844,40340,20-24,6354,6008,12362,"Rochester, MN",43.94981,-92.33066,227151
7845,40340,25-29,7921,7143,15064,"Rochester, MN",43.94981,-92.33066,227151
7846,40340,30-34,7568,7472,15040,"Rochester, MN",43.94981,-92.33066,227151
7847,40340,35-39,7953,8039,15992,"Rochester, MN",43.94981,-92.33066,227151
7848,40340,40-44,7198,7496,14694,"Rochester, MN",43.94981,-92.33066,227151
7849,40340,45-49,6130,6412,12542,"Rochester, MN",43.94981,-92.33066,227151
7850,40340,50-54,6408,6620,13028,"Rochester, MN",43.94981,-92.33066,227151
7851,40340,55-59,7299,7148,14447,"Rochester, MN",43.94981,-92.33066,227151
7852,40340,60-64,7728,7414,15142,"Rochester, MN",43.94981,-92.33066,227151
7853,40340,65+,21144,17852,38996,"Rochester, MN",43.94981,-92.33066,227151
7854,40380,15-19,35231,36339,71570,"Rochester, NY",43.148038,-77.523257,1084973
7855,40380,20-24,35936,35574,71510,"Rochester, NY",43.148038,-77.523257,1084973
7856,40380,25-29,34628,35086,69714,"Rochester, NY",43.148038,-77.523257,1084973
7857,40380,30-34,36231,36397,72628,"Rochester, NY",43.148038,-77.523257,1084973
7858,40380,35-39,34647,33994,68641,"Rochester, NY",43.148038,-77.523257,1084973
7859,40380,40-44,31415,30473,61888,"Rochester, NY",43.148038,-77.523257,1084973
7860,40380,45-49,29646,28157,57803,"Rochester, NY",43.148038,-77.523257,1084973
7861,40380,50-54,35696,34457,70153,"Rochester, NY",43.148038,-77.523257,1084973
7862,40380,55-59,39731,37519,77250,"Rochester, NY",43.148038,-77.523257,1084973
7863,40380,60-64,39959,38060,78019,"Rochester, NY",43.148038,-77.523257,1084973
7864,40380,65+,112714,92518,205232,"Rochester, NY",43.148038,-77.523257,1084973
7865,40420,15-19,10717,11451,22168,"Rockford, IL",42.331183,-89.042914,336278
7866,40420,20-24,9996,10191,20187,"Rockford, IL",42.331183,-89.042914,336278
7867,40420,25-29,10587,10302,20889,"Rockford, IL",42.331183,-89.042914,336278
7868,40420,30-34,10585,10033,20618,"Rockford, IL",42.331183,-89.042914,336278
7869,40420,35-39,10343,9938,20281,"Rockford, IL",42.331183,-89.042914,336278
7870,40420,40-44,10109,9829,19938,"Rockford, IL",42.331183,-89.042914,336278
7871,40420,45-49,9919,9880,19799,"Rockford, IL",42.331183,-89.042914,336278
7872,40420,50-54,10901,10884,21785,"Rockford, IL",42.331183,-89.042914,336278
7873,40420,55-59,11433,11238,22671,"Rockford, IL",42.331183,-89.042914,336278
7874,40420,60-64,11396,11079,22475,"Rockford, IL",42.331183,-89.042914,336278
7875,40420,65+,33145,27479,60624,"Rockford, IL",42.331183,-89.042914,336278
7876,40460,15-19,1347,1408,2755,"Rockingham, NC",35.004636,-79.755695,42724
7877,40460,20-24,1203,1436,2639,"Rockingham, NC",35.004636,-79.755695,42724
7878,40460,25-29,1377,1331,2708,"Rockingham, NC",35.004636,-79.755695,42724
7879,40460,30-34,1346,1263,2609,"Rockingham, NC",35.004636,-79.755695,42724
7880,40460,35-39,1166,1084,2250,"Rockingham, NC",35.004636,-79.755695,42724
7881,40460,40-44,1300,1228,2528,"Rockingham, NC",35.004636,-79.755695,42724
7882,40460,45-49,1392,1238,2630,"Rockingham, NC",35.004636,-79.755695,42724
7883,40460,50-54,1415,1417,2832,"Rockingham, NC",35.004636,-79.755695,42724
7884,40460,55-59,1414,1423,2837,"Rockingham, NC",35.004636,-79.755695,42724
7885,40460,60-64,1472,1392,2864,"Rockingham, NC",35.004636,-79.755695,42724
7886,40460,65+,4333,3442,7775,"Rockingham, NC",35.004636,-79.755695,42724
7887,40530,15-19,609,632,1241,"Rockport, TX",28.122621,-96.967501,24510
7888,40530,20-24,539,625,1164,"Rockport, TX",28.122621,-96.967501,24510
7889,40530,25-29,595,611,1206,"Rockport, TX",28.122621,-96.967501,24510
7890,40530,30-34,587,601,1188,"Rockport, TX",28.122621,-96.967501,24510
7891,40530,35-39,604,666,1270,"Rockport, TX",28.122621,-96.967501,24510
7892,40530,40-44,622,640,1262,"Rockport, TX",28.122621,-96.967501,24510
7893,40530,45-49,626,626,1252,"Rockport, TX",28.122621,-96.967501,24510
7894,40530,50-54,770,725,1495,"Rockport, TX",28.122621,-96.967501,24510
7895,40530,55-59,979,842,1821,"Rockport, TX",28.122621,-96.967501,24510
7896,40530,60-64,1132,1047,2179,"Rockport, TX",28.122621,-96.967501,24510
7897,40530,65+,3475,3241,6716,"Rockport, TX",28.122621,-96.967501,24510
7898,40540,15-19,1513,1572,3085,"Rock Springs, WY",41.660328,-108.875677,41614
7899,40540,20-24,1200,1307,2507,"Rock Springs, WY",41.660328,-108.875677,41614
7900,40540,25-29,1236,1249,2485,"Rock Springs, WY",41.660328,-108.875677,41614
7901,40540,30-34,1362,1523,2885,"Rock Springs, WY",41.660328,-108.875677,41614
7902,40540,35-39,1536,1593,3129,"Rock Springs, WY",41.660328,-108.875677,41614
7903,40540,40-44,1489,1604,3093,"Rock Springs, WY",41.660328,-108.875677,41614
7904,40540,45-49,1176,1332,2508,"Rock Springs, WY",41.660328,-108.875677,41614
7905,40540,50-54,1093,1245,2338,"Rock Springs, WY",41.660328,-108.875677,41614
7906,40540,55-59,1162,1267,2429,"Rock Springs, WY",41.660328,-108.875677,41614
7907,40540,60-64,1292,1431,2723,"Rock Springs, WY",41.660328,-108.875677,41614
7908,40540,65+,2916,2970,5886,"Rock Springs, WY",41.660328,-108.875677,41614
7909,40580,15-19,4497,4754,9251,"Rocky Mount, NC",35.941045,-77.798549,143535
7910,40580,20-24,4257,4303,8560,"Rocky Mount, NC",35.941045,-77.798549,143535
7911,40580,25-29,4553,4188,8741,"Rocky Mount, NC",35.941045,-77.798549,143535
7912,40580,30-34,4524,4103,8627,"Rocky Mount, NC",35.941045,-77.798549,143535
7913,40580,35-39,4078,3724,7802,"Rocky Mount, NC",35.941045,-77.798549,143535
7914,40580,40-44,4291,3806,8097,"Rocky Mount, NC",35.941045,-77.798549,143535
7915,40580,45-49,4492,3946,8438,"Rocky Mount, NC",35.941045,-77.798549,143535
7916,40580,50-54,4776,4467,9243,"Rocky Mount, NC",35.941045,-77.798549,143535
7917,40580,55-59,5344,4806,10150,"Rocky Mount, NC",35.941045,-77.798549,143535
7918,40580,60-64,5413,4800,10213,"Rocky Mount, NC",35.941045,-77.798549,143535
7919,40580,65+,16261,12156,28417,"Rocky Mount, NC",35.941045,-77.798549,143535
7920,40620,15-19,1526,2317,3843,"Rolla, MO",37.866326,-91.790349,44937
7921,40620,20-24,1834,3342,5176,"Rolla, MO",37.866326,-91.790349,44937
7922,40620,25-29,1189,1448,2637,"Rolla, MO",37.866326,-91.790349,44937
7923,40620,30-34,1237,1244,2481,"Rolla, MO",37.866326,-91.790349,44937
7924,40620,35-39,1301,1335,2636,"Rolla, MO",37.866326,-91.790349,44937
7925,40620,40-44,1262,1281,2543,"Rolla, MO",37.866326,-91.790349,44937
7926,40620,45-49,1065,1142,2207,"Rolla, MO",37.866326,-91.790349,44937
7927,40620,50-54,1204,1199,2403,"Rolla, MO",37.866326,-91.790349,44937
7928,40620,55-59,1380,1296,2676,"Rolla, MO",37.866326,-91.790349,44937
7929,40620,60-64,1458,1422,2880,"Rolla, MO",37.866326,-91.790349,44937
7930,40620,65+,4126,3499,7625,"Rolla, MO",37.866326,-91.790349,44937
7931,40660,15-19,3785,3592,7377,"Rome, GA",34.263692,-85.213685,98771
7932,40660,20-24,3485,3194,6679,"Rome, GA",34.263692,-85.213685,98771
7933,40660,25-29,3128,3137,6265,"Rome, GA",34.263692,-85.213685,98771
7934,40660,30-34,3262,3331,6593,"Rome, GA",34.263692,-85.213685,98771
7935,40660,35-39,3092,2920,6012,"Rome, GA",34.263692,-85.213685,98771
7936,40660,40-44,2956,2957,5913,"Rome, GA",34.263692,-85.213685,98771
7937,40660,45-49,2904,3020,5924,"Rome, GA",34.263692,-85.213685,98771
7938,40660,50-54,3179,3112,6291,"Rome, GA",34.263692,-85.213685,98771
7939,40660,55-59,3278,3054,6332,"Rome, GA",34.263692,-85.213685,98771
7940,40660,60-64,3142,3002,6144,"Rome, GA",34.263692,-85.213685,98771
7941,40660,65+,9422,7413,16835,"Rome, GA",34.263692,-85.213685,98771
7942,40700,15-19,2807,3062,5869,"Roseburg, OR",43.286328,-123.154476,111978
7943,40700,20-24,2479,2624,5103,"Roseburg, OR",43.286328,-123.154476,111978
7944,40700,25-29,2987,3112,6099,"Roseburg, OR",43.286328,-123.154476,111978
7945,40700,30-34,3249,3241,6490,"Roseburg, OR",43.286328,-123.154476,111978
7946,40700,35-39,3189,3088,6277,"Roseburg, OR",43.286328,-123.154476,111978
7947,40700,40-44,3079,3260,6339,"Roseburg, OR",43.286328,-123.154476,111978
7948,40700,45-49,2779,2861,5640,"Roseburg, OR",43.286328,-123.154476,111978
7949,40700,50-54,3296,3178,6474,"Roseburg, OR",43.286328,-123.154476,111978
7950,40700,55-59,3925,3672,7597,"Roseburg, OR",43.286328,-123.154476,111978
7951,40700,60-64,4562,4156,8718,"Roseburg, OR",43.286328,-123.154476,111978
7952,40700,65+,15291,14210,29501,"Roseburg, OR",43.286328,-123.154476,111978
7953,40740,15-19,2423,2946,5369,"Roswell, NM",33.361604,-104.469837,64629
7954,40740,20-24,1971,2258,4229,"Roswell, NM",33.361604,-104.469837,64629
7955,40740,25-29,2006,2068,4074,"Roswell, NM",33.361604,-104.469837,64629
7956,40740,30-34,2100,2103,4203,"Roswell, NM",33.361604,-104.469837,64629
7957,40740,35-39,2125,2099,4224,"Roswell, NM",33.361604,-104.469837,64629
7958,40740,40-44,2025,2010,4035,"Roswell, NM",33.361604,-104.469837,64629
7959,40740,45-49,1762,1668,3430,"Roswell, NM",33.361604,-104.469837,64629
7960,40740,50-54,1735,1748,3483,"Roswell, NM",33.361604,-104.469837,64629
7961,40740,55-59,2006,1859,3865,"Roswell, NM",33.361604,-104.469837,64629
7962,40740,60-64,1999,1933,3932,"Roswell, NM",33.361604,-104.469837,64629
7963,40740,65+,5576,4760,10336,"Roswell, NM",33.361604,-104.469837,64629
7964,40760,15-19,505,572,1077,"Ruidoso, NM",33.740841,-105.449805,20436
7965,40760,20-24,400,429,829,"Ruidoso, NM",33.740841,-105.449805,20436
7966,40760,25-29,396,460,856,"Ruidoso, NM",33.740841,-105.449805,20436
7967,40760,30-34,484,460,944,"Ruidoso, NM",33.740841,-105.449805,20436
7968,40760,35-39,613,487,1100,"Ruidoso, NM",33.740841,-105.449805,20436
7969,40760,40-44,523,464,987,"Ruidoso, NM",33.740841,-105.449805,20436
7970,40760,45-49,459,474,933,"Ruidoso, NM",33.740841,-105.449805,20436
7971,40760,50-54,534,531,1065,"Ruidoso, NM",33.740841,-105.449805,20436
7972,40760,55-59,785,720,1505,"Ruidoso, NM",33.740841,-105.449805,20436
7973,40760,60-64,1005,818,1823,"Ruidoso, NM",33.740841,-105.449805,20436
7974,40760,65+,3236,3036,6272,"Ruidoso, NM",33.740841,-105.449805,20436
7975,40780,15-19,3128,3329,6457,"Russellville, AR",35.199586,-93.252763,83944
7976,40780,20-24,3096,3280,6376,"Russellville, AR",35.199586,-93.252763,83944
7977,40780,25-29,2645,2700,5345,"Russellville, AR",35.199586,-93.252763,83944
7978,40780,30-34,2732,2772,5504,"Russellville, AR",35.199586,-93.252763,83944
7979,40780,35-39,2433,2542,4975,"Russellville, AR",35.199586,-93.252763,83944
7980,40780,40-44,2298,2419,4717,"Russellville, AR",35.199586,-93.252763,83944
7981,40780,45-49,2363,2429,4792,"Russellville, AR",35.199586,-93.252763,83944
7982,40780,50-54,2511,2485,4996,"Russellville, AR",35.199586,-93.252763,83944
7983,40780,55-59,2775,2741,5516,"Russellville, AR",35.199586,-93.252763,83944
7984,40780,60-64,2566,2636,5202,"Russellville, AR",35.199586,-93.252763,83944
7985,40780,65+,7677,6344,14021,"Russellville, AR",35.199586,-93.252763,83944
7986,40820,15-19,2576,2530,5106,"Ruston, LA",32.601823,-92.662303,48152
7987,40820,20-24,4308,4327,8635,"Ruston, LA",32.601823,-92.662303,48152
7988,40820,25-29,1503,1595,3098,"Ruston, LA",32.601823,-92.662303,48152
7989,40820,30-34,1266,1242,2508,"Ruston, LA",32.601823,-92.662303,48152
7990,40820,35-39,1320,1290,2610,"Ruston, LA",32.601823,-92.662303,48152
7991,40820,40-44,1269,1264,2533,"Ruston, LA",32.601823,-92.662303,48152
7992,40820,45-49,1082,1036,2118,"Ruston, LA",32.601823,-92.662303,48152
7993,40820,50-54,1087,1088,2175,"Ruston, LA",32.601823,-92.662303,48152
7994,40820,55-59,1237,1082,2319,"Ruston, LA",32.601823,-92.662303,48152
7995,40820,60-64,1228,1120,2348,"Ruston, LA",32.601823,-92.662303,48152
7996,40820,65+,3873,3024,6897,"Ruston, LA",32.601823,-92.662303,48152
7997,40860,15-19,1847,1922,3769,"Rutland, VT",43.580858,-73.038202,60591
7998,40860,20-24,1735,1872,3607,"Rutland, VT",43.580858,-73.038202,60591
7999,40860,25-29,1528,1696,3224,"Rutland, VT",43.580858,-73.038202,60591
8000,40860,30-34,1614,1770,3384,"Rutland, VT",43.580858,-73.038202,60591
8001,40860,35-39,1711,1706,3417,"Rutland, VT",43.580858,-73.038202,60591
8002,40860,40-44,1599,1599,3198,"Rutland, VT",43.580858,-73.038202,60591
8003,40860,45-49,1597,1612,3209,"Rutland, VT",43.580858,-73.038202,60591
8004,40860,50-54,2005,2019,4024,"Rutland, VT",43.580858,-73.038202,60591
8005,40860,55-59,2411,2390,4801,"Rutland, VT",43.580858,-73.038202,60591
8006,40860,60-64,2650,2480,5130,"Rutland, VT",43.580858,-73.038202,60591
8007,40860,65+,7566,6741,14307,"Rutland, VT",43.580858,-73.038202,60591
8008,40900,15-19,78226,80354,158580,"Sacramento-Roseville-Folsom, CA",38.790272,-121.005643,2411428
8009,40900,20-24,76859,76611,153470,"Sacramento-Roseville-Folsom, CA",38.790272,-121.005643,2411428
8010,40900,25-29,80905,81745,162650,"Sacramento-Roseville-Folsom, CA",38.790272,-121.005643,2411428
8011,40900,30-34,87958,88866,176824,"Sacramento-Roseville-Folsom, CA",38.790272,-121.005643,2411428
8012,40900,35-39,86021,86844,172865,"Sacramento-Roseville-Folsom, CA",38.790272,-121.005643,2411428
8013,40900,40-44,79682,79942,159624,"Sacramento-Roseville-Folsom, CA",38.790272,-121.005643,2411428
8014,40900,45-49,72570,71596,144166,"Sacramento-Roseville-Folsom, CA",38.790272,-121.005643,2411428
8015,40900,50-54,75367,73734,149101,"Sacramento-Roseville-Folsom, CA",38.790272,-121.005643,2411428
8016,40900,55-59,76916,73598,150514,"Sacramento-Roseville-Folsom, CA",38.790272,-121.005643,2411428
8017,40900,60-64,77259,71421,148680,"Sacramento-Roseville-Folsom, CA",38.790272,-121.005643,2411428
8018,40900,65+,214976,174060,389036,"Sacramento-Roseville-Folsom, CA",38.790272,-121.005643,2411428
8019,40940,15-19,1408,1548,2956,"Safford, AZ",32.931828,-109.87831,39050
8020,40940,20-24,1192,1593,2785,"Safford, AZ",32.931828,-109.87831,39050
8021,40940,25-29,1144,1662,2806,"Safford, AZ",32.931828,-109.87831,39050
8022,40940,30-34,1197,1705,2902,"Safford, AZ",32.931828,-109.87831,39050
8023,40940,35-39,1048,1595,2643,"Safford, AZ",32.931828,-109.87831,39050
8024,40940,40-44,1130,1527,2657,"Safford, AZ",32.931828,-109.87831,39050
8025,40940,45-49,957,1283,2240,"Safford, AZ",32.931828,-109.87831,39050
8026,40940,50-54,920,1134,2054,"Safford, AZ",32.931828,-109.87831,39050
8027,40940,55-59,946,1049,1995,"Safford, AZ",32.931828,-109.87831,39050
8028,40940,60-64,999,966,1965,"Safford, AZ",32.931828,-109.87831,39050
8029,40940,65+,2939,2571,5510,"Safford, AZ",32.931828,-109.87831,39050
8030,40980,15-19,6221,6501,12722,"Saginaw, MI",43.328267,-84.05541,189591
8031,40980,20-24,6022,6003,12025,"Saginaw, MI",43.328267,-84.05541,189591
8032,40980,25-29,6057,6217,12274,"Saginaw, MI",43.328267,-84.05541,189591
8033,40980,30-34,5979,5889,11868,"Saginaw, MI",43.328267,-84.05541,189591
8034,40980,35-39,5190,5309,10499,"Saginaw, MI",43.328267,-84.05541,189591
8035,40980,40-44,5359,5361,10720,"Saginaw, MI",43.328267,-84.05541,189591
8036,40980,45-49,5342,5035,10377,"Saginaw, MI",43.328267,-84.05541,189591
8037,40980,50-54,5936,5773,11709,"Saginaw, MI",43.328267,-84.05541,189591
8038,40980,55-59,6486,6333,12819,"Saginaw, MI",43.328267,-84.05541,189591
8039,40980,60-64,6954,6362,13316,"Saginaw, MI",43.328267,-84.05541,189591
8040,40980,65+,20985,16728,37713,"Saginaw, MI",43.328267,-84.05541,189591
8041,41060,15-19,7780,7663,15443,"St. Cloud, MN",45.593031,-94.488363,200406
8042,41060,20-24,9167,9539,18706,"St. Cloud, MN",45.593031,-94.488363,200406
8043,41060,25-29,6051,6666,12717,"St. Cloud, MN",45.593031,-94.488363,200406
8044,41060,30-34,5844,6304,12148,"St. Cloud, MN",45.593031,-94.488363,200406
8045,41060,35-39,6049,6708,12757,"St. Cloud, MN",45.593031,-94.488363,200406
8046,41060,40-44,5777,6209,11986,"St. Cloud, MN",45.593031,-94.488363,200406
8047,41060,45-49,4893,5241,10134,"St. Cloud, MN",45.593031,-94.488363,200406
8048,41060,50-54,5560,5729,11289,"St. Cloud, MN",45.593031,-94.488363,200406
8049,41060,55-59,6114,6348,12462,"St. Cloud, MN",45.593031,-94.488363,200406
8050,41060,60-64,5970,6082,12052,"St. Cloud, MN",45.593031,-94.488363,200406
8051,41060,65+,16465,14497,30962,"St. Cloud, MN",45.593031,-94.488363,200406
8052,41100,15-19,6758,7239,13997,"St. George, UT",37.262531,-113.4878,191226
8053,41100,20-24,6012,6205,12217,"St. George, UT",37.262531,-113.4878,191226
8054,41100,25-29,5477,5699,11176,"St. George, UT",37.262531,-113.4878,191226
8055,41100,30-34,5335,5185,10520,"St. George, UT",37.262531,-113.4878,191226
8056,41100,35-39,5803,5685,11488,"St. George, UT",37.262531,-113.4878,191226
8057,41100,40-44,5710,5978,11688,"St. George, UT",37.262531,-113.4878,191226
8058,41100,45-49,4800,4890,9690,"St. George, UT",37.262531,-113.4878,191226
8059,41100,50-54,4586,4612,9198,"St. George, UT",37.262531,-113.4878,191226
8060,41100,55-59,4869,4354,9223,"St. George, UT",37.262531,-113.4878,191226
8061,41100,60-64,6028,5093,11121,"St. George, UT",37.262531,-113.4878,191226
8062,41100,65+,21831,20371,42202,"St. George, UT",37.262531,-113.4878,191226
8063,41140,15-19,3736,4006,7742,"St. Joseph, MO-KS",39.834843,-94.783754,120424
8064,41140,20-24,3397,4056,7453,"St. Joseph, MO-KS",39.834843,-94.783754,120424
8065,41140,25-29,3451,4119,7570,"St. Joseph, MO-KS",39.834843,-94.783754,120424
8066,41140,30-34,3637,4284,7921,"St. Joseph, MO-KS",39.834843,-94.783754,120424
8067,41140,35-39,3554,4316,7870,"St. Joseph, MO-KS",39.834843,-94.783754,120424
8068,41140,40-44,3516,4079,7595,"St. Joseph, MO-KS",39.834843,-94.783754,120424
8069,41140,45-49,3200,3776,6976,"St. Joseph, MO-KS",39.834843,-94.783754,120424
8070,41140,50-54,3505,3812,7317,"St. Joseph, MO-KS",39.834843,-94.783754,120424
8071,41140,55-59,4017,4047,8064,"St. Joseph, MO-KS",39.834843,-94.783754,120424
8072,41140,60-64,4069,4145,8214,"St. Joseph, MO-KS",39.834843,-94.783754,120424
8073,41140,65+,11817,9741,21558,"St. Joseph, MO-KS",39.834843,-94.783754,120424
8074,41180,15-19,84303,88442,172745,"St. Louis, MO-IL",38.740211,-90.345825,2809299
8075,41180,20-24,80697,81103,161800,"St. Louis, MO-IL",38.740211,-90.345825,2809299
8076,41180,25-29,92077,91392,183469,"St. Louis, MO-IL",38.740211,-90.345825,2809299
8077,41180,30-34,97380,93717,191097,"St. Louis, MO-IL",38.740211,-90.345825,2809299
8078,41180,35-39,96504,95157,191661,"St. Louis, MO-IL",38.740211,-90.345825,2809299
8079,41180,40-44,90714,88438,179152,"St. Louis, MO-IL",38.740211,-90.345825,2809299
8080,41180,45-49,82895,79169,162064,"St. Louis, MO-IL",38.740211,-90.345825,2809299
8081,41180,50-54,89040,85252,174292,"St. Louis, MO-IL",38.740211,-90.345825,2809299
8082,41180,55-59,98990,94055,193045,"St. Louis, MO-IL",38.740211,-90.345825,2809299
8083,41180,60-64,102274,96380,198654,"St. Louis, MO-IL",38.740211,-90.345825,2809299
8084,41180,65+,274937,217560,492497,"St. Louis, MO-IL",38.740211,-90.345825,2809299
8085,41220,15-19,1521,1857,3378,"St. Marys, GA",30.913358,-81.642019,55664
8086,41220,20-24,1715,3043,4758,"St. Marys, GA",30.913358,-81.642019,55664
8087,41220,25-29,2039,2499,4538,"St. Marys, GA",30.913358,-81.642019,55664
8088,41220,30-34,2159,2235,4394,"St. Marys, GA",30.913358,-81.642019,55664
8089,41220,35-39,1906,1988,3894,"St. Marys, GA",30.913358,-81.642019,55664
8090,41220,40-44,1444,1531,2975,"St. Marys, GA",30.913358,-81.642019,55664
8091,41220,45-49,1342,1258,2600,"St. Marys, GA",30.913358,-81.642019,55664
8092,41220,50-54,1519,1437,2956,"St. Marys, GA",30.913358,-81.642019,55664
8093,41220,55-59,1687,1556,3243,"St. Marys, GA",30.913358,-81.642019,55664
8094,41220,60-64,1711,1581,3292,"St. Marys, GA",30.913358,-81.642019,55664
8095,41220,65+,4320,3875,8195,"St. Marys, GA",30.913358,-81.642019,55664
8096,41260,15-19,793,869,1662,"St. Marys, PA",41.427332,-78.653937,30783
8097,41260,20-24,760,799,1559,"St. Marys, PA",41.427332,-78.653937,30783
8098,41260,25-29,757,864,1621,"St. Marys, PA",41.427332,-78.653937,30783
8099,41260,30-34,689,774,1463,"St. Marys, PA",41.427332,-78.653937,30783
8100,41260,35-39,778,867,1645,"St. Marys, PA",41.427332,-78.653937,30783
8101,41260,40-44,778,806,1584,"St. Marys, PA",41.427332,-78.653937,30783
8102,41260,45-49,878,867,1745,"St. Marys, PA",41.427332,-78.653937,30783
8103,41260,50-54,1126,1198,2324,"St. Marys, PA",41.427332,-78.653937,30783
8104,41260,55-59,1253,1304,2557,"St. Marys, PA",41.427332,-78.653937,30783
8105,41260,60-64,1236,1430,2666,"St. Marys, PA",41.427332,-78.653937,30783
8106,41260,65+,3753,3331,7084,"St. Marys, PA",41.427332,-78.653937,30783
8107,41400,15-19,2715,2993,5708,"Salem, OH",40.770073,-80.778455,101310
8108,41400,20-24,2496,2747,5243,"Salem, OH",40.770073,-80.778455,101310
8109,41400,25-29,2625,3103,5728,"Salem, OH",40.770073,-80.778455,101310
8110,41400,30-34,2752,3152,5904,"Salem, OH",40.770073,-80.778455,101310
8111,41400,35-39,2675,3269,5944,"Salem, OH",40.770073,-80.778455,101310
8112,41400,40-44,2731,3301,6032,"Salem, OH",40.770073,-80.778455,101310
8113,41400,45-49,2884,3271,6155,"Salem, OH",40.770073,-80.778455,101310
8114,41400,50-54,3182,3549,6731,"Salem, OH",40.770073,-80.778455,101310
8115,41400,55-59,3587,3664,7251,"Salem, OH",40.770073,-80.778455,101310
8116,41400,60-64,4037,4056,8093,"Salem, OH",40.770073,-80.778455,101310
8117,41400,65+,11722,9913,21635,"Salem, OH",40.770073,-80.778455,101310
8118,41420,15-19,14667,15506,30173,"Salem, OR",44.903385,-122.901757,436283
8119,41420,20-24,14553,15352,29905,"Salem, OR",44.903385,-122.901757,436283
8120,41420,25-29,14412,15591,30003,"Salem, OR",44.903385,-122.901757,436283
8121,41420,30-34,14727,15448,30175,"Salem, OR",44.903385,-122.901757,436283
8122,41420,35-39,14222,15006,29228,"Salem, OR",44.903385,-122.901757,436283
8123,41420,40-44,13626,14434,28060,"Salem, OR",44.903385,-122.901757,436283
8124,41420,45-49,12268,12737,25005,"Salem, OR",44.903385,-122.901757,436283
8125,41420,50-54,12481,12965,25446,"Salem, OR",44.903385,-122.901757,436283
8126,41420,55-59,12470,12540,25010,"Salem, OR",44.903385,-122.901757,436283
8127,41420,60-64,13300,12402,25702,"Salem, OR",44.903385,-122.901757,436283
8128,41420,65+,39897,33052,72949,"Salem, OR",44.903385,-122.901757,436283
8129,41460,15-19,1801,2139,3940,"Salina, KS",38.96457,-97.663387,59726
8130,41460,20-24,1743,1944,3687,"Salina, KS",38.96457,-97.663387,59726
8131,41460,25-29,1731,1918,3649,"Salina, KS",38.96457,-97.663387,59726
8132,41460,30-34,1741,1806,3547,"Salina, KS",38.96457,-97.663387,59726
8133,41460,35-39,1768,1845,3613,"Salina, KS",38.96457,-97.663387,59726
8134,41460,40-44,1723,1798,3521,"Salina, KS",38.96457,-97.663387,59726
8135,41460,45-49,1612,1543,3155,"Salina, KS",38.96457,-97.663387,59726
8136,41460,50-54,1777,1930,3707,"Salina, KS",38.96457,-97.663387,59726
8137,41460,55-59,2020,1973,3993,"Salina, KS",38.96457,-97.663387,59726
8138,41460,60-64,2124,2126,4250,"Salina, KS",38.96457,-97.663387,59726
8139,41460,65+,6185,5200,11385,"Salina, KS",38.96457,-97.663387,59726
8140,41500,15-19,16078,16533,32611,"Salinas, CA",36.240104,-121.315578,437325
8141,41500,20-24,14144,15107,29251,"Salinas, CA",36.240104,-121.315578,437325
8142,41500,25-29,14241,15246,29487,"Salinas, CA",36.240104,-121.315578,437325
8143,41500,30-34,14184,16349,30533,"Salinas, CA",36.240104,-121.315578,437325
8144,41500,35-39,14031,16177,30208,"Salinas, CA",36.240104,-121.315578,437325
8145,41500,40-44,13188,15412,28600,"Salinas, CA",36.240104,-121.315578,437325
8146,41500,45-49,12009,13802,25811,"Salinas, CA",36.240104,-121.315578,437325
8147,41500,50-54,11988,13465,25453,"Salinas, CA",36.240104,-121.315578,437325
8148,41500,55-59,11856,12437,24293,"Salinas, CA",36.240104,-121.315578,437325
8149,41500,60-64,12228,11777,24005,"Salinas, CA",36.240104,-121.315578,437325
8150,41500,65+,33992,29345,63337,"Salinas, CA",36.240104,-121.315578,437325
8151,41540,15-19,12737,12573,25310,"Salisbury, MD-DE",38.399521,-75.478262,429223
8152,41540,20-24,13139,13081,26220,"Salisbury, MD-DE",38.399521,-75.478262,429223
8153,41540,25-29,11068,11681,22749,"Salisbury, MD-DE",38.399521,-75.478262,429223
8154,41540,30-34,11227,11098,22325,"Salisbury, MD-DE",38.399521,-75.478262,429223
8155,41540,35-39,11077,11228,22305,"Salisbury, MD-DE",38.399521,-75.478262,429223
8156,41540,40-44,10711,10754,21465,"Salisbury, MD-DE",38.399521,-75.478262,429223
8157,41540,45-49,10589,10193,20782,"Salisbury, MD-DE",38.399521,-75.478262,429223
8158,41540,50-54,12614,12130,24744,"Salisbury, MD-DE",38.399521,-75.478262,429223
8159,41540,55-59,16187,14555,30742,"Salisbury, MD-DE",38.399521,-75.478262,429223
8160,41540,60-64,19120,16528,35648,"Salisbury, MD-DE",38.399521,-75.478262,429223
8161,41540,65+,59176,50859,110035,"Salisbury, MD-DE",38.399521,-75.478262,429223
8162,41620,15-19,44416,47171,91587,"Salt Lake City, UT",40.572887,-112.953253,1263061
8163,41620,20-24,43218,44863,88081,"Salt Lake City, UT",40.572887,-112.953253,1263061
8164,41620,25-29,50471,52570,103041,"Salt Lake City, UT",40.572887,-112.953253,1263061
8165,41620,30-34,49533,51688,101221,"Salt Lake City, UT",40.572887,-112.953253,1263061
8166,41620,35-39,46804,48913,95717,"Salt Lake City, UT",40.572887,-112.953253,1263061
8167,41620,40-44,45471,48228,93699,"Salt Lake City, UT",40.572887,-112.953253,1263061
8168,41620,45-49,37466,40114,77580,"Salt Lake City, UT",40.572887,-112.953253,1263061
8169,41620,50-54,33673,35978,69651,"Salt Lake City, UT",40.572887,-112.953253,1263061
8170,41620,55-59,31609,31988,63597,"Salt Lake City, UT",40.572887,-112.953253,1263061
8171,41620,60-64,31071,30290,61361,"Salt Lake City, UT",40.572887,-112.953253,1263061
8172,41620,65+,77773,67322,145095,"Salt Lake City, UT",40.572887,-112.953253,1263061
8173,41660,15-19,4553,4861,9414,"San Angelo, TX",31.479839,-100.77459,122344
8174,41660,20-24,4405,4993,9398,"San Angelo, TX",31.479839,-100.77459,122344
8175,41660,25-29,4164,4493,8657,"San Angelo, TX",31.479839,-100.77459,122344
8176,41660,30-34,4335,4612,8947,"San Angelo, TX",31.479839,-100.77459,122344
8177,41660,35-39,4152,4473,8625,"San Angelo, TX",31.479839,-100.77459,122344
8178,41660,40-44,3540,3640,7180,"San Angelo, TX",31.479839,-100.77459,122344
8179,41660,45-49,2959,2946,5905,"San Angelo, TX",31.479839,-100.77459,122344
8180,41660,50-54,3143,3128,6271,"San Angelo, TX",31.479839,-100.77459,122344
8181,41660,55-59,3545,3236,6781,"San Angelo, TX",31.479839,-100.77459,122344
8182,41660,60-64,3684,3341,7025,"San Angelo, TX",31.479839,-100.77459,122344
8183,41660,65+,10709,9009,19718,"San Angelo, TX",31.479839,-100.77459,122344
8184,41700,15-19,90314,95098,185412,"San Antonio-New Braunfels, TX",29.43306,-98.606973,2601788
8185,41700,20-24,86915,91680,178595,"San Antonio-New Braunfels, TX",29.43306,-98.606973,2601788
8186,41700,25-29,92440,96554,188994,"San Antonio-New Braunfels, TX",29.43306,-98.606973,2601788
8187,41700,30-34,95280,98888,194168,"San Antonio-New Braunfels, TX",29.43306,-98.606973,2601788
8188,41700,35-39,93842,97425,191267,"San Antonio-New Braunfels, TX",29.43306,-98.606973,2601788
8189,41700,40-44,86784,88241,175025,"San Antonio-New Braunfels, TX",29.43306,-98.606973,2601788
8190,41700,45-49,80801,79437,160238,"San Antonio-New Braunfels, TX",29.43306,-98.606973,2601788
8191,41700,50-54,77596,76351,153947,"San Antonio-New Braunfels, TX",29.43306,-98.606973,2601788
8192,41700,55-59,76878,74180,151058,"San Antonio-New Braunfels, TX",29.43306,-98.606973,2601788
8193,41700,60-64,73033,67590,140623,"San Antonio-New Braunfels, TX",29.43306,-98.606973,2601788
8194,41700,65+,194742,157231,351973,"San Antonio-New Braunfels, TX",29.43306,-98.606973,2601788
8195,41740,15-19,98554,107561,206115,"San Diego-Chula Vista-Carlsbad, CA",33.023604,-116.776117,3286069
8196,41740,20-24,103915,128970,232885,"San Diego-Chula Vista-Carlsbad, CA",33.023604,-116.776117,3286069
8197,41740,25-29,121699,135266,256965,"San Diego-Chula Vista-Carlsbad, CA",33.023604,-116.776117,3286069
8198,41740,30-34,130214,140563,270777,"San Diego-Chula Vista-Carlsbad, CA",33.023604,-116.776117,3286069
8199,41740,35-39,117877,128847,246724,"San Diego-Chula Vista-Carlsbad, CA",33.023604,-116.776117,3286069
8200,41740,40-44,105804,111994,217798,"San Diego-Chula Vista-Carlsbad, CA",33.023604,-116.776117,3286069
8201,41740,45-49,97519,99587,197106,"San Diego-Chula Vista-Carlsbad, CA",33.023604,-116.776117,3286069
8202,41740,50-54,99404,100566,199970,"San Diego-Chula Vista-Carlsbad, CA",33.023604,-116.776117,3286069
8203,41740,55-59,99273,98749,198022,"San Diego-Chula Vista-Carlsbad, CA",33.023604,-116.776117,3286069
8204,41740,60-64,96180,93635,189815,"San Diego-Chula Vista-Carlsbad, CA",33.023604,-116.776117,3286069
8205,41740,65+,267741,221360,489101,"San Diego-Chula Vista-Carlsbad, CA",33.023604,-116.776117,3286069
8206,41760,15-19,1229,1409,2638,"Sandpoint, ID",48.316796,-116.612362,49491
8207,41760,20-24,950,991,1941,"Sandpoint, ID",48.316796,-116.612362,49491
8208,41760,25-29,1058,1129,2187,"Sandpoint, ID",48.316796,-116.612362,49491
8209,41760,30-34,1314,1279,2593,"Sandpoint, ID",48.316796,-116.612362,49491
8210,41760,35-39,1297,1441,2738,"Sandpoint, ID",48.316796,-116.612362,49491
8211,41760,40-44,1519,1455,2974,"Sandpoint, ID",48.316796,-116.612362,49491
8212,41760,45-49,1362,1337,2699,"Sandpoint, ID",48.316796,-116.612362,49491
8213,41760,50-54,1490,1491,2981,"Sandpoint, ID",48.316796,-116.612362,49491
8214,41760,55-59,1794,1760,3554,"Sandpoint, ID",48.316796,-116.612362,49491
8215,41760,60-64,2249,2203,4452,"Sandpoint, ID",48.316796,-116.612362,49491
8216,41760,65+,6301,6524,12825,"Sandpoint, ID",48.316796,-116.612362,49491
8217,41780,15-19,2086,2254,4340,"Sandusky, OH",41.394143,-82.586835,74852
8218,41780,20-24,2016,2105,4121,"Sandusky, OH",41.394143,-82.586835,74852
8219,41780,25-29,2103,2259,4362,"Sandusky, OH",41.394143,-82.586835,74852
8220,41780,30-34,2138,2149,4287,"Sandusky, OH",41.394143,-82.586835,74852
8221,41780,35-39,2113,2047,4160,"Sandusky, OH",41.394143,-82.586835,74852
8222,41780,40-44,2097,1947,4044,"Sandusky, OH",41.394143,-82.586835,74852
8223,41780,45-49,1998,2003,4001,"Sandusky, OH",41.394143,-82.586835,74852
8224,41780,50-54,2528,2329,4857,"Sandusky, OH",41.394143,-82.586835,74852
8225,41780,55-59,2706,2621,5327,"Sandusky, OH",41.394143,-82.586835,74852
8226,41780,60-64,3073,2852,5925,"Sandusky, OH",41.394143,-82.586835,74852
8227,41780,65+,9227,7948,17175,"Sandusky, OH",41.394143,-82.586835,74852
8228,41820,15-19,1967,2185,4152,"Sanford, NC",35.476336,-79.172117,64138
8229,41820,20-24,1804,1838,3642,"Sanford, NC",35.476336,-79.172117,64138
8230,41820,25-29,2032,2013,4045,"Sanford, NC",35.476336,-79.172117,64138
8231,41820,30-34,2110,2057,4167,"Sanford, NC",35.476336,-79.172117,64138
8232,41820,35-39,1951,1935,3886,"Sanford, NC",35.476336,-79.172117,64138
8233,41820,40-44,1994,2020,4014,"Sanford, NC",35.476336,-79.172117,64138
8234,41820,45-49,1910,1822,3732,"Sanford, NC",35.476336,-79.172117,64138
8235,41820,50-54,2148,2169,4317,"Sanford, NC",35.476336,-79.172117,64138
8236,41820,55-59,2257,2172,4429,"Sanford, NC",35.476336,-79.172117,64138
8237,41820,60-64,2144,2043,4187,"Sanford, NC",35.476336,-79.172117,64138
8238,41820,65+,6071,4920,10991,"Sanford, NC",35.476336,-79.172117,64138
8239,41860,15-19,127999,131431,259430,"San Francisco-Oakland-Berkeley, CA",37.773718,-122.274432,4623264
8240,41860,20-24,120567,121532,242099,"San Francisco-Oakland-Berkeley, CA",37.773718,-122.274432,4623264
8241,41860,25-29,156097,161590,317687,"San Francisco-Oakland-Berkeley, CA",37.773718,-122.274432,4623264
8242,41860,30-34,184918,193371,378289,"San Francisco-Oakland-Berkeley, CA",37.773718,-122.274432,4623264
8243,41860,35-39,178228,187080,365308,"San Francisco-Oakland-Berkeley, CA",37.773718,-122.274432,4623264
8244,41860,40-44,162943,167020,329963,"San Francisco-Oakland-Berkeley, CA",37.773718,-122.274432,4623264
8245,41860,45-49,152886,156086,308972,"San Francisco-Oakland-Berkeley, CA",37.773718,-122.274432,4623264
8246,41860,50-54,154951,160688,315639,"San Francisco-Oakland-Berkeley, CA",37.773718,-122.274432,4623264
8247,41860,55-59,152261,154249,306510,"San Francisco-Oakland-Berkeley, CA",37.773718,-122.274432,4623264
8248,41860,60-64,144100,141025,285125,"San Francisco-Oakland-Berkeley, CA",37.773718,-122.274432,4623264
8249,41860,65+,425703,347007,772710,"San Francisco-Oakland-Berkeley, CA",37.773718,-122.274432,4623264
8250,41940,15-19,59545,62672,122217,"San Jose-Sunnyvale-Santa Clara, CA",36.908472,-121.371372,1952185
8251,41940,20-24,55107,58916,114023,"San Jose-Sunnyvale-Santa Clara, CA",36.908472,-121.371372,1952185
8252,41940,25-29,67400,78313,145713,"San Jose-Sunnyvale-Santa Clara, CA",36.908472,-121.371372,1952185
8253,41940,30-34,74051,86592,160643,"San Jose-Sunnyvale-Santa Clara, CA",36.908472,-121.371372,1952185
8254,41940,35-39,70470,79568,150038,"San Jose-Sunnyvale-Santa Clara, CA",36.908472,-121.371372,1952185
8255,41940,40-44,65288,68952,134240,"San Jose-Sunnyvale-Santa Clara, CA",36.908472,-121.371372,1952185
8256,41940,45-49,64707,66944,131651,"San Jose-Sunnyvale-Santa Clara, CA",36.908472,-121.371372,1952185
8257,41940,50-54,64731,67147,131878,"San Jose-Sunnyvale-Santa Clara, CA",36.908472,-121.371372,1952185
8258,41940,55-59,61362,64857,126219,"San Jose-Sunnyvale-Santa Clara, CA",36.908472,-121.371372,1952185
8259,41940,60-64,55696,57181,112877,"San Jose-Sunnyvale-Santa Clara, CA",36.908472,-121.371372,1952185
8260,41940,65+,153722,128009,281731,"San Jose-Sunnyvale-Santa Clara, CA",36.908472,-121.371372,1952185
8261,42020,15-19,10721,11427,22148,"San Luis Obispo-Paso Robles, CA",35.388189,-120.448897,283159
8262,42020,20-24,13081,15639,28720,"San Luis Obispo-Paso Robles, CA",35.388189,-120.448897,283159
8263,42020,25-29,7432,8319,15751,"San Luis Obispo-Paso Robles, CA",35.388189,-120.448897,283159
8264,42020,30-34,7424,8608,16032,"San Luis Obispo-Paso Robles, CA",35.388189,-120.448897,283159
8265,42020,35-39,8004,8898,16902,"San Luis Obispo-Paso Robles, CA",35.388189,-120.448897,283159
8266,42020,40-44,7592,8816,16408,"San Luis Obispo-Paso Robles, CA",35.388189,-120.448897,283159
8267,42020,45-49,6640,7594,14234,"San Luis Obispo-Paso Robles, CA",35.388189,-120.448897,283159
8268,42020,50-54,7338,8082,15420,"San Luis Obispo-Paso Robles, CA",35.388189,-120.448897,283159
8269,42020,55-59,8616,8379,16995,"San Luis Obispo-Paso Robles, CA",35.388189,-120.448897,283159
8270,42020,60-64,10294,9210,19504,"San Luis Obispo-Paso Robles, CA",35.388189,-120.448897,283159
8271,42020,65+,32398,28220,60618,"San Luis Obispo-Paso Robles, CA",35.388189,-120.448897,283159
8272,42100,15-19,11368,10848,22216,"Santa Cruz-Watsonville, CA",37.012347,-122.007789,267792
8273,42100,20-24,13125,12994,26119,"Santa Cruz-Watsonville, CA",37.012347,-122.007789,267792
8274,42100,25-29,7899,8353,16252,"Santa Cruz-Watsonville, CA",37.012347,-122.007789,267792
8275,42100,30-34,7613,8112,15725,"Santa Cruz-Watsonville, CA",37.012347,-122.007789,267792
8276,42100,35-39,7926,8133,16059,"Santa Cruz-Watsonville, CA",37.012347,-122.007789,267792
8277,42100,40-44,7975,7963,15938,"Santa Cruz-Watsonville, CA",37.012347,-122.007789,267792
8278,42100,45-49,7476,7678,15154,"Santa Cruz-Watsonville, CA",37.012347,-122.007789,267792
8279,42100,50-54,8153,8484,16637,"Santa Cruz-Watsonville, CA",37.012347,-122.007789,267792
8280,42100,55-59,8487,8219,16706,"Santa Cruz-Watsonville, CA",37.012347,-122.007789,267792
8281,42100,60-64,8944,8534,17478,"Santa Cruz-Watsonville, CA",37.012347,-122.007789,267792
8282,42100,65+,26063,22872,48935,"Santa Cruz-Watsonville, CA",37.012347,-122.007789,267792
8283,42140,15-19,4276,4171,8447,"Santa Fe, NM",35.514531,-105.963972,155201
8284,42140,20-24,3811,4011,7822,"Santa Fe, NM",35.514531,-105.963972,155201
8285,42140,25-29,4040,4139,8179,"Santa Fe, NM",35.514531,-105.963972,155201
8286,42140,30-34,4371,4478,8849,"Santa Fe, NM",35.514531,-105.963972,155201
8287,42140,35-39,4529,4822,9351,"Santa Fe, NM",35.514531,-105.963972,155201
8288,42140,40-44,4384,4512,8896,"Santa Fe, NM",35.514531,-105.963972,155201
8289,42140,45-49,4319,4297,8616,"Santa Fe, NM",35.514531,-105.963972,155201
8290,42140,50-54,4830,4793,9623,"Santa Fe, NM",35.514531,-105.963972,155201
8291,42140,55-59,5693,5161,10854,"Santa Fe, NM",35.514531,-105.963972,155201
8292,42140,60-64,6597,5745,12342,"Santa Fe, NM",35.514531,-105.963972,155201
8293,42140,65+,22360,18968,41328,"Santa Fe, NM",35.514531,-105.963972,155201
8294,42200,15-19,19009,18219,37228,"Santa Maria-Santa Barbara, CA",34.536677,-120.038364,446475
8295,42200,20-24,23605,24019,47624,"Santa Maria-Santa Barbara, CA",34.536677,-120.038364,446475
8296,42200,25-29,14934,16445,31379,"Santa Maria-Santa Barbara, CA",34.536677,-120.038364,446475
8297,42200,30-34,13308,14968,28276,"Santa Maria-Santa Barbara, CA",34.536677,-120.038364,446475
8298,42200,35-39,12802,14356,27158,"Santa Maria-Santa Barbara, CA",34.536677,-120.038364,446475
8299,42200,40-44,11904,13005,24909,"Santa Maria-Santa Barbara, CA",34.536677,-120.038364,446475
8300,42200,45-49,11030,11676,22706,"Santa Maria-Santa Barbara, CA",34.536677,-120.038364,446475
8301,42200,50-54,11532,12100,23632,"Santa Maria-Santa Barbara, CA",34.536677,-120.038364,446475
8302,42200,55-59,12390,12250,24640,"Santa Maria-Santa Barbara, CA",34.536677,-120.038364,446475
8303,42200,60-64,12691,12230,24921,"Santa Maria-Santa Barbara, CA",34.536677,-120.038364,446475
8304,42200,65+,38694,32703,71397,"Santa Maria-Santa Barbara, CA",34.536677,-120.038364,446475
8305,42220,15-19,14574,14870,29444,"Santa Rosa-Petaluma, CA",38.525182,-122.92611,485887
8306,42220,20-24,13005,13244,26249,"Santa Rosa-Petaluma, CA",38.525182,-122.92611,485887
8307,42220,25-29,14090,14687,28777,"Santa Rosa-Petaluma, CA",38.525182,-122.92611,485887
8308,42220,30-34,15402,16141,31543,"Santa Rosa-Petaluma, CA",38.525182,-122.92611,485887
8309,42220,35-39,16029,16492,32521,"Santa Rosa-Petaluma, CA",38.525182,-122.92611,485887
8310,42220,40-44,15572,15912,31484,"Santa Rosa-Petaluma, CA",38.525182,-122.92611,485887
8311,42220,45-49,14064,14484,28548,"Santa Rosa-Petaluma, CA",38.525182,-122.92611,485887
8312,42220,50-54,15606,15712,31318,"Santa Rosa-Petaluma, CA",38.525182,-122.92611,485887
8313,42220,55-59,17234,16207,33441,"Santa Rosa-Petaluma, CA",38.525182,-122.92611,485887
8314,42220,60-64,18196,16550,34746,"Santa Rosa-Petaluma, CA",38.525182,-122.92611,485887
8315,42220,65+,56495,46123,102618,"Santa Rosa-Petaluma, CA",38.525182,-122.92611,485887
8316,42300,15-19,1045,1146,2191,"Sault Ste. Marie, MI",46.321819,-84.52063,36816
8317,42300,20-24,1425,1721,3146,"Sault Ste. Marie, MI",46.321819,-84.52063,36816
8318,42300,25-29,880,1589,2469,"Sault Ste. Marie, MI",46.321819,-84.52063,36816
8319,42300,30-34,853,1545,2398,"Sault Ste. Marie, MI",46.321819,-84.52063,36816
8320,42300,35-39,897,1575,2472,"Sault Ste. Marie, MI",46.321819,-84.52063,36816
8321,42300,40-44,923,1487,2410,"Sault Ste. Marie, MI",46.321819,-84.52063,36816
8322,42300,45-49,823,1335,2158,"Sault Ste. Marie, MI",46.321819,-84.52063,36816
8323,42300,50-54,913,1328,2241,"Sault Ste. Marie, MI",46.321819,-84.52063,36816
8324,42300,55-59,1124,1300,2424,"Sault Ste. Marie, MI",46.321819,-84.52063,36816
8325,42300,60-64,1230,1307,2537,"Sault Ste. Marie, MI",46.321819,-84.52063,36816
8326,42300,65+,3576,3383,6959,"Sault Ste. Marie, MI",46.321819,-84.52063,36816
8327,42340,15-19,14059,13683,27742,"Savannah, GA",32.109153,-81.273107,410008
8328,42340,20-24,14300,14249,28549,"Savannah, GA",32.109153,-81.273107,410008
8329,42340,25-29,15359,15245,30604,"Savannah, GA",32.109153,-81.273107,410008
8330,42340,30-34,15860,15260,31120,"Savannah, GA",32.109153,-81.273107,410008
8331,42340,35-39,14954,14618,29572,"Savannah, GA",32.109153,-81.273107,410008
8332,42340,40-44,13774,12826,26600,"Savannah, GA",32.109153,-81.273107,410008
8333,42340,45-49,12042,11579,23621,"Savannah, GA",32.109153,-81.273107,410008
8334,42340,50-54,12343,11718,24061,"Savannah, GA",32.109153,-81.273107,410008
8335,42340,55-59,13026,11822,24848,"Savannah, GA",32.109153,-81.273107,410008
8336,42340,60-64,12900,11281,24181,"Savannah, GA",32.109153,-81.273107,410008
8337,42340,65+,34748,27415,62163,"Savannah, GA",32.109153,-81.273107,410008
8338,42380,15-19,1670,1765,3435,"Sayre, PA",41.791504,-76.502123,59892
8339,42380,20-24,1468,1517,2985,"Sayre, PA",41.791504,-76.502123,59892
8340,42380,25-29,1700,1703,3403,"Sayre, PA",41.791504,-76.502123,59892
8341,42380,30-34,1642,1732,3374,"Sayre, PA",41.791504,-76.502123,59892
8342,42380,35-39,1608,1624,3232,"Sayre, PA",41.791504,-76.502123,59892
8343,42380,40-44,1586,1559,3145,"Sayre, PA",41.791504,-76.502123,59892
8344,42380,45-49,1565,1552,3117,"Sayre, PA",41.791504,-76.502123,59892
8345,42380,50-54,1879,1922,3801,"Sayre, PA",41.791504,-76.502123,59892
8346,42380,55-59,2290,2260,4550,"Sayre, PA",41.791504,-76.502123,59892
8347,42380,60-64,2240,2371,4611,"Sayre, PA",41.791504,-76.502123,59892
8348,42380,65+,6911,6318,13229,"Sayre, PA",41.791504,-76.502123,59892
8349,42420,15-19,1308,1299,2607,"Scottsbluff, NE",42.163326,-103.734473,37580
8350,42420,20-24,1001,1072,2073,"Scottsbluff, NE",42.163326,-103.734473,37580
8351,42420,25-29,1037,1101,2138,"Scottsbluff, NE",42.163326,-103.734473,37580
8352,42420,30-34,1102,1058,2160,"Scottsbluff, NE",42.163326,-103.734473,37580
8353,42420,35-39,1152,1080,2232,"Scottsbluff, NE",42.163326,-103.734473,37580
8354,42420,40-44,1113,1103,2216,"Scottsbluff, NE",42.163326,-103.734473,37580
8355,42420,45-49,999,1061,2060,"Scottsbluff, NE",42.163326,-103.734473,37580
8356,42420,50-54,1024,959,1983,"Scottsbluff, NE",42.163326,-103.734473,37580
8357,42420,55-59,1193,1186,2379,"Scottsbluff, NE",42.163326,-103.734473,37580
8358,42420,60-64,1286,1300,2586,"Scottsbluff, NE",42.163326,-103.734473,37580
8359,42420,65+,4169,3376,7545,"Scottsbluff, NE",42.163326,-103.734473,37580
8360,42460,15-19,1453,1655,3108,"Scottsboro, AL",34.764114,-85.980056,52773
8361,42460,20-24,1379,1436,2815,"Scottsboro, AL",34.764114,-85.980056,52773
8362,42460,25-29,1524,1523,3047,"Scottsboro, AL",34.764114,-85.980056,52773
8363,42460,30-34,1524,1530,3054,"Scottsboro, AL",34.764114,-85.980056,52773
8364,42460,35-39,1496,1445,2941,"Scottsboro, AL",34.764114,-85.980056,52773
8365,42460,40-44,1640,1561,3201,"Scottsboro, AL",34.764114,-85.980056,52773
8366,42460,45-49,1699,1750,3449,"Scottsboro, AL",34.764114,-85.980056,52773
8367,42460,50-54,1732,1831,3563,"Scottsboro, AL",34.764114,-85.980056,52773
8368,42460,55-59,1864,1823,3687,"Scottsboro, AL",34.764114,-85.980056,52773
8369,42460,60-64,2015,1917,3932,"Scottsboro, AL",34.764114,-85.980056,52773
8370,42460,65+,6051,5010,11061,"Scottsboro, AL",34.764114,-85.980056,52773
8371,42500,15-19,726,759,1485,"Scottsburg, IN",38.679431,-85.751898,24355
8372,42500,20-24,710,719,1429,"Scottsburg, IN",38.679431,-85.751898,24355
8373,42500,25-29,787,788,1575,"Scottsburg, IN",38.679431,-85.751898,24355
8374,42500,30-34,754,760,1514,"Scottsburg, IN",38.679431,-85.751898,24355
8375,42500,35-39,727,713,1440,"Scottsburg, IN",38.679431,-85.751898,24355
8376,42500,40-44,785,732,1517,"Scottsburg, IN",38.679431,-85.751898,24355
8377,42500,45-49,811,800,1611,"Scottsburg, IN",38.679431,-85.751898,24355
8378,42500,50-54,824,905,1729,"Scottsburg, IN",38.679431,-85.751898,24355
8379,42500,55-59,872,913,1785,"Scottsburg, IN",38.679431,-85.751898,24355
8380,42500,60-64,866,822,1688,"Scottsburg, IN",38.679431,-85.751898,24355
8381,42500,65+,2231,1872,4103,"Scottsburg, IN",38.679431,-85.751898,24355
8382,42540,15-19,17273,18518,35791,"Scranton--Wilkes-Barre, PA",41.322881,-75.898188,567750
8383,42540,20-24,16805,17264,34069,"Scranton--Wilkes-Barre, PA",41.322881,-75.898188,567750
8384,42540,25-29,16211,17474,33685,"Scranton--Wilkes-Barre, PA",41.322881,-75.898188,567750
8385,42540,30-34,17610,19102,36712,"Scranton--Wilkes-Barre, PA",41.322881,-75.898188,567750
8386,42540,35-39,16687,18092,34779,"Scranton--Wilkes-Barre, PA",41.322881,-75.898188,567750
8387,42540,40-44,16348,16839,33187,"Scranton--Wilkes-Barre, PA",41.322881,-75.898188,567750
8388,42540,45-49,16455,16522,32977,"Scranton--Wilkes-Barre, PA",41.322881,-75.898188,567750
8389,42540,50-54,18679,18996,37675,"Scranton--Wilkes-Barre, PA",41.322881,-75.898188,567750
8390,42540,55-59,19864,19930,39794,"Scranton--Wilkes-Barre, PA",41.322881,-75.898188,567750
8391,42540,60-64,20397,19672,40069,"Scranton--Wilkes-Barre, PA",41.322881,-75.898188,567750
8392,42540,65+,63749,50730,114479,"Scranton--Wilkes-Barre, PA",41.322881,-75.898188,567750
8393,42620,15-19,3024,2930,5954,"Searcy, AR",35.255118,-91.753034,77207
8394,42620,20-24,2955,2844,5799,"Searcy, AR",35.255118,-91.753034,77207
8395,42620,25-29,2332,2260,4592,"Searcy, AR",35.255118,-91.753034,77207
8396,42620,30-34,2574,2317,4891,"Searcy, AR",35.255118,-91.753034,77207
8397,42620,35-39,2327,2244,4571,"Searcy, AR",35.255118,-91.753034,77207
8398,42620,40-44,2321,2235,4556,"Searcy, AR",35.255118,-91.753034,77207
8399,42620,45-49,2249,2256,4505,"Searcy, AR",35.255118,-91.753034,77207
8400,42620,50-54,2428,2422,4850,"Searcy, AR",35.255118,-91.753034,77207
8401,42620,55-59,2621,2592,5213,"Searcy, AR",35.255118,-91.753034,77207
8402,42620,60-64,2443,2429,4872,"Searcy, AR",35.255118,-91.753034,77207
8403,42620,65+,7134,5670,12804,"Searcy, AR",35.255118,-91.753034,77207
8404,42660,15-19,109702,114465,224167,"Seattle-Tacoma-Bellevue, WA",47.490552,-121.833977,4011553
8405,42660,20-24,112121,121121,233242,"Seattle-Tacoma-Bellevue, WA",47.490552,-121.833977,4011553
8406,42660,25-29,152137,166028,318165,"Seattle-Tacoma-Bellevue, WA",47.490552,-121.833977,4011553
8407,42660,30-34,171096,185275,356371,"Seattle-Tacoma-Bellevue, WA",47.490552,-121.833977,4011553
8408,42660,35-39,159770,172094,331864,"Seattle-Tacoma-Bellevue, WA",47.490552,-121.833977,4011553
8409,42660,40-44,139334,148024,287358,"Seattle-Tacoma-Bellevue, WA",47.490552,-121.833977,4011553
8410,42660,45-49,123487,129012,252499,"Seattle-Tacoma-Bellevue, WA",47.490552,-121.833977,4011553
8411,42660,50-54,125953,132471,258424,"Seattle-Tacoma-Bellevue, WA",47.490552,-121.833977,4011553
8412,42660,55-59,121199,124869,246068,"Seattle-Tacoma-Bellevue, WA",47.490552,-121.833977,4011553
8413,42660,60-64,117246,116617,233863,"Seattle-Tacoma-Bellevue, WA",47.490552,-121.833977,4011553
8414,42660,65+,308105,254970,563075,"Seattle-Tacoma-Bellevue, WA",47.490552,-121.833977,4011553
8415,42680,15-19,3480,4170,7650,"Sebastian-Vero Beach, FL",27.700528,-80.574789,163662
8416,42680,20-24,3275,3442,6717,"Sebastian-Vero Beach, FL",27.700528,-80.574789,163662
8417,42680,25-29,3598,3840,7438,"Sebastian-Vero Beach, FL",27.700528,-80.574789,163662
8418,42680,30-34,3927,3913,7840,"Sebastian-Vero Beach, FL",27.700528,-80.574789,163662
8419,42680,35-39,3747,3724,7471,"Sebastian-Vero Beach, FL",27.700528,-80.574789,163662
8420,42680,40-44,3773,3545,7318,"Sebastian-Vero Beach, FL",27.700528,-80.574789,163662
8421,42680,45-49,3902,3771,7673,"Sebastian-Vero Beach, FL",27.700528,-80.574789,163662
8422,42680,50-54,4923,4471,9394,"Sebastian-Vero Beach, FL",27.700528,-80.574789,163662
8423,42680,55-59,6117,5464,11581,"Sebastian-Vero Beach, FL",27.700528,-80.574789,163662
8424,42680,60-64,7802,6392,14194,"Sebastian-Vero Beach, FL",27.700528,-80.574789,163662
8425,42680,65+,30080,26054,56134,"Sebastian-Vero Beach, FL",27.700528,-80.574789,163662
8426,42700,15-19,2299,2470,4769,"Sebring-Avon Park, FL",27.34108,-81.342353,103296
8427,42700,20-24,2133,2199,4332,"Sebring-Avon Park, FL",27.34108,-81.342353,103296
8428,42700,25-29,2321,2542,4863,"Sebring-Avon Park, FL",27.34108,-81.342353,103296
8429,42700,30-34,2460,2624,5084,"Sebring-Avon Park, FL",27.34108,-81.342353,103296
8430,42700,35-39,2446,2426,4872,"Sebring-Avon Park, FL",27.34108,-81.342353,103296
8431,42700,40-44,2279,2306,4585,"Sebring-Avon Park, FL",27.34108,-81.342353,103296
8432,42700,45-49,2256,2211,4467,"Sebring-Avon Park, FL",27.34108,-81.342353,103296
8433,42700,50-54,2649,2645,5294,"Sebring-Avon Park, FL",27.34108,-81.342353,103296
8434,42700,55-59,3298,2987,6285,"Sebring-Avon Park, FL",27.34108,-81.342353,103296
8435,42700,60-64,3978,3483,7461,"Sebring-Avon Park, FL",27.34108,-81.342353,103296
8436,42700,65+,19339,17544,36883,"Sebring-Avon Park, FL",27.34108,-81.342353,103296
8437,42740,15-19,1337,1488,2825,"Sedalia, MO",38.727367,-93.285207,43188
8438,42740,20-24,1279,1347,2626,"Sedalia, MO",38.727367,-93.285207,43188
8439,42740,25-29,1335,1283,2618,"Sedalia, MO",38.727367,-93.285207,43188
8440,42740,30-34,1407,1373,2780,"Sedalia, MO",38.727367,-93.285207,43188
8441,42740,35-39,1411,1428,2839,"Sedalia, MO",38.727367,-93.285207,43188
8442,42740,40-44,1275,1351,2626,"Sedalia, MO",38.727367,-93.285207,43188
8443,42740,45-49,1191,1195,2386,"Sedalia, MO",38.727367,-93.285207,43188
8444,42740,50-54,1127,1250,2377,"Sedalia, MO",38.727367,-93.285207,43188
8445,42740,55-59,1447,1351,2798,"Sedalia, MO",38.727367,-93.285207,43188
8446,42740,60-64,1409,1438,2847,"Sedalia, MO",38.727367,-93.285207,43188
8447,42740,65+,4022,3370,7392,"Sedalia, MO",38.727367,-93.285207,43188
8448,42780,15-19,1633,1707,3340,"Selinsgrove, PA",40.755407,-77.072929,39621
8449,42780,20-24,1424,1448,2872,"Selinsgrove, PA",40.755407,-77.072929,39621
8450,42780,25-29,998,1039,2037,"Selinsgrove, PA",40.755407,-77.072929,39621
8451,42780,30-34,1137,1190,2327,"Selinsgrove, PA",40.755407,-77.072929,39621
8452,42780,35-39,1074,1106,2180,"Selinsgrove, PA",40.755407,-77.072929,39621
8453,42780,40-44,1032,1058,2090,"Selinsgrove, PA",40.755407,-77.072929,39621
8454,42780,45-49,1117,1123,2240,"Selinsgrove, PA",40.755407,-77.072929,39621
8455,42780,50-54,1277,1301,2578,"Selinsgrove, PA",40.755407,-77.072929,39621
8456,42780,55-59,1388,1416,2804,"Selinsgrove, PA",40.755407,-77.072929,39621
8457,42780,60-64,1315,1361,2676,"Selinsgrove, PA",40.755407,-77.072929,39621
8458,42780,65+,4260,3598,7858,"Selinsgrove, PA",40.755407,-77.072929,39621
8459,42820,15-19,1219,1322,2541,"Selma, AL",32.333526,-87.11436,37619
8460,42820,20-24,1167,1129,2296,"Selma, AL",32.333526,-87.11436,37619
8461,42820,25-29,1132,940,2072,"Selma, AL",32.333526,-87.11436,37619
8462,42820,30-34,1186,942,2128,"Selma, AL",32.333526,-87.11436,37619
8463,42820,35-39,1148,950,2098,"Selma, AL",32.333526,-87.11436,37619
8464,42820,40-44,1167,970,2137,"Selma, AL",32.333526,-87.11436,37619
8465,42820,45-49,1188,874,2062,"Selma, AL",32.333526,-87.11436,37619
8466,42820,50-54,1174,1020,2194,"Selma, AL",32.333526,-87.11436,37619
8467,42820,55-59,1453,1202,2655,"Selma, AL",32.333526,-87.11436,37619
8468,42820,60-64,1568,1289,2857,"Selma, AL",32.333526,-87.11436,37619
8469,42820,65+,4221,3178,7399,"Selma, AL",32.333526,-87.11436,37619
8470,42860,15-19,2198,2210,4408,"Seneca, SC",34.748766,-83.06154,79203
8471,42860,20-24,1955,2165,4120,"Seneca, SC",34.748766,-83.06154,79203
8472,42860,25-29,2159,2223,4382,"Seneca, SC",34.748766,-83.06154,79203
8473,42860,30-34,2258,2281,4539,"Seneca, SC",34.748766,-83.06154,79203
8474,42860,35-39,2010,1996,4006,"Seneca, SC",34.748766,-83.06154,79203
8475,42860,40-44,2074,2095,4169,"Seneca, SC",34.748766,-83.06154,79203
8476,42860,45-49,2232,2197,4429,"Seneca, SC",34.748766,-83.06154,79203
8477,42860,50-54,2622,2524,5146,"Seneca, SC",34.748766,-83.06154,79203
8478,42860,55-59,2959,2885,5844,"Seneca, SC",34.748766,-83.06154,79203
8479,42860,60-64,3404,3210,6614,"Seneca, SC",34.748766,-83.06154,79203
8480,42860,65+,10059,9011,19070,"Seneca, SC",34.748766,-83.06154,79203
8481,42900,15-19,887,1010,1897,"Seneca Falls, NY",42.782294,-76.827088,33688
8482,42900,20-24,834,1241,2075,"Seneca Falls, NY",42.782294,-76.827088,33688
8483,42900,25-29,944,1329,2273,"Seneca Falls, NY",42.782294,-76.827088,33688
8484,42900,30-34,979,1247,2226,"Seneca Falls, NY",42.782294,-76.827088,33688
8485,42900,35-39,925,1190,2115,"Seneca Falls, NY",42.782294,-76.827088,33688
8486,42900,40-44,824,1067,1891,"Seneca Falls, NY",42.782294,-76.827088,33688
8487,42900,45-49,846,955,1801,"Seneca Falls, NY",42.782294,-76.827088,33688
8488,42900,50-54,1008,1090,2098,"Seneca Falls, NY",42.782294,-76.827088,33688
8489,42900,55-59,1129,1210,2339,"Seneca Falls, NY",42.782294,-76.827088,33688
8490,42900,60-64,1284,1295,2579,"Seneca Falls, NY",42.782294,-76.827088,33688
8491,42900,65+,3563,3288,6851,"Seneca Falls, NY",42.782294,-76.827088,33688
8492,42940,15-19,2633,2998,5631,"Sevierville, TN",35.787822,-83.5249,99517
8493,42940,20-24,2598,2780,5378,"Sevierville, TN",35.787822,-83.5249,99517
8494,42940,25-29,3040,3145,6185,"Sevierville, TN",35.787822,-83.5249,99517
8495,42940,30-34,2982,3014,5996,"Sevierville, TN",35.787822,-83.5249,99517
8496,42940,35-39,2772,2782,5554,"Sevierville, TN",35.787822,-83.5249,99517
8497,42940,40-44,2921,2809,5730,"Sevierville, TN",35.787822,-83.5249,99517
8498,42940,45-49,3068,3062,6130,"Sevierville, TN",35.787822,-83.5249,99517
8499,42940,50-54,3451,3417,6868,"Sevierville, TN",35.787822,-83.5249,99517
8500,42940,55-59,3959,3596,7555,"Sevierville, TN",35.787822,-83.5249,99517
8501,42940,60-64,3956,3621,7577,"Sevierville, TN",35.787822,-83.5249,99517
8502,42940,65+,10900,9505,20405,"Sevierville, TN",35.787822,-83.5249,99517
8503,42980,15-19,1369,1565,2934,"Seymour, IN",38.911957,-86.042516,46067
8504,42980,20-24,1195,1307,2502,"Seymour, IN",38.911957,-86.042516,46067
8505,42980,25-29,1374,1388,2762,"Seymour, IN",38.911957,-86.042516,46067
8506,42980,30-34,1378,1344,2722,"Seymour, IN",38.911957,-86.042516,46067
8507,42980,35-39,1344,1507,2851,"Seymour, IN",38.911957,-86.042516,46067
8508,42980,40-44,1487,1579,3066,"Seymour, IN",38.911957,-86.042516,46067
8509,42980,45-49,1360,1502,2862,"Seymour, IN",38.911957,-86.042516,46067
8510,42980,50-54,1417,1585,3002,"Seymour, IN",38.911957,-86.042516,46067
8511,42980,55-59,1579,1566,3145,"Seymour, IN",38.911957,-86.042516,46067
8512,42980,60-64,1552,1523,3075,"Seymour, IN",38.911957,-86.042516,46067
8513,42980,65+,4293,3507,7800,"Seymour, IN",38.911957,-86.042516,46067
8514,43020,15-19,1327,1522,2849,"Shawano, WI",44.851643,-88.745543,45148
8515,43020,20-24,1100,1149,2249,"Shawano, WI",44.851643,-88.745543,45148
8516,43020,25-29,1133,1223,2356,"Shawano, WI",44.851643,-88.745543,45148
8517,43020,30-34,1202,1176,2378,"Shawano, WI",44.851643,-88.745543,45148
8518,43020,35-39,1238,1239,2477,"Shawano, WI",44.851643,-88.745543,45148
8519,43020,40-44,1217,1234,2451,"Shawano, WI",44.851643,-88.745543,45148
8520,43020,45-49,1262,1216,2478,"Shawano, WI",44.851643,-88.745543,45148
8521,43020,50-54,1445,1547,2992,"Shawano, WI",44.851643,-88.745543,45148
8522,43020,55-59,1780,1838,3618,"Shawano, WI",44.851643,-88.745543,45148
8523,43020,60-64,1750,1838,3588,"Shawano, WI",44.851643,-88.745543,45148
8524,43020,65+,4912,4499,9411,"Shawano, WI",44.851643,-88.745543,45148
8525,43060,15-19,2473,2562,5035,"Shawnee, OK",35.211391,-96.957004,73019
8526,43060,20-24,2476,2374,4850,"Shawnee, OK",35.211391,-96.957004,73019
8527,43060,25-29,2390,2155,4545,"Shawnee, OK",35.211391,-96.957004,73019
8528,43060,30-34,2484,2210,4694,"Shawnee, OK",35.211391,-96.957004,73019
8529,43060,35-39,2470,2172,4642,"Shawnee, OK",35.211391,-96.957004,73019
8530,43060,40-44,2422,2228,4650,"Shawnee, OK",35.211391,-96.957004,73019
8531,43060,45-49,2283,2127,4410,"Shawnee, OK",35.211391,-96.957004,73019
8532,43060,50-54,2337,2128,4465,"Shawnee, OK",35.211391,-96.957004,73019
8533,43060,55-59,2429,2330,4759,"Shawnee, OK",35.211391,-96.957004,73019
8534,43060,60-64,2437,2187,4624,"Shawnee, OK",35.211391,-96.957004,73019
8535,43060,65+,6622,5546,12168,"Shawnee, OK",35.211391,-96.957004,73019
8536,43100,15-19,3540,3887,7427,"Sheboygan, WI",43.741232,-87.731516,117747
8537,43100,20-24,3218,3698,6916,"Sheboygan, WI",43.741232,-87.731516,117747
8538,43100,25-29,3393,3802,7195,"Sheboygan, WI",43.741232,-87.731516,117747
8539,43100,30-34,3120,3473,6593,"Sheboygan, WI",43.741232,-87.731516,117747
8540,43100,35-39,3525,3808,7333,"Sheboygan, WI",43.741232,-87.731516,117747
8541,43100,40-44,3394,3757,7151,"Sheboygan, WI",43.741232,-87.731516,117747
8542,43100,45-49,3298,3462,6760,"Sheboygan, WI",43.741232,-87.731516,117747
8543,43100,50-54,3600,4061,7661,"Sheboygan, WI",43.741232,-87.731516,117747
8544,43100,55-59,4250,4440,8690,"Sheboygan, WI",43.741232,-87.731516,117747
8545,43100,60-64,4372,4402,8774,"Sheboygan, WI",43.741232,-87.731516,117747
8546,43100,65+,12006,10389,22395,"Sheboygan, WI",43.741232,-87.731516,117747
8547,43140,15-19,3221,3322,6543,"Shelby, NC",35.33463,-81.557114,100359
8548,43140,20-24,3134,3104,6238,"Shelby, NC",35.33463,-81.557114,100359
8549,43140,25-29,3172,3052,6224,"Shelby, NC",35.33463,-81.557114,100359
8550,43140,30-34,3260,2972,6232,"Shelby, NC",35.33463,-81.557114,100359
8551,43140,35-39,2793,2575,5368,"Shelby, NC",35.33463,-81.557114,100359
8552,43140,40-44,2931,2601,5532,"Shelby, NC",35.33463,-81.557114,100359
8553,43140,45-49,2988,2854,5842,"Shelby, NC",35.33463,-81.557114,100359
8554,43140,50-54,3687,3384,7071,"Shelby, NC",35.33463,-81.557114,100359
8555,43140,55-59,3689,3530,7219,"Shelby, NC",35.33463,-81.557114,100359
8556,43140,60-64,3502,3294,6796,"Shelby, NC",35.33463,-81.557114,100359
8557,43140,65+,10503,8268,18771,"Shelby, NC",35.33463,-81.557114,100359
8558,43180,15-19,1650,1805,3455,"Shelbyville, TN",35.51366,-86.458294,51119
8559,43180,20-24,1486,1542,3028,"Shelbyville, TN",35.51366,-86.458294,51119
8560,43180,25-29,1638,1778,3416,"Shelbyville, TN",35.51366,-86.458294,51119
8561,43180,30-34,1710,1735,3445,"Shelbyville, TN",35.51366,-86.458294,51119
8562,43180,35-39,1618,1572,3190,"Shelbyville, TN",35.51366,-86.458294,51119
8563,43180,40-44,1572,1623,3195,"Shelbyville, TN",35.51366,-86.458294,51119
8564,43180,45-49,1622,1540,3162,"Shelbyville, TN",35.51366,-86.458294,51119
8565,43180,50-54,1667,1698,3365,"Shelbyville, TN",35.51366,-86.458294,51119
8566,43180,55-59,1760,1665,3425,"Shelbyville, TN",35.51366,-86.458294,51119
8567,43180,60-64,1575,1525,3100,"Shelbyville, TN",35.51366,-86.458294,51119
8568,43180,65+,4311,3421,7732,"Shelbyville, TN",35.51366,-86.458294,51119
8569,43220,15-19,1611,1861,3472,"Shelton, WA",47.350832,-123.173103,67615
8570,43220,20-24,1437,1922,3359,"Shelton, WA",47.350832,-123.173103,67615
8571,43220,25-29,1689,2347,4036,"Shelton, WA",47.350832,-123.173103,67615
8572,43220,30-34,1921,2255,4176,"Shelton, WA",47.350832,-123.173103,67615
8573,43220,35-39,1868,2216,4084,"Shelton, WA",47.350832,-123.173103,67615
8574,43220,40-44,1780,2122,3902,"Shelton, WA",47.350832,-123.173103,67615
8575,43220,45-49,1607,1922,3529,"Shelton, WA",47.350832,-123.173103,67615
8576,43220,50-54,1901,1989,3890,"Shelton, WA",47.350832,-123.173103,67615
8577,43220,55-59,2355,2268,4623,"Shelton, WA",47.350832,-123.173103,67615
8578,43220,60-64,2820,2785,5605,"Shelton, WA",47.350832,-123.173103,67615
8579,43220,65+,8211,7841,16052,"Shelton, WA",47.350832,-123.173103,67615
8580,43260,15-19,973,1022,1995,"Sheridan, WY",44.781369,-106.881211,31646
8581,43260,20-24,815,837,1652,"Sheridan, WY",44.781369,-106.881211,31646
8582,43260,25-29,817,888,1705,"Sheridan, WY",44.781369,-106.881211,31646
8583,43260,30-34,919,957,1876,"Sheridan, WY",44.781369,-106.881211,31646
8584,43260,35-39,1025,1008,2033,"Sheridan, WY",44.781369,-106.881211,31646
8585,43260,40-44,971,1017,1988,"Sheridan, WY",44.781369,-106.881211,31646
8586,43260,45-49,854,943,1797,"Sheridan, WY",44.781369,-106.881211,31646
8587,43260,50-54,909,980,1889,"Sheridan, WY",44.781369,-106.881211,31646
8588,43260,55-59,1005,989,1994,"Sheridan, WY",44.781369,-106.881211,31646
8589,43260,60-64,1216,1147,2363,"Sheridan, WY",44.781369,-106.881211,31646
8590,43260,65+,3566,3376,6942,"Sheridan, WY",44.781369,-106.881211,31646
8591,43300,15-19,4589,4759,9348,"Sherman-Denison, TX",33.624524,-96.675693,139336
8592,43300,20-24,4085,4184,8269,"Sherman-Denison, TX",33.624524,-96.675693,139336
8593,43300,25-29,4217,4075,8292,"Sherman-Denison, TX",33.624524,-96.675693,139336
8594,43300,30-34,4404,4167,8571,"Sherman-Denison, TX",33.624524,-96.675693,139336
8595,43300,35-39,4486,4226,8712,"Sherman-Denison, TX",33.624524,-96.675693,139336
8596,43300,40-44,4100,4112,8212,"Sherman-Denison, TX",33.624524,-96.675693,139336
8597,43300,45-49,4009,3955,7964,"Sherman-Denison, TX",33.624524,-96.675693,139336
8598,43300,50-54,4374,4178,8552,"Sherman-Denison, TX",33.624524,-96.675693,139336
8599,43300,55-59,4753,4571,9324,"Sherman-Denison, TX",33.624524,-96.675693,139336
8600,43300,60-64,4939,4599,9538,"Sherman-Denison, TX",33.624524,-96.675693,139336
8601,43300,65+,13737,11456,25193,"Sherman-Denison, TX",33.624524,-96.675693,139336
8602,43320,15-19,3671,4003,7674,"Show Low, AZ",35.390785,-110.321025,108147
8603,43320,20-24,2828,3204,6032,"Show Low, AZ",35.390785,-110.321025,108147
8604,43320,25-29,2929,3352,6281,"Show Low, AZ",35.390785,-110.321025,108147
8605,43320,30-34,3188,3552,6740,"Show Low, AZ",35.390785,-110.321025,108147
8606,43320,35-39,2939,3234,6173,"Show Low, AZ",35.390785,-110.321025,108147
8607,43320,40-44,2809,3005,5814,"Show Low, AZ",35.390785,-110.321025,108147
8608,43320,45-49,2738,2866,5604,"Show Low, AZ",35.390785,-110.321025,108147
8609,43320,50-54,2859,2871,5730,"Show Low, AZ",35.390785,-110.321025,108147
8610,43320,55-59,3573,3276,6849,"Show Low, AZ",35.390785,-110.321025,108147
8611,43320,60-64,3993,3618,7611,"Show Low, AZ",35.390785,-110.321025,108147
8612,43320,65+,10904,9995,20899,"Show Low, AZ",35.390785,-110.321025,108147
8613,43340,15-19,12001,12773,24774,"Shreveport-Bossier City, LA",32.437682,-93.744884,389155
8614,43340,20-24,11638,12079,23717,"Shreveport-Bossier City, LA",32.437682,-93.744884,389155
8615,43340,25-29,12704,12273,24977,"Shreveport-Bossier City, LA",32.437682,-93.744884,389155
8616,43340,30-34,13928,12746,26674,"Shreveport-Bossier City, LA",32.437682,-93.744884,389155
8617,43340,35-39,13707,12841,26548,"Shreveport-Bossier City, LA",32.437682,-93.744884,389155
8618,43340,40-44,12676,12000,24676,"Shreveport-Bossier City, LA",32.437682,-93.744884,389155
8619,43340,45-49,11337,10560,21897,"Shreveport-Bossier City, LA",32.437682,-93.744884,389155
8620,43340,50-54,11605,10622,22227,"Shreveport-Bossier City, LA",32.437682,-93.744884,389155
8621,43340,55-59,12335,11496,23831,"Shreveport-Bossier City, LA",32.437682,-93.744884,389155
8622,43340,60-64,13186,11737,24923,"Shreveport-Bossier City, LA",32.437682,-93.744884,389155
8623,43340,65+,38217,29332,67549,"Shreveport-Bossier City, LA",32.437682,-93.744884,389155
8624,43380,15-19,1575,1717,3292,"Sidney, OH",40.33668,-84.204142,47977
8625,43380,20-24,1329,1485,2814,"Sidney, OH",40.33668,-84.204142,47977
8626,43380,25-29,1400,1426,2826,"Sidney, OH",40.33668,-84.204142,47977
8627,43380,30-34,1339,1375,2714,"Sidney, OH",40.33668,-84.204142,47977
8628,43380,35-39,1348,1418,2766,"Sidney, OH",40.33668,-84.204142,47977
8629,43380,40-44,1359,1389,2748,"Sidney, OH",40.33668,-84.204142,47977
8630,43380,45-49,1419,1411,2830,"Sidney, OH",40.33668,-84.204142,47977
8631,43380,50-54,1502,1621,3123,"Sidney, OH",40.33668,-84.204142,47977
8632,43380,55-59,1687,1796,3483,"Sidney, OH",40.33668,-84.204142,47977
8633,43380,60-64,1622,1745,3367,"Sidney, OH",40.33668,-84.204142,47977
8634,43380,65+,4468,3873,8341,"Sidney, OH",40.33668,-84.204142,47977
8635,43420,15-19,3635,4288,7923,"Sierra Vista-Douglas, AZ",31.840129,-109.775163,126050
8636,43420,20-24,3120,4076,7196,"Sierra Vista-Douglas, AZ",31.840129,-109.775163,126050
8637,43420,25-29,3346,4255,7601,"Sierra Vista-Douglas, AZ",31.840129,-109.775163,126050
8638,43420,30-34,3631,4252,7883,"Sierra Vista-Douglas, AZ",31.840129,-109.775163,126050
8639,43420,35-39,3475,4251,7726,"Sierra Vista-Douglas, AZ",31.840129,-109.775163,126050
8640,43420,40-44,3233,3673,6906,"Sierra Vista-Douglas, AZ",31.840129,-109.775163,126050
8641,43420,45-49,2923,3212,6135,"Sierra Vista-Douglas, AZ",31.840129,-109.775163,126050
8642,43420,50-54,3239,3265,6504,"Sierra Vista-Douglas, AZ",31.840129,-109.775163,126050
8643,43420,55-59,3940,3720,7660,"Sierra Vista-Douglas, AZ",31.840129,-109.775163,126050
8644,43420,60-64,4595,4089,8684,"Sierra Vista-Douglas, AZ",31.840129,-109.775163,126050
8645,43420,65+,15480,14409,29889,"Sierra Vista-Douglas, AZ",31.840129,-109.775163,126050
8646,43460,15-19,1129,1258,2387,"Sikeston, MO",37.047793,-89.568098,37840
8647,43460,20-24,1036,1003,2039,"Sikeston, MO",37.047793,-89.568098,37840
8648,43460,25-29,1207,1151,2358,"Sikeston, MO",37.047793,-89.568098,37840
8649,43460,30-34,1225,1151,2376,"Sikeston, MO",37.047793,-89.568098,37840
8650,43460,35-39,1170,1102,2272,"Sikeston, MO",37.047793,-89.568098,37840
8651,43460,40-44,1130,1072,2202,"Sikeston, MO",37.047793,-89.568098,37840
8652,43460,45-49,1095,1045,2140,"Sikeston, MO",37.047793,-89.568098,37840
8653,43460,50-54,1210,1155,2365,"Sikeston, MO",37.047793,-89.568098,37840
8654,43460,55-59,1293,1253,2546,"Sikeston, MO",37.047793,-89.568098,37840
8655,43460,60-64,1257,1183,2440,"Sikeston, MO",37.047793,-89.568098,37840
8656,43460,65+,4012,3116,7128,"Sikeston, MO",37.047793,-89.568098,37840
8657,43500,15-19,778,810,1588,"Silver City, NM",32.732087,-108.381504,27889
8658,43500,20-24,691,805,1496,"Silver City, NM",32.732087,-108.381504,27889
8659,43500,25-29,662,712,1374,"Silver City, NM",32.732087,-108.381504,27889
8660,43500,30-34,613,632,1245,"Silver City, NM",32.732087,-108.381504,27889
8661,43500,35-39,686,701,1387,"Silver City, NM",32.732087,-108.381504,27889
8662,43500,40-44,786,728,1514,"Silver City, NM",32.732087,-108.381504,27889
8663,43500,45-49,679,710,1389,"Silver City, NM",32.732087,-108.381504,27889
8664,43500,50-54,738,703,1441,"Silver City, NM",32.732087,-108.381504,27889
8665,43500,55-59,912,804,1716,"Silver City, NM",32.732087,-108.381504,27889
8666,43500,60-64,1097,1058,2155,"Silver City, NM",32.732087,-108.381504,27889
8667,43500,65+,4295,3945,8240,"Silver City, NM",32.732087,-108.381504,27889
8668,43580,15-19,5272,5713,10985,"Sioux City, IA-NE-SD",42.512942,-96.438949,149265
8669,43580,20-24,4807,4904,9711,"Sioux City, IA-NE-SD",42.512942,-96.438949,149265
8670,43580,25-29,4548,4891,9439,"Sioux City, IA-NE-SD",42.512942,-96.438949,149265
8671,43580,30-34,4520,4782,9302,"Sioux City, IA-NE-SD",42.512942,-96.438949,149265
8672,43580,35-39,4586,5033,9619,"Sioux City, IA-NE-SD",42.512942,-96.438949,149265
8673,43580,40-44,4500,4646,9146,"Sioux City, IA-NE-SD",42.512942,-96.438949,149265
8674,43580,45-49,4188,4157,8345,"Sioux City, IA-NE-SD",42.512942,-96.438949,149265
8675,43580,50-54,4191,4421,8612,"Sioux City, IA-NE-SD",42.512942,-96.438949,149265
8676,43580,55-59,4394,4688,9082,"Sioux City, IA-NE-SD",42.512942,-96.438949,149265
8677,43580,60-64,4517,4473,8990,"Sioux City, IA-NE-SD",42.512942,-96.438949,149265
8678,43580,65+,12579,10887,23466,"Sioux City, IA-NE-SD",42.512942,-96.438949,149265
8679,43620,15-19,8831,9356,18187,"Sioux Falls, SD",43.49542,-96.995339,281958
8680,43620,20-24,8418,8551,16969,"Sioux Falls, SD",43.49542,-96.995339,281958
8681,43620,25-29,9738,10177,19915,"Sioux Falls, SD",43.49542,-96.995339,281958
8682,43620,30-34,10129,10760,20889,"Sioux Falls, SD",43.49542,-96.995339,281958
8683,43620,35-39,10140,11146,21286,"Sioux Falls, SD",43.49542,-96.995339,281958
8684,43620,40-44,9063,9944,19007,"Sioux Falls, SD",43.49542,-96.995339,281958
8685,43620,45-49,7623,8150,15773,"Sioux Falls, SD",43.49542,-96.995339,281958
8686,43620,50-54,7524,8113,15637,"Sioux Falls, SD",43.49542,-96.995339,281958
8687,43620,55-59,8305,8414,16719,"Sioux Falls, SD",43.49542,-96.995339,281958
8688,43620,60-64,8461,8400,16861,"Sioux Falls, SD",43.49542,-96.995339,281958
8689,43620,65+,21472,18344,39816,"Sioux Falls, SD",43.49542,-96.995339,281958
8690,43660,15-19,556,652,1208,"Snyder, TX",32.744353,-100.913346,16824
8691,43660,20-24,468,660,1128,"Snyder, TX",32.744353,-100.913346,16824
8692,43660,25-29,448,679,1127,"Snyder, TX",32.744353,-100.913346,16824
8693,43660,30-34,457,676,1133,"Snyder, TX",32.744353,-100.913346,16824
8694,43660,35-39,485,681,1166,"Snyder, TX",32.744353,-100.913346,16824
8695,43660,40-44,445,697,1142,"Snyder, TX",32.744353,-100.913346,16824
8696,43660,45-49,355,615,970,"Snyder, TX",32.744353,-100.913346,16824
8697,43660,50-54,431,549,980,"Snyder, TX",32.744353,-100.913346,16824
8698,43660,55-59,470,536,1006,"Snyder, TX",32.744353,-100.913346,16824
8699,43660,60-64,477,517,994,"Snyder, TX",32.744353,-100.913346,16824
8700,43660,65+,1372,1156,2528,"Snyder, TX",32.744353,-100.913346,16824
8701,43700,15-19,1901,2078,3979,"Somerset, KY",37.107452,-84.576969,65423
8702,43700,20-24,1640,1707,3347,"Somerset, KY",37.107452,-84.576969,65423
8703,43700,25-29,1885,1961,3846,"Somerset, KY",37.107452,-84.576969,65423
8704,43700,30-34,2039,1909,3948,"Somerset, KY",37.107452,-84.576969,65423
8705,43700,35-39,1982,1832,3814,"Somerset, KY",37.107452,-84.576969,65423
8706,43700,40-44,2059,2042,4101,"Somerset, KY",37.107452,-84.576969,65423
8707,43700,45-49,2022,2051,4073,"Somerset, KY",37.107452,-84.576969,65423
8708,43700,50-54,2305,2211,4516,"Somerset, KY",37.107452,-84.576969,65423
8709,43700,55-59,2413,2230,4643,"Somerset, KY",37.107452,-84.576969,65423
8710,43700,60-64,2380,2215,4595,"Somerset, KY",37.107452,-84.576969,65423
8711,43700,65+,6911,5780,12691,"Somerset, KY",37.107452,-84.576969,65423
8712,43740,15-19,1764,1949,3713,"Somerset, PA",39.981297,-79.028486,73627
8713,43740,20-24,1612,2199,3811,"Somerset, PA",39.981297,-79.028486,73627
8714,43740,25-29,1692,2516,4208,"Somerset, PA",39.981297,-79.028486,73627
8715,43740,30-34,1755,2467,4222,"Somerset, PA",39.981297,-79.028486,73627
8716,43740,35-39,1835,2476,4311,"Somerset, PA",39.981297,-79.028486,73627
8717,43740,40-44,1898,2526,4424,"Somerset, PA",39.981297,-79.028486,73627
8718,43740,45-49,2063,2582,4645,"Somerset, PA",39.981297,-79.028486,73627
8719,43740,50-54,2266,2746,5012,"Somerset, PA",39.981297,-79.028486,73627
8720,43740,55-59,2623,2835,5458,"Somerset, PA",39.981297,-79.028486,73627
8721,43740,60-64,2912,3031,5943,"Somerset, PA",39.981297,-79.028486,73627
8722,43740,65+,9012,8015,17027,"Somerset, PA",39.981297,-79.028486,73627
8723,43760,15-19,1282,1342,2624,"Sonora, CA",38.021434,-119.964733,55810
8724,43760,20-24,1107,1484,2591,"Sonora, CA",38.021434,-119.964733,55810
8725,43760,25-29,1269,1910,3179,"Sonora, CA",38.021434,-119.964733,55810
8726,43760,30-34,1478,2060,3538,"Sonora, CA",38.021434,-119.964733,55810
8727,43760,35-39,1451,1959,3410,"Sonora, CA",38.021434,-119.964733,55810
8728,43760,40-44,1391,1936,3327,"Sonora, CA",38.021434,-119.964733,55810
8729,43760,45-49,1186,1659,2845,"Sonora, CA",38.021434,-119.964733,55810
8730,43760,50-54,1455,1671,3126,"Sonora, CA",38.021434,-119.964733,55810
8731,43760,55-59,1805,1807,3612,"Sonora, CA",38.021434,-119.964733,55810
8732,43760,60-64,2329,2241,4570,"Sonora, CA",38.021434,-119.964733,55810
8733,43760,65+,7860,7340,15200,"Sonora, CA",38.021434,-119.964733,55810
8734,43780,15-19,11578,11972,23550,"South Bend-Mishawaka, IN-MI",41.774981,-86.123014,323695
8735,43780,20-24,11949,11433,23382,"South Bend-Mishawaka, IN-MI",41.774981,-86.123014,323695
8736,43780,25-29,10539,10652,21191,"South Bend-Mishawaka, IN-MI",41.774981,-86.123014,323695
8737,43780,30-34,10320,10219,20539,"South Bend-Mishawaka, IN-MI",41.774981,-86.123014,323695
8738,43780,35-39,9829,10103,19932,"South Bend-Mishawaka, IN-MI",41.774981,-86.123014,323695
8739,43780,40-44,9677,9633,19310,"South Bend-Mishawaka, IN-MI",41.774981,-86.123014,323695
8740,43780,45-49,9159,8816,17975,"South Bend-Mishawaka, IN-MI",41.774981,-86.123014,323695
8741,43780,50-54,9805,9675,19480,"South Bend-Mishawaka, IN-MI",41.774981,-86.123014,323695
8742,43780,55-59,10346,9901,20247,"South Bend-Mishawaka, IN-MI",41.774981,-86.123014,323695
8743,43780,60-64,10537,10205,20742,"South Bend-Mishawaka, IN-MI",41.774981,-86.123014,323695
8744,43780,65+,30694,25519,56213,"South Bend-Mishawaka, IN-MI",41.774981,-86.123014,323695
8745,43900,15-19,11020,11375,22395,"Spartanburg, SC",34.932014,-81.991624,335864
8746,43900,20-24,10438,10347,20785,"Spartanburg, SC",34.932014,-81.991624,335864
8747,43900,25-29,11506,11324,22830,"Spartanburg, SC",34.932014,-81.991624,335864
8748,43900,30-34,12425,11625,24050,"Spartanburg, SC",34.932014,-81.991624,335864
8749,43900,35-39,10713,10369,21082,"Spartanburg, SC",34.932014,-81.991624,335864
8750,43900,40-44,10227,9909,20136,"Spartanburg, SC",34.932014,-81.991624,335864
8751,43900,45-49,10268,9931,20199,"Spartanburg, SC",34.932014,-81.991624,335864
8752,43900,50-54,11112,10919,22031,"Spartanburg, SC",34.932014,-81.991624,335864
8753,43900,55-59,11246,11043,22289,"Spartanburg, SC",34.932014,-81.991624,335864
8754,43900,60-64,10622,9910,20532,"Spartanburg, SC",34.932014,-81.991624,335864
8755,43900,65+,30546,24352,54898,"Spartanburg, SC",34.932014,-81.991624,335864
8756,43940,15-19,921,913,1834,"Spearfish, SD",44.348514,-103.806362,26165
8757,43940,20-24,1023,963,1986,"Spearfish, SD",44.348514,-103.806362,26165
8758,43940,25-29,682,696,1378,"Spearfish, SD",44.348514,-103.806362,26165
8759,43940,30-34,703,802,1505,"Spearfish, SD",44.348514,-103.806362,26165
8760,43940,35-39,759,850,1609,"Spearfish, SD",44.348514,-103.806362,26165
8761,43940,40-44,682,789,1471,"Spearfish, SD",44.348514,-103.806362,26165
8762,43940,45-49,626,631,1257,"Spearfish, SD",44.348514,-103.806362,26165
8763,43940,50-54,707,737,1444,"Spearfish, SD",44.348514,-103.806362,26165
8764,43940,55-59,864,845,1709,"Spearfish, SD",44.348514,-103.806362,26165
8765,43940,60-64,1154,1035,2189,"Spearfish, SD",44.348514,-103.806362,26165
8766,43940,65+,3110,3070,6180,"Spearfish, SD",44.348514,-103.806362,26165
8767,43980,15-19,520,502,1022,"Spencer, IA",43.081224,-95.149875,16440
8768,43980,20-24,419,400,819,"Spencer, IA",43.081224,-95.149875,16440
8769,43980,25-29,427,443,870,"Spencer, IA",43.081224,-95.149875,16440
8770,43980,30-34,463,500,963,"Spencer, IA",43.081224,-95.149875,16440
8771,43980,35-39,514,509,1023,"Spencer, IA",43.081224,-95.149875,16440
8772,43980,40-44,482,493,975,"Spencer, IA",43.081224,-95.149875,16440
8773,43980,45-49,434,448,882,"Spencer, IA",43.081224,-95.149875,16440
8774,43980,50-54,444,469,913,"Spencer, IA",43.081224,-95.149875,16440
8775,43980,55-59,510,518,1028,"Spencer, IA",43.081224,-95.149875,16440
8776,43980,60-64,636,616,1252,"Spencer, IA",43.081224,-95.149875,16440
8777,43980,65+,1919,1675,3594,"Spencer, IA",43.081224,-95.149875,16440
8778,44020,15-19,427,503,930,"Spirit Lake, IA",43.389611,-95.196057,17851
8779,44020,20-24,457,421,878,"Spirit Lake, IA",43.389611,-95.196057,17851
8780,44020,25-29,433,435,868,"Spirit Lake, IA",43.389611,-95.196057,17851
8781,44020,30-34,425,485,910,"Spirit Lake, IA",43.389611,-95.196057,17851
8782,44020,35-39,442,506,948,"Spirit Lake, IA",43.389611,-95.196057,17851
8783,44020,40-44,473,512,985,"Spirit Lake, IA",43.389611,-95.196057,17851
8784,44020,45-49,430,470,900,"Spirit Lake, IA",43.389611,-95.196057,17851
8785,44020,50-54,532,542,1074,"Spirit Lake, IA",43.389611,-95.196057,17851
8786,44020,55-59,608,589,1197,"Spirit Lake, IA",43.389611,-95.196057,17851
8787,44020,60-64,750,720,1470,"Spirit Lake, IA",43.389611,-95.196057,17851
8788,44020,65+,2579,2265,4844,"Spirit Lake, IA",43.389611,-95.196057,17851
8789,44060,15-19,18160,19032,37192,"Spokane-Spokane Valley, WA",48.091618,-117.663472,593466
8790,44060,20-24,18184,19305,37489,"Spokane-Spokane Valley, WA",48.091618,-117.663472,593466
8791,44060,25-29,20555,21577,42132,"Spokane-Spokane Valley, WA",48.091618,-117.663472,593466
8792,44060,30-34,21485,22653,44138,"Spokane-Spokane Valley, WA",48.091618,-117.663472,593466
8793,44060,35-39,20116,20959,41075,"Spokane-Spokane Valley, WA",48.091618,-117.663472,593466
8794,44060,40-44,18145,18807,36952,"Spokane-Spokane Valley, WA",48.091618,-117.663472,593466
8795,44060,45-49,16279,16718,32997,"Spokane-Spokane Valley, WA",48.091618,-117.663472,593466
8796,44060,50-54,17543,17706,35249,"Spokane-Spokane Valley, WA",48.091618,-117.663472,593466
8797,44060,55-59,18982,18190,37172,"Spokane-Spokane Valley, WA",48.091618,-117.663472,593466
8798,44060,60-64,20049,19026,39075,"Spokane-Spokane Valley, WA",48.091618,-117.663472,593466
8799,44060,65+,55542,47961,103503,"Spokane-Spokane Valley, WA",48.091618,-117.663472,593466
8800,44100,15-19,6313,6687,13000,"Springfield, IL",39.828611,-89.696084,206898
8801,44100,20-24,5936,5884,11820,"Springfield, IL",39.828611,-89.696084,206898
8802,44100,25-29,6295,5892,12187,"Springfield, IL",39.828611,-89.696084,206898
8803,44100,30-34,6691,6098,12789,"Springfield, IL",39.828611,-89.696084,206898
8804,44100,35-39,7000,6427,13427,"Springfield, IL",39.828611,-89.696084,206898
8805,44100,40-44,6657,6476,13133,"Springfield, IL",39.828611,-89.696084,206898
8806,44100,45-49,6110,5861,11971,"Springfield, IL",39.828611,-89.696084,206898
8807,44100,50-54,6667,6427,13094,"Springfield, IL",39.828611,-89.696084,206898
8808,44100,55-59,7442,7133,14575,"Springfield, IL",39.828611,-89.696084,206898
8809,44100,60-64,7568,7058,14626,"Springfield, IL",39.828611,-89.696084,206898
8810,44100,65+,22181,16908,39089,"Springfield, IL",39.828611,-89.696084,206898
8811,44140,15-19,27457,25977,53434,"Springfield, MA",42.364833,-72.619406,695305
8812,44140,20-24,30828,28551,59379,"Springfield, MA",42.364833,-72.619406,695305
8813,44140,25-29,21554,21614,43168,"Springfield, MA",42.364833,-72.619406,695305
8814,44140,30-34,22067,21726,43793,"Springfield, MA",42.364833,-72.619406,695305
8815,44140,35-39,21639,20834,42473,"Springfield, MA",42.364833,-72.619406,695305
8816,44140,40-44,20706,18985,39691,"Springfield, MA",42.364833,-72.619406,695305
8817,44140,45-49,19707,18037,37744,"Springfield, MA",42.364833,-72.619406,695305
8818,44140,50-54,22512,20846,43358,"Springfield, MA",42.364833,-72.619406,695305
8819,44140,55-59,24595,22733,47328,"Springfield, MA",42.364833,-72.619406,695305
8820,44140,60-64,25046,23069,48115,"Springfield, MA",42.364833,-72.619406,695305
8821,44140,65+,71785,57432,129217,"Springfield, MA",42.364833,-72.619406,695305
8822,44180,15-19,16075,16368,32443,"Springfield, MO",37.36087,-93.180262,481483
8823,44180,20-24,20864,20121,40985,"Springfield, MO",37.36087,-93.180262,481483
8824,44180,25-29,16167,16472,32639,"Springfield, MO",37.36087,-93.180262,481483
8825,44180,30-34,15405,15407,30812,"Springfield, MO",37.36087,-93.180262,481483
8826,44180,35-39,15337,15615,30952,"Springfield, MO",37.36087,-93.180262,481483
8827,44180,40-44,14424,15010,29434,"Springfield, MO",37.36087,-93.180262,481483
8828,44180,45-49,13282,13457,26739,"Springfield, MO",37.36087,-93.180262,481483
8829,44180,50-54,13867,14023,27890,"Springfield, MO",37.36087,-93.180262,481483
8830,44180,55-59,14891,14253,29144,"Springfield, MO",37.36087,-93.180262,481483
8831,44180,60-64,15323,14231,29554,"Springfield, MO",37.36087,-93.180262,481483
8832,44180,65+,45215,36057,81272,"Springfield, MO",37.36087,-93.180262,481483
8833,44220,15-19,4467,4565,9032,"Springfield, OH",39.917032,-83.783676,135633
8834,44220,20-24,4232,4203,8435,"Springfield, OH",39.917032,-83.783676,135633
8835,44220,25-29,3950,3952,7902,"Springfield, OH",39.917032,-83.783676,135633
8836,44220,30-34,4091,3937,8028,"Springfield, OH",39.917032,-83.783676,135633
8837,44220,35-39,3999,3810,7809,"Springfield, OH",39.917032,-83.783676,135633
8838,44220,40-44,3908,3629,7537,"Springfield, OH",39.917032,-83.783676,135633
8839,44220,45-49,3828,3740,7568,"Springfield, OH",39.917032,-83.783676,135633
8840,44220,50-54,4366,4390,8756,"Springfield, OH",39.917032,-83.783676,135633
8841,44220,55-59,4666,4577,9243,"Springfield, OH",39.917032,-83.783676,135633
8842,44220,60-64,4876,4513,9389,"Springfield, OH",39.917032,-83.783676,135633
8843,44220,65+,14787,12081,26868,"Springfield, OH",39.917032,-83.783676,135633
8844,44260,15-19,3087,3118,6205,"Starkville, MS",33.514617,-89.077508,61825
8845,44260,20-24,5527,6535,12062,"Starkville, MS",33.514617,-89.077508,61825
8846,44260,25-29,2237,2327,4564,"Starkville, MS",33.514617,-89.077508,61825
8847,44260,30-34,1841,1800,3641,"Starkville, MS",33.514617,-89.077508,61825
8848,44260,35-39,1703,1697,3400,"Starkville, MS",33.514617,-89.077508,61825
8849,44260,40-44,1497,1474,2971,"Starkville, MS",33.514617,-89.077508,61825
8850,44260,45-49,1348,1246,2594,"Starkville, MS",33.514617,-89.077508,61825
8851,44260,50-54,1413,1304,2717,"Starkville, MS",33.514617,-89.077508,61825
8852,44260,55-59,1574,1416,2990,"Starkville, MS",33.514617,-89.077508,61825
8853,44260,60-64,1638,1442,3080,"Starkville, MS",33.514617,-89.077508,61825
8854,44260,65+,4466,3595,8061,"Starkville, MS",33.514617,-89.077508,61825
8855,44300,15-19,7532,7664,15196,"State College, PA",40.909128,-77.847877,157527
8856,44300,20-24,11158,14190,25348,"State College, PA",40.909128,-77.847877,157527
8857,44300,25-29,4332,5743,10075,"State College, PA",40.909128,-77.847877,157527
8858,44300,30-34,4544,5874,10418,"State College, PA",40.909128,-77.847877,157527
8859,44300,35-39,3962,5026,8988,"State College, PA",40.909128,-77.847877,157527
8860,44300,40-44,3812,4800,8612,"State College, PA",40.909128,-77.847877,157527
8861,44300,45-49,3717,4295,8012,"State College, PA",40.909128,-77.847877,157527
8862,44300,50-54,4172,4752,8924,"State College, PA",40.909128,-77.847877,157527
8863,44300,55-59,4599,4778,9377,"State College, PA",40.909128,-77.847877,157527
8864,44300,60-64,4442,4661,9103,"State College, PA",40.909128,-77.847877,157527
8865,44300,65+,13094,11474,24568,"State College, PA",40.909128,-77.847877,157527
8866,44340,15-19,4663,4992,9655,"Statesboro, GA",32.394481,-81.741618,82442
8867,44340,20-24,6257,6320,12577,"Statesboro, GA",32.394481,-81.741618,82442
8868,44340,25-29,2756,2763,5519,"Statesboro, GA",32.394481,-81.741618,82442
8869,44340,30-34,2689,2535,5224,"Statesboro, GA",32.394481,-81.741618,82442
8870,44340,35-39,2456,2321,4777,"Statesboro, GA",32.394481,-81.741618,82442
8871,44340,40-44,2259,2125,4384,"Statesboro, GA",32.394481,-81.741618,82442
8872,44340,45-49,2120,1958,4078,"Statesboro, GA",32.394481,-81.741618,82442
8873,44340,50-54,2154,2085,4239,"Statesboro, GA",32.394481,-81.741618,82442
8874,44340,55-59,2199,2101,4300,"Statesboro, GA",32.394481,-81.741618,82442
8875,44340,60-64,2168,1952,4120,"Statesboro, GA",32.394481,-81.741618,82442
8876,44340,65+,5467,4526,9993,"Statesboro, GA",32.394481,-81.741618,82442
8877,44420,15-19,3436,3632,7068,"Staunton, VA",38.160958,-79.127632,125774
8878,44420,20-24,3425,3412,6837,"Staunton, VA",38.160958,-79.127632,125774
8879,44420,25-29,3788,3995,7783,"Staunton, VA",38.160958,-79.127632,125774
8880,44420,30-34,3871,4132,8003,"Staunton, VA",38.160958,-79.127632,125774
8881,44420,35-39,3853,4172,8025,"Staunton, VA",38.160958,-79.127632,125774
8882,44420,40-44,3851,3974,7825,"Staunton, VA",38.160958,-79.127632,125774
8883,44420,45-49,3605,3721,7326,"Staunton, VA",38.160958,-79.127632,125774
8884,44420,50-54,4013,4138,8151,"Staunton, VA",38.160958,-79.127632,125774
8885,44420,55-59,4602,4477,9079,"Staunton, VA",38.160958,-79.127632,125774
8886,44420,60-64,4691,4381,9072,"Staunton, VA",38.160958,-79.127632,125774
8887,44420,65+,14408,11963,26371,"Staunton, VA",38.160958,-79.127632,125774
8888,44460,15-19,629,737,1366,"Steamboat Springs, CO",40.483664,-106.987702,25091
8889,44460,20-24,515,630,1145,"Steamboat Springs, CO",40.483664,-106.987702,25091
8890,44460,25-29,775,827,1602,"Steamboat Springs, CO",40.483664,-106.987702,25091
8891,44460,30-34,851,1022,1873,"Steamboat Springs, CO",40.483664,-106.987702,25091
8892,44460,35-39,906,1051,1957,"Steamboat Springs, CO",40.483664,-106.987702,25091
8893,44460,40-44,904,969,1873,"Steamboat Springs, CO",40.483664,-106.987702,25091
8894,44460,45-49,789,928,1717,"Steamboat Springs, CO",40.483664,-106.987702,25091
8895,44460,50-54,871,971,1842,"Steamboat Springs, CO",40.483664,-106.987702,25091
8896,44460,55-59,836,857,1693,"Steamboat Springs, CO",40.483664,-106.987702,25091
8897,44460,60-64,991,1008,1999,"Steamboat Springs, CO",40.483664,-106.987702,25091
8898,44460,65+,2139,2353,4492,"Steamboat Springs, CO",40.483664,-106.987702,25091
8899,44500,15-19,2461,2153,4614,"Stephenville, TX",32.236661,-98.220507,43378
8900,44500,20-24,2795,2714,5509,"Stephenville, TX",32.236661,-98.220507,43378
8901,44500,25-29,1451,1400,2851,"Stephenville, TX",32.236661,-98.220507,43378
8902,44500,30-34,1318,1282,2600,"Stephenville, TX",32.236661,-98.220507,43378
8903,44500,35-39,1202,1229,2431,"Stephenville, TX",32.236661,-98.220507,43378
8904,44500,40-44,1132,1163,2295,"Stephenville, TX",32.236661,-98.220507,43378
8905,44500,45-49,1033,1019,2052,"Stephenville, TX",32.236661,-98.220507,43378
8906,44500,50-54,1111,1100,2211,"Stephenville, TX",32.236661,-98.220507,43378
8907,44500,55-59,1226,1223,2449,"Stephenville, TX",32.236661,-98.220507,43378
8908,44500,60-64,1190,1190,2380,"Stephenville, TX",32.236661,-98.220507,43378
8909,44500,65+,3442,2942,6384,"Stephenville, TX",32.236661,-98.220507,43378
8910,44540,15-19,536,824,1360,"Sterling, CO",40.728091,-103.090464,21487
8911,44540,20-24,538,940,1478,"Sterling, CO",40.728091,-103.090464,21487
8912,44540,25-29,568,1175,1743,"Sterling, CO",40.728091,-103.090464,21487
8913,44540,30-34,580,1087,1667,"Sterling, CO",40.728091,-103.090464,21487
8914,44540,35-39,573,1011,1584,"Sterling, CO",40.728091,-103.090464,21487
8915,44540,40-44,505,864,1369,"Sterling, CO",40.728091,-103.090464,21487
8916,44540,45-49,467,762,1229,"Sterling, CO",40.728091,-103.090464,21487
8917,44540,50-54,482,753,1235,"Sterling, CO",40.728091,-103.090464,21487
8918,44540,55-59,609,705,1314,"Sterling, CO",40.728091,-103.090464,21487
8919,44540,60-64,647,747,1394,"Sterling, CO",40.728091,-103.090464,21487
8920,44540,65+,2098,1800,3898,"Sterling, CO",40.728091,-103.090464,21487
8921,44580,15-19,1627,1752,3379,"Sterling, IL",41.750673,-89.911005,55305
8922,44580,20-24,1441,1568,3009,"Sterling, IL",41.750673,-89.911005,55305
8923,44580,25-29,1473,1559,3032,"Sterling, IL",41.750673,-89.911005,55305
8924,44580,30-34,1559,1592,3151,"Sterling, IL",41.750673,-89.911005,55305
8925,44580,35-39,1574,1531,3105,"Sterling, IL",41.750673,-89.911005,55305
8926,44580,40-44,1471,1564,3035,"Sterling, IL",41.750673,-89.911005,55305
8927,44580,45-49,1564,1642,3206,"Sterling, IL",41.750673,-89.911005,55305
8928,44580,50-54,1744,1789,3533,"Sterling, IL",41.750673,-89.911005,55305
8929,44580,55-59,1907,1892,3799,"Sterling, IL",41.750673,-89.911005,55305
8930,44580,60-64,2075,2018,4093,"Sterling, IL",41.750673,-89.911005,55305
8931,44580,65+,6458,5520,11978,"Sterling, IL",41.750673,-89.911005,55305
8932,44620,15-19,2747,2795,5542,"Stevens Point, WI",44.476246,-89.49807,70468
8933,44620,20-24,3785,4109,7894,"Stevens Point, WI",44.476246,-89.49807,70468
8934,44620,25-29,2145,2290,4435,"Stevens Point, WI",44.476246,-89.49807,70468
8935,44620,30-34,1849,2110,3959,"Stevens Point, WI",44.476246,-89.49807,70468
8936,44620,35-39,1959,2104,4063,"Stevens Point, WI",44.476246,-89.49807,70468
8937,44620,40-44,1969,2080,4049,"Stevens Point, WI",44.476246,-89.49807,70468
8938,44620,45-49,1738,1846,3584,"Stevens Point, WI",44.476246,-89.49807,70468
8939,44620,50-54,1913,2028,3941,"Stevens Point, WI",44.476246,-89.49807,70468
8940,44620,55-59,2299,2369,4668,"Stevens Point, WI",44.476246,-89.49807,70468
8941,44620,60-64,2361,2390,4751,"Stevens Point, WI",44.476246,-89.49807,70468
8942,44620,65+,6635,6030,12665,"Stevens Point, WI",44.476246,-89.49807,70468
8943,44660,15-19,4094,4078,8172,"Stillwater, OK",36.079225,-96.975255,81989
8944,44660,20-24,7473,8881,16354,"Stillwater, OK",36.079225,-96.975255,81989
8945,44660,25-29,2664,3245,5909,"Stillwater, OK",36.079225,-96.975255,81989
8946,44660,30-34,2170,2477,4647,"Stillwater, OK",36.079225,-96.975255,81989
8947,44660,35-39,2327,2349,4676,"Stillwater, OK",36.079225,-96.975255,81989
8948,44660,40-44,2008,2185,4193,"Stillwater, OK",36.079225,-96.975255,81989
8949,44660,45-49,1795,1863,3658,"Stillwater, OK",36.079225,-96.975255,81989
8950,44660,50-54,1629,1731,3360,"Stillwater, OK",36.079225,-96.975255,81989
8951,44660,55-59,1898,1729,3627,"Stillwater, OK",36.079225,-96.975255,81989
8952,44660,60-64,1957,1907,3864,"Stillwater, OK",36.079225,-96.975255,81989
8953,44660,65+,5918,4906,10824,"Stillwater, OK",36.079225,-96.975255,81989
8954,44700,15-19,28663,30639,59302,"Stockton, CA",37.934982,-121.272244,789410
8955,44700,20-24,25403,27096,52499,"Stockton, CA",37.934982,-121.272244,789410
8956,44700,25-29,26431,27678,54109,"Stockton, CA",37.934982,-121.272244,789410
8957,44700,30-34,27549,28481,56030,"Stockton, CA",37.934982,-121.272244,789410
8958,44700,35-39,27178,28351,55529,"Stockton, CA",37.934982,-121.272244,789410
8959,44700,40-44,25941,26799,52740,"Stockton, CA",37.934982,-121.272244,789410
8960,44700,45-49,23401,23942,47343,"Stockton, CA",37.934982,-121.272244,789410
8961,44700,50-54,23312,23930,47242,"Stockton, CA",37.934982,-121.272244,789410
8962,44700,55-59,22700,23107,45807,"Stockton, CA",37.934982,-121.272244,789410
8963,44700,60-64,21523,20824,42347,"Stockton, CA",37.934982,-121.272244,789410
8964,44700,65+,56999,46227,103226,"Stockton, CA",37.934982,-121.272244,789410
8965,44740,15-19,766,917,1683,"Storm Lake, IA",42.741522,-95.141432,20771
8966,44740,20-24,739,717,1456,"Storm Lake, IA",42.741522,-95.141432,20771
8967,44740,25-29,619,616,1235,"Storm Lake, IA",42.741522,-95.141432,20771
8968,44740,30-34,589,651,1240,"Storm Lake, IA",42.741522,-95.141432,20771
8969,44740,35-39,649,780,1429,"Storm Lake, IA",42.741522,-95.141432,20771
8970,44740,40-44,533,647,1180,"Storm Lake, IA",42.741522,-95.141432,20771
8971,44740,45-49,495,496,991,"Storm Lake, IA",42.741522,-95.141432,20771
8972,44740,50-54,527,546,1073,"Storm Lake, IA",42.741522,-95.141432,20771
8973,44740,55-59,569,606,1175,"Storm Lake, IA",42.741522,-95.141432,20771
8974,44740,60-64,680,694,1374,"Storm Lake, IA",42.741522,-95.141432,20771
8975,44740,65+,1737,1631,3368,"Storm Lake, IA",42.741522,-95.141432,20771
8976,44780,15-19,1902,2062,3964,"Sturgis, MI",41.911488,-85.52287,60758
8977,44780,20-24,1637,1749,3386,"Sturgis, MI",41.911488,-85.52287,60758
8978,44780,25-29,1756,1852,3608,"Sturgis, MI",41.911488,-85.52287,60758
8979,44780,30-34,1742,1911,3653,"Sturgis, MI",41.911488,-85.52287,60758
8980,44780,35-39,1822,1848,3670,"Sturgis, MI",41.911488,-85.52287,60758
8981,44780,40-44,1759,1761,3520,"Sturgis, MI",41.911488,-85.52287,60758
8982,44780,45-49,1666,1685,3351,"Sturgis, MI",41.911488,-85.52287,60758
8983,44780,50-54,1659,1917,3576,"Sturgis, MI",41.911488,-85.52287,60758
8984,44780,55-59,2068,2087,4155,"Sturgis, MI",41.911488,-85.52287,60758
8985,44780,60-64,2173,2174,4347,"Sturgis, MI",41.911488,-85.52287,60758
8986,44780,65+,6084,5281,11365,"Sturgis, MI",41.911488,-85.52287,60758
8987,44860,15-19,1246,1263,2509,"Sulphur Springs, TX",33.148967,-95.565434,37211
8988,44860,20-24,1037,1092,2129,"Sulphur Springs, TX",33.148967,-95.565434,37211
8989,44860,25-29,1103,1175,2278,"Sulphur Springs, TX",33.148967,-95.565434,37211
8990,44860,30-34,1183,1093,2276,"Sulphur Springs, TX",33.148967,-95.565434,37211
8991,44860,35-39,1161,1130,2291,"Sulphur Springs, TX",33.148967,-95.565434,37211
8992,44860,40-44,1028,1026,2054,"Sulphur Springs, TX",33.148967,-95.565434,37211
8993,44860,45-49,1129,1041,2170,"Sulphur Springs, TX",33.148967,-95.565434,37211
8994,44860,50-54,1149,1154,2303,"Sulphur Springs, TX",33.148967,-95.565434,37211
8995,44860,55-59,1256,1230,2486,"Sulphur Springs, TX",33.148967,-95.565434,37211
8996,44860,60-64,1223,1188,2411,"Sulphur Springs, TX",33.148967,-95.565434,37211
8997,44860,65+,3751,3135,6886,"Sulphur Springs, TX",33.148967,-95.565434,37211
8998,44900,15-19,684,784,1468,"Summerville, GA",34.474178,-85.345289,24932
8999,44900,20-24,656,833,1489,"Summerville, GA",34.474178,-85.345289,24932
9000,44900,25-29,703,918,1621,"Summerville, GA",34.474178,-85.345289,24932
9001,44900,30-34,697,871,1568,"Summerville, GA",34.474178,-85.345289,24932
9002,44900,35-39,699,774,1473,"Summerville, GA",34.474178,-85.345289,24932
9003,44900,40-44,710,829,1539,"Summerville, GA",34.474178,-85.345289,24932
9004,44900,45-49,700,834,1534,"Summerville, GA",34.474178,-85.345289,24932
9005,44900,50-54,806,864,1670,"Summerville, GA",34.474178,-85.345289,24932
9006,44900,55-59,840,809,1649,"Summerville, GA",34.474178,-85.345289,24932
9007,44900,60-64,905,837,1742,"Summerville, GA",34.474178,-85.345289,24932
9008,44900,65+,2534,2066,4600,"Summerville, GA",34.474178,-85.345289,24932
9009,44940,15-19,4101,4383,8484,"Sumter, SC",33.792654,-80.294055,135782
9010,44940,20-24,4334,5377,9711,"Sumter, SC",33.792654,-80.294055,135782
9011,44940,25-29,4403,4718,9121,"Sumter, SC",33.792654,-80.294055,135782
9012,44940,30-34,4592,4310,8902,"Sumter, SC",33.792654,-80.294055,135782
9013,44940,35-39,4117,3815,7932,"Sumter, SC",33.792654,-80.294055,135782
9014,44940,40-44,3917,3569,7486,"Sumter, SC",33.792654,-80.294055,135782
9015,44940,45-49,3597,3262,6859,"Sumter, SC",33.792654,-80.294055,135782
9016,44940,50-54,4279,3678,7957,"Sumter, SC",33.792654,-80.294055,135782
9017,44940,55-59,4650,4202,8852,"Sumter, SC",33.792654,-80.294055,135782
9018,44940,60-64,4901,4300,9201,"Sumter, SC",33.792654,-80.294055,135782
9019,44940,65+,14666,11104,25770,"Sumter, SC",33.792654,-80.294055,135782
9020,44980,15-19,2308,2678,4986,"Sunbury, PA",40.851524,-76.709877,91266
9021,44980,20-24,2160,2607,4767,"Sunbury, PA",40.851524,-76.709877,91266
9022,44980,25-29,2490,2914,5404,"Sunbury, PA",40.851524,-76.709877,91266
9023,44980,30-34,2611,3013,5624,"Sunbury, PA",40.851524,-76.709877,91266
9024,44980,35-39,2663,2930,5593,"Sunbury, PA",40.851524,-76.709877,91266
9025,44980,40-44,2514,2834,5348,"Sunbury, PA",40.851524,-76.709877,91266
9026,44980,45-49,2494,2772,5266,"Sunbury, PA",40.851524,-76.709877,91266
9027,44980,50-54,2863,3159,6022,"Sunbury, PA",40.851524,-76.709877,91266
9028,44980,55-59,3315,3428,6743,"Sunbury, PA",40.851524,-76.709877,91266
9029,44980,60-64,3458,3363,6821,"Sunbury, PA",40.851524,-76.709877,91266
9030,44980,65+,10908,9107,20015,"Sunbury, PA",40.851524,-76.709877,91266
9031,45000,15-19,686,906,1592,"Susanville, CA",40.715287,-120.621223,33159
9032,45000,20-24,565,1782,2347,"Susanville, CA",40.715287,-120.621223,33159
9033,45000,25-29,787,2309,3096,"Susanville, CA",40.715287,-120.621223,33159
9034,45000,30-34,810,2245,3055,"Susanville, CA",40.715287,-120.621223,33159
9035,45000,35-39,772,1950,2722,"Susanville, CA",40.715287,-120.621223,33159
9036,45000,40-44,683,1602,2285,"Susanville, CA",40.715287,-120.621223,33159
9037,45000,45-49,681,1486,2167,"Susanville, CA",40.715287,-120.621223,33159
9038,45000,50-54,727,1198,1925,"Susanville, CA",40.715287,-120.621223,33159
9039,45000,55-59,827,1037,1864,"Susanville, CA",40.715287,-120.621223,33159
9040,45000,60-64,891,1002,1893,"Susanville, CA",40.715287,-120.621223,33159
9041,45000,65+,2700,2585,5285,"Susanville, CA",40.715287,-120.621223,33159
9042,45020,15-19,504,646,1150,"Sweetwater, TX",32.312338,-100.418108,14597
9043,45020,20-24,364,522,886,"Sweetwater, TX",32.312338,-100.418108,14597
9044,45020,25-29,386,427,813,"Sweetwater, TX",32.312338,-100.418108,14597
9045,45020,30-34,400,413,813,"Sweetwater, TX",32.312338,-100.418108,14597
9046,45020,35-39,429,447,876,"Sweetwater, TX",32.312338,-100.418108,14597
9047,45020,40-44,459,426,885,"Sweetwater, TX",32.312338,-100.418108,14597
9048,45020,45-49,402,396,798,"Sweetwater, TX",32.312338,-100.418108,14597
9049,45020,50-54,434,456,890,"Sweetwater, TX",32.312338,-100.418108,14597
9050,45020,55-59,429,430,859,"Sweetwater, TX",32.312338,-100.418108,14597
9051,45020,60-64,447,395,842,"Sweetwater, TX",32.312338,-100.418108,14597
9052,45020,65+,1446,1254,2700,"Sweetwater, TX",32.312338,-100.418108,14597
9053,45060,15-19,23478,22952,46430,"Syracuse, NY",43.006516,-76.196134,658281
9054,45060,20-24,22533,22194,44727,"Syracuse, NY",43.006516,-76.196134,658281
9055,45060,25-29,20595,20306,40901,"Syracuse, NY",43.006516,-76.196134,658281
9056,45060,30-34,21335,21194,42529,"Syracuse, NY",43.006516,-76.196134,658281
9057,45060,35-39,20626,20366,40992,"Syracuse, NY",43.006516,-76.196134,658281
9058,45060,40-44,18917,18505,37422,"Syracuse, NY",43.006516,-76.196134,658281
9059,45060,45-49,17767,17131,34898,"Syracuse, NY",43.006516,-76.196134,658281
9060,45060,50-54,21520,20866,42386,"Syracuse, NY",43.006516,-76.196134,658281
9061,45060,55-59,24519,23593,48112,"Syracuse, NY",43.006516,-76.196134,658281
9062,45060,60-64,24041,23401,47442,"Syracuse, NY",43.006516,-76.196134,658281
9063,45060,65+,65298,54187,119485,"Syracuse, NY",43.006516,-76.196134,658281
9064,45140,15-19,1798,1757,3555,"Tahlequah, OK",35.904367,-94.996796,47627
9065,45140,20-24,2557,2582,5139,"Tahlequah, OK",35.904367,-94.996796,47627
9066,45140,25-29,1565,1520,3085,"Tahlequah, OK",35.904367,-94.996796,47627
9067,45140,30-34,1385,1314,2699,"Tahlequah, OK",35.904367,-94.996796,47627
9068,45140,35-39,1409,1485,2894,"Tahlequah, OK",35.904367,-94.996796,47627
9069,45140,40-44,1391,1350,2741,"Tahlequah, OK",35.904367,-94.996796,47627
9070,45140,45-49,1246,1200,2446,"Tahlequah, OK",35.904367,-94.996796,47627
9071,45140,50-54,1295,1235,2530,"Tahlequah, OK",35.904367,-94.996796,47627
9072,45140,55-59,1490,1332,2822,"Tahlequah, OK",35.904367,-94.996796,47627
9073,45140,60-64,1580,1351,2931,"Tahlequah, OK",35.904367,-94.996796,47627
9074,45140,65+,4393,3814,8207,"Tahlequah, OK",35.904367,-94.996796,47627
9075,45180,15-19,2633,2387,5020,"Talladega-Sylacauga, AL",33.369314,-86.17593,81524
9076,45180,20-24,2652,2347,4999,"Talladega-Sylacauga, AL",33.369314,-86.17593,81524
9077,45180,25-29,2435,2627,5062,"Talladega-Sylacauga, AL",33.369314,-86.17593,81524
9078,45180,30-34,2668,2703,5371,"Talladega-Sylacauga, AL",33.369314,-86.17593,81524
9079,45180,35-39,2546,2338,4884,"Talladega-Sylacauga, AL",33.369314,-86.17593,81524
9080,45180,40-44,2531,2361,4892,"Talladega-Sylacauga, AL",33.369314,-86.17593,81524
9081,45180,45-49,2507,2515,5022,"Talladega-Sylacauga, AL",33.369314,-86.17593,81524
9082,45180,50-54,2843,2770,5613,"Talladega-Sylacauga, AL",33.369314,-86.17593,81524
9083,45180,55-59,2885,2735,5620,"Talladega-Sylacauga, AL",33.369314,-86.17593,81524
9084,45180,60-64,3060,2754,5814,"Talladega-Sylacauga, AL",33.369314,-86.17593,81524
9085,45180,65+,8401,7034,15435,"Talladega-Sylacauga, AL",33.369314,-86.17593,81524
9086,45220,15-19,16463,14639,31102,"Tallahassee, FL",30.346366,-84.267001,385776
9087,45220,20-24,26412,23270,49682,"Tallahassee, FL",30.346366,-84.267001,385776
9088,45220,25-29,13734,13764,27498,"Tallahassee, FL",30.346366,-84.267001,385776
9089,45220,30-34,12534,12279,24813,"Tallahassee, FL",30.346366,-84.267001,385776
9090,45220,35-39,11847,11572,23419,"Tallahassee, FL",30.346366,-84.267001,385776
9091,45220,40-44,11280,10919,22199,"Tallahassee, FL",30.346366,-84.267001,385776
9092,45220,45-49,10586,10136,20722,"Tallahassee, FL",30.346366,-84.267001,385776
9093,45220,50-54,10691,10793,21484,"Tallahassee, FL",30.346366,-84.267001,385776
9094,45220,55-59,11271,10367,21638,"Tallahassee, FL",30.346366,-84.267001,385776
9095,45220,60-64,11895,10300,22195,"Tallahassee, FL",30.346366,-84.267001,385776
9096,45220,65+,33141,26901,60042,"Tallahassee, FL",30.346366,-84.267001,385776
9097,45300,15-19,86670,91137,177807,"Tampa-St. Petersburg-Clearwater, FL",28.120541,-82.525188,3219514
9098,45300,20-24,87686,86985,174671,"Tampa-St. Petersburg-Clearwater, FL",28.120541,-82.525188,3219514
9099,45300,25-29,102275,101117,203392,"Tampa-St. Petersburg-Clearwater, FL",28.120541,-82.525188,3219514
9100,45300,30-34,111513,109206,220719,"Tampa-St. Petersburg-Clearwater, FL",28.120541,-82.525188,3219514
9101,45300,35-39,107188,105207,212395,"Tampa-St. Petersburg-Clearwater, FL",28.120541,-82.525188,3219514
9102,45300,40-44,102741,100474,203215,"Tampa-St. Petersburg-Clearwater, FL",28.120541,-82.525188,3219514
9103,45300,45-49,100262,97409,197671,"Tampa-St. Petersburg-Clearwater, FL",28.120541,-82.525188,3219514
9104,45300,50-54,107890,105878,213768,"Tampa-St. Petersburg-Clearwater, FL",28.120541,-82.525188,3219514
9105,45300,55-59,115292,109767,225059,"Tampa-St. Petersburg-Clearwater, FL",28.120541,-82.525188,3219514
9106,45300,60-64,115060,105559,220619,"Tampa-St. Petersburg-Clearwater, FL",28.120541,-82.525188,3219514
9107,45300,65+,355674,293247,648921,"Tampa-St. Petersburg-Clearwater, FL",28.120541,-82.525188,3219514
9108,45340,15-19,832,972,1804,"Taos, NM",36.577183,-105.638878,34623
9109,45340,20-24,727,793,1520,"Taos, NM",36.577183,-105.638878,34623
9110,45340,25-29,776,842,1618,"Taos, NM",36.577183,-105.638878,34623
9111,45340,30-34,907,932,1839,"Taos, NM",36.577183,-105.638878,34623
9112,45340,35-39,955,920,1875,"Taos, NM",36.577183,-105.638878,34623
9113,45340,40-44,979,1002,1981,"Taos, NM",36.577183,-105.638878,34623
9114,45340,45-49,894,968,1862,"Taos, NM",36.577183,-105.638878,34623
9115,45340,50-54,1057,1115,2172,"Taos, NM",36.577183,-105.638878,34623
9116,45340,55-59,1314,1171,2485,"Taos, NM",36.577183,-105.638878,34623
9117,45340,60-64,1493,1335,2828,"Taos, NM",36.577183,-105.638878,34623
9118,45340,65+,5313,4617,9930,"Taos, NM",36.577183,-105.638878,34623
9119,45380,15-19,910,1030,1940,"Taylorville, IL",39.545524,-89.279593,33662
9120,45380,20-24,814,1038,1852,"Taylorville, IL",39.545524,-89.279593,33662
9121,45380,25-29,903,1128,2031,"Taylorville, IL",39.545524,-89.279593,33662
9122,45380,30-34,926,1108,2034,"Taylorville, IL",39.545524,-89.279593,33662
9123,45380,35-39,916,1148,2064,"Taylorville, IL",39.545524,-89.279593,33662
9124,45380,40-44,952,1143,2095,"Taylorville, IL",39.545524,-89.279593,33662
9125,45380,45-49,891,1140,2031,"Taylorville, IL",39.545524,-89.279593,33662
9126,45380,50-54,1072,1151,2223,"Taylorville, IL",39.545524,-89.279593,33662
9127,45380,55-59,1225,1272,2497,"Taylorville, IL",39.545524,-89.279593,33662
9128,45380,60-64,1194,1310,2504,"Taylorville, IL",39.545524,-89.279593,33662
9129,45380,65+,3810,3099,6909,"Taylorville, IL",39.545524,-89.279593,33662
9130,45460,15-19,5961,6687,12648,"Terre Haute, IN",39.478401,-87.311132,184910
9131,45460,20-24,7645,8259,15904,"Terre Haute, IN",39.478401,-87.311132,184910
9132,45460,25-29,5721,6605,12326,"Terre Haute, IN",39.478401,-87.311132,184910
9133,45460,30-34,5305,6298,11603,"Terre Haute, IN",39.478401,-87.311132,184910
9134,45460,35-39,5260,6059,11319,"Terre Haute, IN",39.478401,-87.311132,184910
9135,45460,40-44,5244,5804,11048,"Terre Haute, IN",39.478401,-87.311132,184910
9136,45460,45-49,5082,5631,10713,"Terre Haute, IN",39.478401,-87.311132,184910
9137,45460,50-54,5315,5861,11176,"Terre Haute, IN",39.478401,-87.311132,184910
9138,45460,55-59,5729,5853,11582,"Terre Haute, IN",39.478401,-87.311132,184910
9139,45460,60-64,6074,5830,11904,"Terre Haute, IN",39.478401,-87.311132,184910
9140,45460,65+,18397,14549,32946,"Terre Haute, IN",39.478401,-87.311132,184910
9141,45500,15-19,4360,4915,9275,"Texarkana, TX-AR",33.478373,-94.207162,147174
9142,45500,20-24,4011,4758,8769,"Texarkana, TX-AR",33.478373,-94.207162,147174
9143,45500,25-29,4597,5186,9783,"Texarkana, TX-AR",33.478373,-94.207162,147174
9144,45500,30-34,4664,5174,9838,"Texarkana, TX-AR",33.478373,-94.207162,147174
9145,45500,35-39,4569,4784,9353,"Texarkana, TX-AR",33.478373,-94.207162,147174
9146,45500,40-44,4658,4775,9433,"Texarkana, TX-AR",33.478373,-94.207162,147174
9147,45500,45-49,4346,4401,8747,"Texarkana, TX-AR",33.478373,-94.207162,147174
9148,45500,50-54,4515,4633,9148,"Texarkana, TX-AR",33.478373,-94.207162,147174
9149,45500,55-59,4721,4606,9327,"Texarkana, TX-AR",33.478373,-94.207162,147174
9150,45500,60-64,4746,4395,9141,"Texarkana, TX-AR",33.478373,-94.207162,147174
9151,45500,65+,14356,11365,25721,"Texarkana, TX-AR",33.478373,-94.207162,147174
9152,45520,15-19,695,817,1512,"The Dalles, OR",45.164536,-121.165069,26726
9153,45520,20-24,682,688,1370,"The Dalles, OR",45.164536,-121.165069,26726
9154,45520,25-29,838,900,1738,"The Dalles, OR",45.164536,-121.165069,26726
9155,45520,30-34,912,946,1858,"The Dalles, OR",45.164536,-121.165069,26726
9156,45520,35-39,863,935,1798,"The Dalles, OR",45.164536,-121.165069,26726
9157,45520,40-44,751,805,1556,"The Dalles, OR",45.164536,-121.165069,26726
9158,45520,45-49,721,713,1434,"The Dalles, OR",45.164536,-121.165069,26726
9159,45520,50-54,724,742,1466,"The Dalles, OR",45.164536,-121.165069,26726
9160,45520,55-59,838,782,1620,"The Dalles, OR",45.164536,-121.165069,26726
9161,45520,60-64,979,911,1890,"The Dalles, OR",45.164536,-121.165069,26726
9162,45520,65+,2922,2710,5632,"The Dalles, OR",45.164536,-121.165069,26726
9163,45540,15-19,1233,1325,2558,"The Villages, FL",28.715444,-82.069952,135638
9164,45540,20-24,1213,1690,2903,"The Villages, FL",28.715444,-82.069952,135638
9165,45540,25-29,1389,2200,3589,"The Villages, FL",28.715444,-82.069952,135638
9166,45540,30-34,1514,2718,4232,"The Villages, FL",28.715444,-82.069952,135638
9167,45540,35-39,1427,2852,4279,"The Villages, FL",28.715444,-82.069952,135638
9168,45540,40-44,1533,2418,3951,"The Villages, FL",28.715444,-82.069952,135638
9169,45540,45-49,1685,2283,3968,"The Villages, FL",28.715444,-82.069952,135638
9170,45540,50-54,2200,2491,4691,"The Villages, FL",28.715444,-82.069952,135638
9171,45540,55-59,3851,3337,7188,"The Villages, FL",28.715444,-82.069952,135638
9172,45540,60-64,6583,4914,11497,"The Villages, FL",28.715444,-82.069952,135638
9173,45540,65+,41571,37331,78902,"The Villages, FL",28.715444,-82.069952,135638
9174,45580,15-19,820,813,1633,"Thomaston, GA",32.881837,-84.292283,27720
9175,45580,20-24,832,799,1631,"Thomaston, GA",32.881837,-84.292283,27720
9176,45580,25-29,908,874,1782,"Thomaston, GA",32.881837,-84.292283,27720
9177,45580,30-34,892,822,1714,"Thomaston, GA",32.881837,-84.292283,27720
9178,45580,35-39,796,699,1495,"Thomaston, GA",32.881837,-84.292283,27720
9179,45580,40-44,833,799,1632,"Thomaston, GA",32.881837,-84.292283,27720
9180,45580,45-49,872,776,1648,"Thomaston, GA",32.881837,-84.292283,27720
9181,45580,50-54,945,888,1833,"Thomaston, GA",32.881837,-84.292283,27720
9182,45580,55-59,1020,978,1998,"Thomaston, GA",32.881837,-84.292283,27720
9183,45580,60-64,1046,936,1982,"Thomaston, GA",32.881837,-84.292283,27720
9184,45580,65+,2925,2232,5157,"Thomaston, GA",32.881837,-84.292283,27720
9185,45620,15-19,1422,1478,2900,"Thomasville, GA",30.864619,-83.919815,45842
9186,45620,20-24,1361,1283,2644,"Thomasville, GA",30.864619,-83.919815,45842
9187,45620,25-29,1423,1269,2692,"Thomasville, GA",30.864619,-83.919815,45842
9188,45620,30-34,1423,1248,2671,"Thomasville, GA",30.864619,-83.919815,45842
9189,45620,35-39,1517,1326,2843,"Thomasville, GA",30.864619,-83.919815,45842
9190,45620,40-44,1411,1295,2706,"Thomasville, GA",30.864619,-83.919815,45842
9191,45620,45-49,1367,1141,2508,"Thomasville, GA",30.864619,-83.919815,45842
9192,45620,50-54,1478,1402,2880,"Thomasville, GA",30.864619,-83.919815,45842
9193,45620,55-59,1658,1518,3176,"Thomasville, GA",30.864619,-83.919815,45842
9194,45620,60-64,1678,1437,3115,"Thomasville, GA",30.864619,-83.919815,45842
9195,45620,65+,4888,3794,8682,"Thomasville, GA",30.864619,-83.919815,45842
9196,45660,15-19,1998,2227,4225,"Tiffin, OH",41.119992,-83.127547,54906
9197,45660,20-24,1782,2072,3854,"Tiffin, OH",41.119992,-83.127547,54906
9198,45660,25-29,1563,1642,3205,"Tiffin, OH",41.119992,-83.127547,54906
9199,45660,30-34,1560,1649,3209,"Tiffin, OH",41.119992,-83.127547,54906
9200,45660,35-39,1550,1589,3139,"Tiffin, OH",41.119992,-83.127547,54906
9201,45660,40-44,1614,1795,3409,"Tiffin, OH",41.119992,-83.127547,54906
9202,45660,45-49,1536,1554,3090,"Tiffin, OH",41.119992,-83.127547,54906
9203,45660,50-54,1554,1624,3178,"Tiffin, OH",41.119992,-83.127547,54906
9204,45660,55-59,1825,1869,3694,"Tiffin, OH",41.119992,-83.127547,54906
9205,45660,60-64,2016,1923,3939,"Tiffin, OH",41.119992,-83.127547,54906
9206,45660,65+,5597,4791,10388,"Tiffin, OH",41.119992,-83.127547,54906
9207,45700,15-19,1655,1665,3320,"Tifton, GA",31.457003,-83.525931,41212
9208,45700,20-24,1443,1424,2867,"Tifton, GA",31.457003,-83.525931,41212
9209,45700,25-29,1369,1281,2650,"Tifton, GA",31.457003,-83.525931,41212
9210,45700,30-34,1404,1318,2722,"Tifton, GA",31.457003,-83.525931,41212
9211,45700,35-39,1274,1253,2527,"Tifton, GA",31.457003,-83.525931,41212
9212,45700,40-44,1337,1253,2590,"Tifton, GA",31.457003,-83.525931,41212
9213,45700,45-49,1194,1143,2337,"Tifton, GA",31.457003,-83.525931,41212
9214,45700,50-54,1227,1215,2442,"Tifton, GA",31.457003,-83.525931,41212
9215,45700,55-59,1228,1181,2409,"Tifton, GA",31.457003,-83.525931,41212
9216,45700,60-64,1301,1128,2429,"Tifton, GA",31.457003,-83.525931,41212
9217,45700,65+,3758,2749,6507,"Tifton, GA",31.457003,-83.525931,41212
9218,45740,15-19,892,875,1767,"Toccoa, GA",34.553582,-83.290588,26865
9219,45740,20-24,939,867,1806,"Toccoa, GA",34.553582,-83.290588,26865
9220,45740,25-29,785,766,1551,"Toccoa, GA",34.553582,-83.290588,26865
9221,45740,30-34,806,762,1568,"Toccoa, GA",34.553582,-83.290588,26865
9222,45740,35-39,751,719,1470,"Toccoa, GA",34.553582,-83.290588,26865
9223,45740,40-44,765,737,1502,"Toccoa, GA",34.553582,-83.290588,26865
9224,45740,45-49,771,667,1438,"Toccoa, GA",34.553582,-83.290588,26865
9225,45740,50-54,872,837,1709,"Toccoa, GA",34.553582,-83.290588,26865
9226,45740,55-59,895,905,1800,"Toccoa, GA",34.553582,-83.290588,26865
9227,45740,60-64,989,892,1881,"Toccoa, GA",34.553582,-83.290588,26865
9228,45740,65+,2942,2498,5440,"Toccoa, GA",34.553582,-83.290588,26865
9229,45780,15-19,21641,22206,43847,"Toledo, OH",41.555313,-83.517088,644217
9230,45780,20-24,23113,23065,46178,"Toledo, OH",41.555313,-83.517088,644217
9231,45780,25-29,21354,21369,42723,"Toledo, OH",41.555313,-83.517088,644217
9232,45780,30-34,21618,21439,43057,"Toledo, OH",41.555313,-83.517088,644217
9233,45780,35-39,19560,19214,38774,"Toledo, OH",41.555313,-83.517088,644217
9234,45780,40-44,18672,18366,37038,"Toledo, OH",41.555313,-83.517088,644217
9235,45780,45-49,18555,17848,36403,"Toledo, OH",41.555313,-83.517088,644217
9236,45780,50-54,19829,19341,39170,"Toledo, OH",41.555313,-83.517088,644217
9237,45780,55-59,21365,20447,41812,"Toledo, OH",41.555313,-83.517088,644217
9238,45780,60-64,22612,21504,44116,"Toledo, OH",41.555313,-83.517088,644217
9239,45780,65+,62493,50750,113243,"Toledo, OH",41.555313,-83.517088,644217
9240,45820,15-19,7421,8158,15579,"Topeka, KS",39.041389,-95.802639,232670
9241,45820,20-24,6769,6770,13539,"Topeka, KS",39.041389,-95.802639,232670
9242,45820,25-29,6761,6764,13525,"Topeka, KS",39.041389,-95.802639,232670
9243,45820,30-34,6887,6643,13530,"Topeka, KS",39.041389,-95.802639,232670
9244,45820,35-39,7417,7042,14459,"Topeka, KS",39.041389,-95.802639,232670
9245,45820,40-44,7055,7135,14190,"Topeka, KS",39.041389,-95.802639,232670
9246,45820,45-49,6404,6323,12727,"Topeka, KS",39.041389,-95.802639,232670
9247,45820,50-54,6940,6835,13775,"Topeka, KS",39.041389,-95.802639,232670
9248,45820,55-59,8078,7725,15803,"Topeka, KS",39.041389,-95.802639,232670
9249,45820,60-64,8404,7900,16304,"Topeka, KS",39.041389,-95.802639,232670
9250,45820,65+,24533,20534,45067,"Topeka, KS",39.041389,-95.802639,232670
9251,45860,15-19,4946,5363,10309,"Torrington, CT",41.791883,-73.235404,185000
9252,45860,20-24,4656,4948,9604,"Torrington, CT",41.791883,-73.235404,185000
9253,45860,25-29,4851,5233,10084,"Torrington, CT",41.791883,-73.235404,185000
9254,45860,30-34,4902,5208,10110,"Torrington, CT",41.791883,-73.235404,185000
9255,45860,35-39,5173,5411,10584,"Torrington, CT",41.791883,-73.235404,185000
9256,45860,40-44,5096,5232,10328,"Torrington, CT",41.791883,-73.235404,185000
9257,45860,45-49,5200,5126,10326,"Torrington, CT",41.791883,-73.235404,185000
9258,45860,50-54,6944,6808,13752,"Torrington, CT",41.791883,-73.235404,185000
9259,45860,55-59,7966,7848,15814,"Torrington, CT",41.791883,-73.235404,185000
9260,45860,60-64,8010,7965,15975,"Torrington, CT",41.791883,-73.235404,185000
9261,45860,65+,22406,19763,42169,"Torrington, CT",41.791883,-73.235404,185000
9262,45900,15-19,4121,4402,8523,"Traverse City, MI",44.952324,-85.90832,154685
9263,45900,20-24,3717,3908,7625,"Traverse City, MI",44.952324,-85.90832,154685
9264,45900,25-29,4113,4360,8473,"Traverse City, MI",44.952324,-85.90832,154685
9265,45900,30-34,4550,4574,9124,"Traverse City, MI",44.952324,-85.90832,154685
9266,45900,35-39,4716,4880,9596,"Traverse City, MI",44.952324,-85.90832,154685
9267,45900,40-44,4449,4533,8982,"Traverse City, MI",44.952324,-85.90832,154685
9268,45900,45-49,4060,4156,8216,"Traverse City, MI",44.952324,-85.90832,154685
9269,45900,50-54,4659,4757,9416,"Traverse City, MI",44.952324,-85.90832,154685
9270,45900,55-59,5742,5438,11180,"Traverse City, MI",44.952324,-85.90832,154685
9271,45900,60-64,6712,6290,13002,"Traverse City, MI",44.952324,-85.90832,154685
9272,45900,65+,19330,17326,36656,"Traverse City, MI",44.952324,-85.90832,154685
9273,45940,15-19,14103,14113,28216,"Trenton-Princeton, NJ",40.282503,-74.703724,385898
9274,45940,20-24,14591,14284,28875,"Trenton-Princeton, NJ",40.282503,-74.703724,385898
9275,45940,25-29,11537,12204,23741,"Trenton-Princeton, NJ",40.282503,-74.703724,385898
9276,45940,30-34,11578,12068,23646,"Trenton-Princeton, NJ",40.282503,-74.703724,385898
9277,45940,35-39,12016,12248,24264,"Trenton-Princeton, NJ",40.282503,-74.703724,385898
9278,45940,40-44,12507,12604,25111,"Trenton-Princeton, NJ",40.282503,-74.703724,385898
9279,45940,45-49,12559,12620,25179,"Trenton-Princeton, NJ",40.282503,-74.703724,385898
9280,45940,50-54,13318,13197,26515,"Trenton-Princeton, NJ",40.282503,-74.703724,385898
9281,45940,55-59,13408,13101,26509,"Trenton-Princeton, NJ",40.282503,-74.703724,385898
9282,45940,60-64,12677,12068,24745,"Trenton-Princeton, NJ",40.282503,-74.703724,385898
9283,45940,65+,34803,26872,61675,"Trenton-Princeton, NJ",40.282503,-74.703724,385898
9284,45980,15-19,1525,1247,2772,"Troy, AL",31.798653,-85.941608,32991
9285,45980,20-24,2767,2565,5332,"Troy, AL",31.798653,-85.941608,32991
9286,45980,25-29,1014,1239,2253,"Troy, AL",31.798653,-85.941608,32991
9287,45980,30-34,879,889,1768,"Troy, AL",31.798653,-85.941608,32991
9288,45980,35-39,909,801,1710,"Troy, AL",31.798653,-85.941608,32991
9289,45980,40-44,867,759,1626,"Troy, AL",31.798653,-85.941608,32991
9290,45980,45-49,848,750,1598,"Troy, AL",31.798653,-85.941608,32991
9291,45980,50-54,936,816,1752,"Troy, AL",31.798653,-85.941608,32991
9292,45980,55-59,963,816,1779,"Troy, AL",31.798653,-85.941608,32991
9293,45980,60-64,989,876,1865,"Troy, AL",31.798653,-85.941608,32991
9294,45980,65+,2912,2322,5234,"Troy, AL",31.798653,-85.941608,32991
9295,46020,15-19,2374,2512,4886,"Truckee-Grass Valley, CA",39.297508,-120.771343,103487
9296,46020,20-24,2062,2169,4231,"Truckee-Grass Valley, CA",39.297508,-120.771343,103487
9297,46020,25-29,2226,2417,4643,"Truckee-Grass Valley, CA",39.297508,-120.771343,103487
9298,46020,30-34,2827,2780,5607,"Truckee-Grass Valley, CA",39.297508,-120.771343,103487
9299,46020,35-39,3061,3090,6151,"Truckee-Grass Valley, CA",39.297508,-120.771343,103487
9300,46020,40-44,3099,3271,6370,"Truckee-Grass Valley, CA",39.297508,-120.771343,103487
9301,46020,45-49,2633,2893,5526,"Truckee-Grass Valley, CA",39.297508,-120.771343,103487
9302,46020,50-54,3032,3035,6067,"Truckee-Grass Valley, CA",39.297508,-120.771343,103487
9303,46020,55-59,3831,3446,7277,"Truckee-Grass Valley, CA",39.297508,-120.771343,103487
9304,46020,60-64,4821,4121,8942,"Truckee-Grass Valley, CA",39.297508,-120.771343,103487
9305,46020,65+,15438,14031,29469,"Truckee-Grass Valley, CA",39.297508,-120.771343,103487
9306,46060,15-19,34049,35302,69351,"Tucson, AZ",32.128038,-111.783657,1052030
9307,46060,20-24,44167,44929,89096,"Tucson, AZ",32.128038,-111.783657,1052030
9308,46060,25-29,34830,37379,72209,"Tucson, AZ",32.128038,-111.783657,1052030
9309,46060,30-34,30854,34011,64865,"Tucson, AZ",32.128038,-111.783657,1052030
9310,46060,35-39,30479,32078,62557,"Tucson, AZ",32.128038,-111.783657,1052030
9311,46060,40-44,30252,30432,60684,"Tucson, AZ",32.128038,-111.783657,1052030
9312,46060,45-49,28271,28027,56298,"Tucson, AZ",32.128038,-111.783657,1052030
9313,46060,50-54,28893,27971,56864,"Tucson, AZ",32.128038,-111.783657,1052030
9314,46060,55-59,31330,29590,60920,"Tucson, AZ",32.128038,-111.783657,1052030
9315,46060,60-64,35164,31290,66454,"Tucson, AZ",32.128038,-111.783657,1052030
9316,46060,65+,117876,99565,217441,"Tucson, AZ",32.128038,-111.783657,1052030
9317,46100,15-19,3504,3731,7235,"Tullahoma-Manchester, TN",35.303085,-86.111905,108891
9318,46100,20-24,3474,3542,7016,"Tullahoma-Manchester, TN",35.303085,-86.111905,108891
9319,46100,25-29,3274,3265,6539,"Tullahoma-Manchester, TN",35.303085,-86.111905,108891
9320,46100,30-34,3242,3251,6493,"Tullahoma-Manchester, TN",35.303085,-86.111905,108891
9321,46100,35-39,3183,3096,6279,"Tullahoma-Manchester, TN",35.303085,-86.111905,108891
9322,46100,40-44,3184,3271,6455,"Tullahoma-Manchester, TN",35.303085,-86.111905,108891
9323,46100,45-49,3305,3236,6541,"Tullahoma-Manchester, TN",35.303085,-86.111905,108891
9324,46100,50-54,3407,3406,6813,"Tullahoma-Manchester, TN",35.303085,-86.111905,108891
9325,46100,55-59,3869,3791,7660,"Tullahoma-Manchester, TN",35.303085,-86.111905,108891
9326,46100,60-64,3831,3720,7551,"Tullahoma-Manchester, TN",35.303085,-86.111905,108891
9327,46100,65+,11253,9327,20580,"Tullahoma-Manchester, TN",35.303085,-86.111905,108891
9328,46140,15-19,32848,34721,67569,"Tulsa, OK",36.254442,-96.177298,1023988
9329,46140,20-24,31021,31928,62949,"Tulsa, OK",36.254442,-96.177298,1023988
9330,46140,25-29,34048,34565,68613,"Tulsa, OK",36.254442,-96.177298,1023988
9331,46140,30-34,35682,35161,70843,"Tulsa, OK",36.254442,-96.177298,1023988
9332,46140,35-39,34915,34626,69541,"Tulsa, OK",36.254442,-96.177298,1023988
9333,46140,40-44,32369,32462,64831,"Tulsa, OK",36.254442,-96.177298,1023988
9334,46140,45-49,30130,29738,59868,"Tulsa, OK",36.254442,-96.177298,1023988
9335,46140,50-54,30665,30660,61325,"Tulsa, OK",36.254442,-96.177298,1023988
9336,46140,55-59,31807,31084,62891,"Tulsa, OK",36.254442,-96.177298,1023988
9337,46140,60-64,32968,30644,63612,"Tulsa, OK",36.254442,-96.177298,1023988
9338,46140,65+,91028,73806,164834,"Tulsa, OK",36.254442,-96.177298,1023988
9339,46180,15-19,5361,5912,11273,"Tupelo, MS",34.340033,-88.651184,163162
9340,46180,20-24,4985,5039,10024,"Tupelo, MS",34.340033,-88.651184,163162
9341,46180,25-29,5309,5170,10479,"Tupelo, MS",34.340033,-88.651184,163162
9342,46180,30-34,5514,5128,10642,"Tupelo, MS",34.340033,-88.651184,163162
9343,46180,35-39,5221,5041,10262,"Tupelo, MS",34.340033,-88.651184,163162
9344,46180,40-44,5188,4889,10077,"Tupelo, MS",34.340033,-88.651184,163162
9345,46180,45-49,5109,4837,9946,"Tupelo, MS",34.340033,-88.651184,163162
9346,46180,50-54,5260,5185,10445,"Tupelo, MS",34.340033,-88.651184,163162
9347,46180,55-59,5481,5307,10788,"Tupelo, MS",34.340033,-88.651184,163162
9348,46180,60-64,5201,4772,9973,"Tupelo, MS",34.340033,-88.651184,163162
9349,46180,65+,15037,11423,26460,"Tupelo, MS",34.340033,-88.651184,163162
9350,46220,15-19,10787,10368,21155,"Tuscaloosa, AL",33.097877,-87.799147,268191
9351,46220,20-24,13915,13500,27415,"Tuscaloosa, AL",33.097877,-87.799147,268191
9352,46220,25-29,9464,9022,18486,"Tuscaloosa, AL",33.097877,-87.799147,268191
9353,46220,30-34,9640,9270,18910,"Tuscaloosa, AL",33.097877,-87.799147,268191
9354,46220,35-39,8360,7924,16284,"Tuscaloosa, AL",33.097877,-87.799147,268191
9355,46220,40-44,8338,7700,16038,"Tuscaloosa, AL",33.097877,-87.799147,268191
9356,46220,45-49,7954,7224,15178,"Tuscaloosa, AL",33.097877,-87.799147,268191
9357,46220,50-54,7809,7331,15140,"Tuscaloosa, AL",33.097877,-87.799147,268191
9358,46220,55-59,8126,7555,15681,"Tuscaloosa, AL",33.097877,-87.799147,268191
9359,46220,60-64,8168,7499,15667,"Tuscaloosa, AL",33.097877,-87.799147,268191
9360,46220,65+,22879,17945,40824,"Tuscaloosa, AL",33.097877,-87.799147,268191
9361,46300,15-19,4159,4359,8518,"Twin Falls, ID",42.440397,-114.568729,116905
9362,46300,20-24,3401,3390,6791,"Twin Falls, ID",42.440397,-114.568729,116905
9363,46300,25-29,3819,3729,7548,"Twin Falls, ID",42.440397,-114.568729,116905
9364,46300,30-34,4115,3958,8073,"Twin Falls, ID",42.440397,-114.568729,116905
9365,46300,35-39,4038,4215,8253,"Twin Falls, ID",42.440397,-114.568729,116905
9366,46300,40-44,3653,3861,7514,"Twin Falls, ID",42.440397,-114.568729,116905
9367,46300,45-49,3036,3238,6274,"Twin Falls, ID",42.440397,-114.568729,116905
9368,46300,50-54,2864,3137,6001,"Twin Falls, ID",42.440397,-114.568729,116905
9369,46300,55-59,3208,3267,6475,"Twin Falls, ID",42.440397,-114.568729,116905
9370,46300,60-64,3420,3355,6775,"Twin Falls, ID",42.440397,-114.568729,116905
9371,46300,65+,9637,8460,18097,"Twin Falls, ID",42.440397,-114.568729,116905
9372,46340,15-19,8433,8718,17151,"Tyler, TX",32.377016,-95.270041,237186
9373,46340,20-24,8113,7655,15768,"Tyler, TX",32.377016,-95.270041,237186
9374,46340,25-29,8041,7696,15737,"Tyler, TX",32.377016,-95.270041,237186
9375,46340,30-34,8372,7584,15956,"Tyler, TX",32.377016,-95.270041,237186
9376,46340,35-39,7899,7332,15231,"Tyler, TX",32.377016,-95.270041,237186
9377,46340,40-44,7126,6907,14033,"Tyler, TX",32.377016,-95.270041,237186
9378,46340,45-49,6828,6236,13064,"Tyler, TX",32.377016,-95.270041,237186
9379,46340,50-54,7067,6665,13732,"Tyler, TX",32.377016,-95.270041,237186
9380,46340,55-59,7185,6779,13964,"Tyler, TX",32.377016,-95.270041,237186
9381,46340,60-64,7496,6822,14318,"Tyler, TX",32.377016,-95.270041,237186
9382,46340,65+,22411,18147,40558,"Tyler, TX",32.377016,-95.270041,237186
9383,46380,15-19,2600,2681,5281,"Ukiah, CA",39.432388,-123.442881,91305
9384,46380,20-24,2174,2312,4486,"Ukiah, CA",39.432388,-123.442881,91305
9385,46380,25-29,2334,2529,4863,"Ukiah, CA",39.432388,-123.442881,91305
9386,46380,30-34,2570,2631,5201,"Ukiah, CA",39.432388,-123.442881,91305
9387,46380,35-39,2745,2855,5600,"Ukiah, CA",39.432388,-123.442881,91305
9388,46380,40-44,2751,2981,5732,"Ukiah, CA",39.432388,-123.442881,91305
9389,46380,45-49,2540,2691,5231,"Ukiah, CA",39.432388,-123.442881,91305
9390,46380,50-54,2667,2663,5330,"Ukiah, CA",39.432388,-123.442881,91305
9391,46380,55-59,2801,2750,5551,"Ukiah, CA",39.432388,-123.442881,91305
9392,46380,60-64,3331,3201,6532,"Ukiah, CA",39.432388,-123.442881,91305
9393,46380,65+,11486,10113,21599,"Ukiah, CA",39.432388,-123.442881,91305
9394,46420,15-19,735,839,1574,"Union, SC",34.690397,-81.615896,27016
9395,46420,20-24,711,716,1427,"Union, SC",34.690397,-81.615896,27016
9396,46420,25-29,814,751,1565,"Union, SC",34.690397,-81.615896,27016
9397,46420,30-34,926,735,1661,"Union, SC",34.690397,-81.615896,27016
9398,46420,35-39,724,643,1367,"Union, SC",34.690397,-81.615896,27016
9399,46420,40-44,811,740,1551,"Union, SC",34.690397,-81.615896,27016
9400,46420,45-49,826,735,1561,"Union, SC",34.690397,-81.615896,27016
9401,46420,50-54,954,927,1881,"Union, SC",34.690397,-81.615896,27016
9402,46420,55-59,1081,944,2025,"Union, SC",34.690397,-81.615896,27016
9403,46420,60-64,1065,984,2049,"Union, SC",34.690397,-81.615896,27016
9404,46420,65+,3228,2425,5653,"Union, SC",34.690397,-81.615896,27016
9405,46460,15-19,894,903,1797,"Union City, TN",36.361892,-89.148078,30466
9406,46460,20-24,847,841,1688,"Union City, TN",36.361892,-89.148078,30466
9407,46460,25-29,918,891,1809,"Union City, TN",36.361892,-89.148078,30466
9408,46460,30-34,867,858,1725,"Union City, TN",36.361892,-89.148078,30466
9409,46460,35-39,893,858,1751,"Union City, TN",36.361892,-89.148078,30466
9410,46460,40-44,910,901,1811,"Union City, TN",36.361892,-89.148078,30466
9411,46460,45-49,912,943,1855,"Union City, TN",36.361892,-89.148078,30466
9412,46460,50-54,1045,1029,2074,"Union City, TN",36.361892,-89.148078,30466
9413,46460,55-59,1013,927,1940,"Union City, TN",36.361892,-89.148078,30466
9414,46460,60-64,1115,1042,2157,"Union City, TN",36.361892,-89.148078,30466
9415,46460,65+,3540,2883,6423,"Union City, TN",36.361892,-89.148078,30466
9416,46500,15-19,1229,1338,2567,"Urbana, OH",40.132775,-83.767604,38699
9417,46500,20-24,1011,1123,2134,"Urbana, OH",40.132775,-83.767604,38699
9418,46500,25-29,1181,1256,2437,"Urbana, OH",40.132775,-83.767604,38699
9419,46500,30-34,1138,1168,2306,"Urbana, OH",40.132775,-83.767604,38699
9420,46500,35-39,1131,1132,2263,"Urbana, OH",40.132775,-83.767604,38699
9421,46500,40-44,1080,1124,2204,"Urbana, OH",40.132775,-83.767604,38699
9422,46500,45-49,1152,1144,2296,"Urbana, OH",40.132775,-83.767604,38699
9423,46500,50-54,1320,1396,2716,"Urbana, OH",40.132775,-83.767604,38699
9424,46500,55-59,1399,1438,2837,"Urbana, OH",40.132775,-83.767604,38699
9425,46500,60-64,1395,1404,2799,"Urbana, OH",40.132775,-83.767604,38699
9426,46500,65+,3928,3323,7251,"Urbana, OH",40.132775,-83.767604,38699
9427,46520,15-19,25908,28278,54186,"Urban Honolulu, HI",21.461365,-158.201974,1000890
9428,46520,20-24,28958,37848,66806,"Urban Honolulu, HI",21.461365,-158.201974,1000890
9429,46520,25-29,32754,38069,70823,"Urban Honolulu, HI",21.461365,-158.201974,1000890
9430,46520,30-34,34840,38269,73109,"Urban Honolulu, HI",21.461365,-158.201974,1000890
9431,46520,35-39,33655,36247,69902,"Urban Honolulu, HI",21.461365,-158.201974,1000890
9432,46520,40-44,30850,32292,63142,"Urban Honolulu, HI",21.461365,-158.201974,1000890
9433,46520,45-49,28329,29048,57377,"Urban Honolulu, HI",21.461365,-158.201974,1000890
9434,46520,50-54,29714,30170,59884,"Urban Honolulu, HI",21.461365,-158.201974,1000890
9435,46520,55-59,30139,30495,60634,"Urban Honolulu, HI",21.461365,-158.201974,1000890
9436,46520,60-64,29910,29433,59343,"Urban Honolulu, HI",21.461365,-158.201974,1000890
9437,46520,65+,103587,84348,187935,"Urban Honolulu, HI",21.461365,-158.201974,1000890
9438,46540,15-19,9220,9742,18962,"Utica-Rome, NY",43.33228,-75.173189,290211
9439,46540,20-24,8424,9634,18058,"Utica-Rome, NY",43.33228,-75.173189,290211
9440,46540,25-29,8236,8988,17224,"Utica-Rome, NY",43.33228,-75.173189,290211
9441,46540,30-34,8585,9121,17706,"Utica-Rome, NY",43.33228,-75.173189,290211
9442,46540,35-39,8432,9163,17595,"Utica-Rome, NY",43.33228,-75.173189,290211
9443,46540,40-44,7937,8423,16360,"Utica-Rome, NY",43.33228,-75.173189,290211
9444,46540,45-49,7903,8104,16007,"Utica-Rome, NY",43.33228,-75.173189,290211
9445,46540,50-54,9169,9525,18694,"Utica-Rome, NY",43.33228,-75.173189,290211
9446,46540,55-59,10318,10450,20768,"Utica-Rome, NY",43.33228,-75.173189,290211
9447,46540,60-64,10484,10416,20900,"Utica-Rome, NY",43.33228,-75.173189,290211
9448,46540,65+,31501,26011,57512,"Utica-Rome, NY",43.33228,-75.173189,290211
9449,46620,15-19,908,1007,1915,"Uvalde, TX",29.350308,-99.768427,24729
9450,46620,20-24,855,907,1762,"Uvalde, TX",29.350308,-99.768427,24729
9451,46620,25-29,860,893,1753,"Uvalde, TX",29.350308,-99.768427,24729
9452,46620,30-34,779,818,1597,"Uvalde, TX",29.350308,-99.768427,24729
9453,46620,35-39,702,710,1412,"Uvalde, TX",29.350308,-99.768427,24729
9454,46620,40-44,703,703,1406,"Uvalde, TX",29.350308,-99.768427,24729
9455,46620,45-49,688,683,1371,"Uvalde, TX",29.350308,-99.768427,24729
9456,46620,50-54,696,657,1353,"Uvalde, TX",29.350308,-99.768427,24729
9457,46620,55-59,662,611,1273,"Uvalde, TX",29.350308,-99.768427,24729
9458,46620,60-64,680,605,1285,"Uvalde, TX",29.350308,-99.768427,24729
9459,46620,65+,2194,1787,3981,"Uvalde, TX",29.350308,-99.768427,24729
9460,46660,15-19,5915,5589,11504,"Valdosta, GA",30.827158,-83.243555,149152
9461,46660,20-24,8058,7855,15913,"Valdosta, GA",30.827158,-83.243555,149152
9462,46660,25-29,5339,5667,11006,"Valdosta, GA",30.827158,-83.243555,149152
9463,46660,30-34,5160,4935,10095,"Valdosta, GA",30.827158,-83.243555,149152
9464,46660,35-39,4782,4688,9470,"Valdosta, GA",30.827158,-83.243555,149152
9465,46660,40-44,4299,4037,8336,"Valdosta, GA",30.827158,-83.243555,149152
9466,46660,45-49,4017,3698,7715,"Valdosta, GA",30.827158,-83.243555,149152
9467,46660,50-54,4081,3753,7834,"Valdosta, GA",30.827158,-83.243555,149152
9468,46660,55-59,4354,4085,8439,"Valdosta, GA",30.827158,-83.243555,149152
9469,46660,60-64,4214,3823,8037,"Valdosta, GA",30.827158,-83.243555,149152
9470,46660,65+,11689,8903,20592,"Valdosta, GA",30.827158,-83.243555,149152
9471,46700,15-19,12945,14058,27003,"Vallejo, CA",38.267226,-121.939594,451716
9472,46700,20-24,12860,14644,27504,"Vallejo, CA",38.267226,-121.939594,451716
9473,46700,25-29,14675,15952,30627,"Vallejo, CA",38.267226,-121.939594,451716
9474,46700,30-34,16205,17281,33486,"Vallejo, CA",38.267226,-121.939594,451716
9475,46700,35-39,15718,16830,32548,"Vallejo, CA",38.267226,-121.939594,451716
9476,46700,40-44,14109,14879,28988,"Vallejo, CA",38.267226,-121.939594,451716
9477,46700,45-49,12674,13484,26158,"Vallejo, CA",38.267226,-121.939594,451716
9478,46700,50-54,13689,14195,27884,"Vallejo, CA",38.267226,-121.939594,451716
9479,46700,55-59,14980,14712,29692,"Vallejo, CA",38.267226,-121.939594,451716
9480,46700,60-64,15170,14144,29314,"Vallejo, CA",38.267226,-121.939594,451716
9481,46700,65+,42090,34224,76314,"Vallejo, CA",38.267226,-121.939594,451716
9482,46780,15-19,910,893,1803,"Van Wert, OH",40.85552,-84.585775,28732
9483,46780,20-24,762,788,1550,"Van Wert, OH",40.85552,-84.585775,28732
9484,46780,25-29,874,916,1790,"Van Wert, OH",40.85552,-84.585775,28732
9485,46780,30-34,823,832,1655,"Van Wert, OH",40.85552,-84.585775,28732
9486,46780,35-39,786,834,1620,"Van Wert, OH",40.85552,-84.585775,28732
9487,46780,40-44,871,947,1818,"Van Wert, OH",40.85552,-84.585775,28732
9488,46780,45-49,788,822,1610,"Van Wert, OH",40.85552,-84.585775,28732
9489,46780,50-54,839,899,1738,"Van Wert, OH",40.85552,-84.585775,28732
9490,46780,55-59,960,974,1934,"Van Wert, OH",40.85552,-84.585775,28732
9491,46780,60-64,1047,988,2035,"Van Wert, OH",40.85552,-84.585775,28732
9492,46780,65+,3102,2602,5704,"Van Wert, OH",40.85552,-84.585775,28732
9493,46820,15-19,983,780,1763,"Vermillion, SD",42.91615,-96.980468,15150
9494,46820,20-24,1707,1608,3315,"Vermillion, SD",42.91615,-96.980468,15150
9495,46820,25-29,515,583,1098,"Vermillion, SD",42.91615,-96.980468,15150
9496,46820,30-34,410,456,866,"Vermillion, SD",42.91615,-96.980468,15150
9497,46820,35-39,341,371,712,"Vermillion, SD",42.91615,-96.980468,15150
9498,46820,40-44,344,351,695,"Vermillion, SD",42.91615,-96.980468,15150
9499,46820,45-49,264,312,576,"Vermillion, SD",42.91615,-96.980468,15150
9500,46820,50-54,308,317,625,"Vermillion, SD",42.91615,-96.980468,15150
9501,46820,55-59,347,320,667,"Vermillion, SD",42.91615,-96.980468,15150
9502,46820,60-64,358,318,676,"Vermillion, SD",42.91615,-96.980468,15150
9503,46820,65+,949,927,1876,"Vermillion, SD",42.91615,-96.980468,15150
9504,46860,15-19,1472,1559,3031,"Vernal, UT",40.125887,-109.517748,36204
9505,46860,20-24,964,1071,2035,"Vernal, UT",40.125887,-109.517748,36204
9506,46860,25-29,1102,1127,2229,"Vernal, UT",40.125887,-109.517748,36204
9507,46860,30-34,1243,1218,2461,"Vernal, UT",40.125887,-109.517748,36204
9508,46860,35-39,1336,1401,2737,"Vernal, UT",40.125887,-109.517748,36204
9509,46860,40-44,1278,1363,2641,"Vernal, UT",40.125887,-109.517748,36204
9510,46860,45-49,989,1019,2008,"Vernal, UT",40.125887,-109.517748,36204
9511,46860,50-54,804,913,1717,"Vernal, UT",40.125887,-109.517748,36204
9512,46860,55-59,889,816,1705,"Vernal, UT",40.125887,-109.517748,36204
9513,46860,60-64,919,907,1826,"Vernal, UT",40.125887,-109.517748,36204
9514,46860,65+,2231,2114,4345,"Vernal, UT",40.125887,-109.517748,36204
9515,46900,15-19,421,500,921,"Vernon, TX",34.08492,-99.24244,12731
9516,46900,20-24,335,407,742,"Vernon, TX",34.08492,-99.24244,12731
9517,46900,25-29,385,412,797,"Vernon, TX",34.08492,-99.24244,12731
9518,46900,30-34,458,391,849,"Vernon, TX",34.08492,-99.24244,12731
9519,46900,35-39,456,439,895,"Vernon, TX",34.08492,-99.24244,12731
9520,46900,40-44,371,414,785,"Vernon, TX",34.08492,-99.24244,12731
9521,46900,45-49,369,372,741,"Vernon, TX",34.08492,-99.24244,12731
9522,46900,50-54,361,324,685,"Vernon, TX",34.08492,-99.24244,12731
9523,46900,55-59,428,412,840,"Vernon, TX",34.08492,-99.24244,12731
9524,46900,60-64,435,409,844,"Vernon, TX",34.08492,-99.24244,12731
9525,46900,65+,1291,1115,2406,"Vernon, TX",34.08492,-99.24244,12731
9526,46980,15-19,1388,1443,2831,"Vicksburg, MS",32.356095,-90.852384,43579
9527,46980,20-24,1228,1167,2395,"Vicksburg, MS",32.356095,-90.852384,43579
9528,46980,25-29,1422,1257,2679,"Vicksburg, MS",32.356095,-90.852384,43579
9529,46980,30-34,1353,1182,2535,"Vicksburg, MS",32.356095,-90.852384,43579
9530,46980,35-39,1405,1301,2706,"Vicksburg, MS",32.356095,-90.852384,43579
9531,46980,40-44,1401,1324,2725,"Vicksburg, MS",32.356095,-90.852384,43579
9532,46980,45-49,1358,1233,2591,"Vicksburg, MS",32.356095,-90.852384,43579
9533,46980,50-54,1368,1210,2578,"Vicksburg, MS",32.356095,-90.852384,43579
9534,46980,55-59,1585,1400,2985,"Vicksburg, MS",32.356095,-90.852384,43579
9535,46980,60-64,1597,1490,3087,"Vicksburg, MS",32.356095,-90.852384,43579
9536,46980,65+,4471,3532,8003,"Vicksburg, MS",32.356095,-90.852384,43579
9537,47020,15-19,3402,3475,6877,"Victoria, TX",28.731455,-97.196993,98127
9538,47020,20-24,3166,3132,6298,"Victoria, TX",28.731455,-97.196993,98127
9539,47020,25-29,3184,3229,6413,"Victoria, TX",28.731455,-97.196993,98127
9540,47020,30-34,3236,3311,6547,"Victoria, TX",28.731455,-97.196993,98127
9541,47020,35-39,3196,3304,6500,"Victoria, TX",28.731455,-97.196993,98127
9542,47020,40-44,2986,2900,5886,"Victoria, TX",28.731455,-97.196993,98127
9543,47020,45-49,2699,2569,5268,"Victoria, TX",28.731455,-97.196993,98127
9544,47020,50-54,2656,2511,5167,"Victoria, TX",28.731455,-97.196993,98127
9545,47020,55-59,2936,2829,5765,"Victoria, TX",28.731455,-97.196993,98127
9546,47020,60-64,3130,3001,6131,"Victoria, TX",28.731455,-97.196993,98127
9547,47020,65+,9254,7666,16920,"Victoria, TX",28.731455,-97.196993,98127
9548,47080,15-19,1212,1315,2527,"Vidalia, GA",32.154218,-82.411379,35564
9549,47080,20-24,1166,1193,2359,"Vidalia, GA",32.154218,-82.411379,35564
9550,47080,25-29,1121,1064,2185,"Vidalia, GA",32.154218,-82.411379,35564
9551,47080,30-34,1120,1113,2233,"Vidalia, GA",32.154218,-82.411379,35564
9552,47080,35-39,1132,1067,2199,"Vidalia, GA",32.154218,-82.411379,35564
9553,47080,40-44,1069,1042,2111,"Vidalia, GA",32.154218,-82.411379,35564
9554,47080,45-49,1059,978,2037,"Vidalia, GA",32.154218,-82.411379,35564
9555,47080,50-54,1110,1012,2122,"Vidalia, GA",32.154218,-82.411379,35564
9556,47080,55-59,1175,1055,2230,"Vidalia, GA",32.154218,-82.411379,35564
9557,47080,60-64,1120,1097,2217,"Vidalia, GA",32.154218,-82.411379,35564
9558,47080,65+,3484,2524,6008,"Vidalia, GA",32.154218,-82.411379,35564
9559,47180,15-19,1261,1559,2820,"Vincennes, IN",38.688391,-87.420354,35956
9560,47180,20-24,1291,1610,2901,"Vincennes, IN",38.688391,-87.420354,35956
9561,47180,25-29,941,1079,2020,"Vincennes, IN",38.688391,-87.420354,35956
9562,47180,30-34,942,1135,2077,"Vincennes, IN",38.688391,-87.420354,35956
9563,47180,35-39,1036,1190,2226,"Vincennes, IN",38.688391,-87.420354,35956
9564,47180,40-44,1039,1045,2084,"Vincennes, IN",38.688391,-87.420354,35956
9565,47180,45-49,887,927,1814,"Vincennes, IN",38.688391,-87.420354,35956
9566,47180,50-54,986,1051,2037,"Vincennes, IN",38.688391,-87.420354,35956
9567,47180,55-59,1178,1226,2404,"Vincennes, IN",38.688391,-87.420354,35956
9568,47180,60-64,1262,1283,2545,"Vincennes, IN",38.688391,-87.420354,35956
9569,47180,65+,3745,2928,6673,"Vincennes, IN",38.688391,-87.420354,35956
9570,47220,15-19,4910,5034,9944,"Vineland-Bridgeton, NJ",39.328434,-75.121628,153627
9571,47220,20-24,4270,4774,9044,"Vineland-Bridgeton, NJ",39.328434,-75.121628,153627
9572,47220,25-29,4574,5509,10083,"Vineland-Bridgeton, NJ",39.328434,-75.121628,153627
9573,47220,30-34,4649,6282,10931,"Vineland-Bridgeton, NJ",39.328434,-75.121628,153627
9574,47220,35-39,4543,5713,10256,"Vineland-Bridgeton, NJ",39.328434,-75.121628,153627
9575,47220,40-44,4484,5373,9857,"Vineland-Bridgeton, NJ",39.328434,-75.121628,153627
9576,47220,45-49,4501,4983,9484,"Vineland-Bridgeton, NJ",39.328434,-75.121628,153627
9577,47220,50-54,4939,4845,9784,"Vineland-Bridgeton, NJ",39.328434,-75.121628,153627
9578,47220,55-59,5014,4905,9919,"Vineland-Bridgeton, NJ",39.328434,-75.121628,153627
9579,47220,60-64,4755,4494,9249,"Vineland-Bridgeton, NJ",39.328434,-75.121628,153627
9580,47220,65+,13415,10941,24356,"Vineland-Bridgeton, NJ",39.328434,-75.121628,153627
9581,47240,15-19,459,541,1000,"Vineyard Haven, MA",41.38097,-70.701499,21097
9582,47240,20-24,458,449,907,"Vineyard Haven, MA",41.38097,-70.701499,21097
9583,47240,25-29,518,562,1080,"Vineyard Haven, MA",41.38097,-70.701499,21097
9584,47240,30-34,587,603,1190,"Vineyard Haven, MA",41.38097,-70.701499,21097
9585,47240,35-39,577,627,1204,"Vineyard Haven, MA",41.38097,-70.701499,21097
9586,47240,40-44,609,606,1215,"Vineyard Haven, MA",41.38097,-70.701499,21097
9587,47240,45-49,587,580,1167,"Vineyard Haven, MA",41.38097,-70.701499,21097
9588,47240,50-54,697,704,1401,"Vineyard Haven, MA",41.38097,-70.701499,21097
9589,47240,55-59,858,826,1684,"Vineyard Haven, MA",41.38097,-70.701499,21097
9590,47240,60-64,868,932,1800,"Vineyard Haven, MA",41.38097,-70.701499,21097
9591,47240,65+,2931,2460,5391,"Vineyard Haven, MA",41.38097,-70.701499,21097
9592,47260,15-19,55575,58712,114287,"Virginia Beach-Norfolk-Newport News, VA-NC",36.804408,-76.449526,1803328
9593,47260,20-24,60861,74379,135240,"Virginia Beach-Norfolk-Newport News, VA-NC",36.804408,-76.449526,1803328
9594,47260,25-29,64649,70539,135188,"Virginia Beach-Norfolk-Newport News, VA-NC",36.804408,-76.449526,1803328
9595,47260,30-34,67761,68291,136052,"Virginia Beach-Norfolk-Newport News, VA-NC",36.804408,-76.449526,1803328
9596,47260,35-39,63675,64136,127811,"Virginia Beach-Norfolk-Newport News, VA-NC",36.804408,-76.449526,1803328
9597,47260,40-44,56213,54953,111166,"Virginia Beach-Norfolk-Newport News, VA-NC",36.804408,-76.449526,1803328
9598,47260,45-49,49576,47035,96611,"Virginia Beach-Norfolk-Newport News, VA-NC",36.804408,-76.449526,1803328
9599,47260,50-54,54438,49954,104392,"Virginia Beach-Norfolk-Newport News, VA-NC",36.804408,-76.449526,1803328
9600,47260,55-59,60817,55590,116407,"Virginia Beach-Norfolk-Newport News, VA-NC",36.804408,-76.449526,1803328
9601,47260,60-64,60109,54625,114734,"Virginia Beach-Norfolk-Newport News, VA-NC",36.804408,-76.449526,1803328
9602,47260,65+,158017,123062,281079,"Virginia Beach-Norfolk-Newport News, VA-NC",36.804408,-76.449526,1803328
9603,47300,15-19,19382,20292,39674,"Visalia, CA",36.228834,-118.781055,477054
9604,47300,20-24,16696,17009,33705,"Visalia, CA",36.228834,-118.781055,477054
9605,47300,25-29,16807,17016,33823,"Visalia, CA",36.228834,-118.781055,477054
9606,47300,30-34,16394,17147,33541,"Visalia, CA",36.228834,-118.781055,477054
9607,47300,35-39,15979,16417,32396,"Visalia, CA",36.228834,-118.781055,477054
9608,47300,40-44,14857,15444,30301,"Visalia, CA",36.228834,-118.781055,477054
9609,47300,45-49,13027,13351,26378,"Visalia, CA",36.228834,-118.781055,477054
9610,47300,50-54,12582,12975,25557,"Visalia, CA",36.228834,-118.781055,477054
9611,47300,55-59,12308,12266,24574,"Visalia, CA",36.228834,-118.781055,477054
9612,47300,60-64,11542,11236,22778,"Visalia, CA",36.228834,-118.781055,477054
9613,47300,65+,30155,25417,55572,"Visalia, CA",36.228834,-118.781055,477054
9614,47340,15-19,1057,1172,2229,"Wabash, IN",40.843747,-85.795192,30816
9615,47340,20-24,1008,1048,2056,"Wabash, IN",40.843747,-85.795192,30816
9616,47340,25-29,884,884,1768,"Wabash, IN",40.843747,-85.795192,30816
9617,47340,30-34,798,848,1646,"Wabash, IN",40.843747,-85.795192,30816
9618,47340,35-39,871,797,1668,"Wabash, IN",40.843747,-85.795192,30816
9619,47340,40-44,863,928,1791,"Wabash, IN",40.843747,-85.795192,30816
9620,47340,45-49,898,863,1761,"Wabash, IN",40.843747,-85.795192,30816
9621,47340,50-54,939,917,1856,"Wabash, IN",40.843747,-85.795192,30816
9622,47340,55-59,1059,1014,2073,"Wabash, IN",40.843747,-85.795192,30816
9623,47340,60-64,1134,1178,2312,"Wabash, IN",40.843747,-85.795192,30816
9624,47340,65+,3580,2870,6450,"Wabash, IN",40.843747,-85.795192,30816
9625,47380,15-19,11225,11499,22724,"Waco, TX",31.427226,-97.093473,280428
9626,47380,20-24,13636,13860,27496,"Waco, TX",31.427226,-97.093473,280428
9627,47380,25-29,9668,9511,19179,"Waco, TX",31.427226,-97.093473,280428
9628,47380,30-34,9202,8397,17599,"Waco, TX",31.427226,-97.093473,280428
9629,47380,35-39,8952,8463,17415,"Waco, TX",31.427226,-97.093473,280428
9630,47380,40-44,8378,7929,16307,"Waco, TX",31.427226,-97.093473,280428
9631,47380,45-49,7553,7088,14641,"Waco, TX",31.427226,-97.093473,280428
9632,47380,50-54,7653,7186,14839,"Waco, TX",31.427226,-97.093473,280428
9633,47380,55-59,8179,7653,15832,"Waco, TX",31.427226,-97.093473,280428
9634,47380,60-64,8052,7588,15640,"Waco, TX",31.427226,-97.093473,280428
9635,47380,65+,23558,19011,42569,"Waco, TX",31.427226,-97.093473,280428
9636,47420,15-19,780,944,1724,"Wahpeton, ND-MN",46.29395,-96.790701,22955
9637,47420,20-24,786,1015,1801,"Wahpeton, ND-MN",46.29395,-96.790701,22955
9638,47420,25-29,602,675,1277,"Wahpeton, ND-MN",46.29395,-96.790701,22955
9639,47420,30-34,621,667,1288,"Wahpeton, ND-MN",46.29395,-96.790701,22955
9640,47420,35-39,634,688,1322,"Wahpeton, ND-MN",46.29395,-96.790701,22955
9641,47420,40-44,597,691,1288,"Wahpeton, ND-MN",46.29395,-96.790701,22955
9642,47420,45-49,528,580,1108,"Wahpeton, ND-MN",46.29395,-96.790701,22955
9643,47420,50-54,572,630,1202,"Wahpeton, ND-MN",46.29395,-96.790701,22955
9644,47420,55-59,753,738,1491,"Wahpeton, ND-MN",46.29395,-96.790701,22955
9645,47420,60-64,773,930,1703,"Wahpeton, ND-MN",46.29395,-96.790701,22955
9646,47420,65+,2306,2193,4499,"Wahpeton, ND-MN",46.29395,-96.790701,22955
9647,47460,15-19,2392,2440,4832,"Walla Walla, WA",46.254606,-118.48037,62682
9648,47460,20-24,2508,2971,5479,"Walla Walla, WA",46.254606,-118.48037,62682
9649,47460,25-29,1713,2178,3891,"Walla Walla, WA",46.254606,-118.48037,62682
9650,47460,30-34,1766,2126,3892,"Walla Walla, WA",46.254606,-118.48037,62682
9651,47460,35-39,1797,2172,3969,"Walla Walla, WA",46.254606,-118.48037,62682
9652,47460,40-44,1643,1950,3593,"Walla Walla, WA",46.254606,-118.48037,62682
9653,47460,45-49,1552,1756,3308,"Walla Walla, WA",46.254606,-118.48037,62682
9654,47460,50-54,1604,1788,3392,"Walla Walla, WA",46.254606,-118.48037,62682
9655,47460,55-59,1848,1851,3699,"Walla Walla, WA",46.254606,-118.48037,62682
9656,47460,60-64,1992,1881,3873,"Walla Walla, WA",46.254606,-118.48037,62682
9657,47460,65+,6495,5506,12001,"Walla Walla, WA",46.254606,-118.48037,62682
9658,47540,15-19,1424,1525,2949,"Wapakoneta, OH",40.561309,-84.224018,46141
9659,47540,20-24,1258,1320,2578,"Wapakoneta, OH",40.561309,-84.224018,46141
9660,47540,25-29,1270,1420,2690,"Wapakoneta, OH",40.561309,-84.224018,46141
9661,47540,30-34,1335,1404,2739,"Wapakoneta, OH",40.561309,-84.224018,46141
9662,47540,35-39,1314,1305,2619,"Wapakoneta, OH",40.561309,-84.224018,46141
9663,47540,40-44,1346,1403,2749,"Wapakoneta, OH",40.561309,-84.224018,46141
9664,47540,45-49,1281,1371,2652,"Wapakoneta, OH",40.561309,-84.224018,46141
9665,47540,50-54,1411,1416,2827,"Wapakoneta, OH",40.561309,-84.224018,46141
9666,47540,55-59,1572,1564,3136,"Wapakoneta, OH",40.561309,-84.224018,46141
9667,47540,60-64,1604,1697,3301,"Wapakoneta, OH",40.561309,-84.224018,46141
9668,47540,65+,4725,4026,8751,"Wapakoneta, OH",40.561309,-84.224018,46141
9669,47580,15-19,6750,6964,13714,"Warner Robins, GA",32.492806,-83.711084,195246
9670,47580,20-24,6372,6645,13017,"Warner Robins, GA",32.492806,-83.711084,195246
9671,47580,25-29,6699,6574,13273,"Warner Robins, GA",32.492806,-83.711084,195246
9672,47580,30-34,7217,6677,13894,"Warner Robins, GA",32.492806,-83.711084,195246
9673,47580,35-39,7401,6512,13913,"Warner Robins, GA",32.492806,-83.711084,195246
9674,47580,40-44,6684,6023,12707,"Warner Robins, GA",32.492806,-83.711084,195246
9675,47580,45-49,5966,5362,11328,"Warner Robins, GA",32.492806,-83.711084,195246
9676,47580,50-54,5929,5474,11403,"Warner Robins, GA",32.492806,-83.711084,195246
9677,47580,55-59,6650,6235,12885,"Warner Robins, GA",32.492806,-83.711084,195246
9678,47580,60-64,5975,5809,11784,"Warner Robins, GA",32.492806,-83.711084,195246
9679,47580,65+,15102,11877,26979,"Warner Robins, GA",32.492806,-83.711084,195246
9680,47620,15-19,943,1063,2006,"Warren, PA",41.834298,-79.298182,38134
9681,47620,20-24,852,976,1828,"Warren, PA",41.834298,-79.298182,38134
9682,47620,25-29,919,1031,1950,"Warren, PA",41.834298,-79.298182,38134
9683,47620,30-34,940,1009,1949,"Warren, PA",41.834298,-79.298182,38134
9684,47620,35-39,1031,1065,2096,"Warren, PA",41.834298,-79.298182,38134
9685,47620,40-44,986,1030,2016,"Warren, PA",41.834298,-79.298182,38134
9686,47620,45-49,1043,1005,2048,"Warren, PA",41.834298,-79.298182,38134
9687,47620,50-54,1268,1372,2640,"Warren, PA",41.834298,-79.298182,38134
9688,47620,55-59,1459,1528,2987,"Warren, PA",41.834298,-79.298182,38134
9689,47620,60-64,1600,1613,3213,"Warren, PA",41.834298,-79.298182,38134
9690,47620,65+,4828,4373,9201,"Warren, PA",41.834298,-79.298182,38134
9691,47660,15-19,2205,2219,4424,"Warrensburg, MO",38.741528,-93.811863,54150
9692,47660,20-24,3579,4402,7981,"Warrensburg, MO",38.741528,-93.811863,54150
9693,47660,25-29,1820,2279,4099,"Warrensburg, MO",38.741528,-93.811863,54150
9694,47660,30-34,1697,1858,3555,"Warrensburg, MO",38.741528,-93.811863,54150
9695,47660,35-39,1574,1776,3350,"Warrensburg, MO",38.741528,-93.811863,54150
9696,47660,40-44,1350,1450,2800,"Warrensburg, MO",38.741528,-93.811863,54150
9697,47660,45-49,1191,1240,2431,"Warrensburg, MO",38.741528,-93.811863,54150
9698,47660,50-54,1377,1270,2647,"Warrensburg, MO",38.741528,-93.811863,54150
9699,47660,55-59,1418,1499,2917,"Warrensburg, MO",38.741528,-93.811863,54150
9700,47660,60-64,1557,1457,3014,"Warrensburg, MO",38.741528,-93.811863,54150
9701,47660,65+,3658,3345,7003,"Warrensburg, MO",38.741528,-93.811863,54150
9702,47700,15-19,2620,2737,5357,"Warsaw, IN",41.244293,-85.861575,80106
9703,47700,20-24,2529,2587,5116,"Warsaw, IN",41.244293,-85.861575,80106
9704,47700,25-29,2419,2635,5054,"Warsaw, IN",41.244293,-85.861575,80106
9705,47700,30-34,2484,2569,5053,"Warsaw, IN",41.244293,-85.861575,80106
9706,47700,35-39,2394,2556,4950,"Warsaw, IN",41.244293,-85.861575,80106
9707,47700,40-44,2218,2424,4642,"Warsaw, IN",41.244293,-85.861575,80106
9708,47700,45-49,2131,2223,4354,"Warsaw, IN",41.244293,-85.861575,80106
9709,47700,50-54,2381,2507,4888,"Warsaw, IN",41.244293,-85.861575,80106
9710,47700,55-59,2709,2626,5335,"Warsaw, IN",41.244293,-85.861575,80106
9711,47700,60-64,2765,2809,5574,"Warsaw, IN",41.244293,-85.861575,80106
9712,47700,65+,7512,6688,14200,"Warsaw, IN",41.244293,-85.861575,80106
9713,47780,15-19,1203,1271,2474,"Washington, IN",38.69609,-87.076943,33397
9714,47780,20-24,952,1029,1981,"Washington, IN",38.69609,-87.076943,33397
9715,47780,25-29,1007,1129,2136,"Washington, IN",38.69609,-87.076943,33397
9716,47780,30-34,985,1031,2016,"Washington, IN",38.69609,-87.076943,33397
9717,47780,35-39,939,1040,1979,"Washington, IN",38.69609,-87.076943,33397
9718,47780,40-44,899,954,1853,"Washington, IN",38.69609,-87.076943,33397
9719,47780,45-49,855,880,1735,"Washington, IN",38.69609,-87.076943,33397
9720,47780,50-54,865,897,1762,"Washington, IN",38.69609,-87.076943,33397
9721,47780,55-59,994,1006,2000,"Washington, IN",38.69609,-87.076943,33397
9722,47780,60-64,983,1021,2004,"Washington, IN",38.69609,-87.076943,33397
9723,47780,65+,2809,2387,5196,"Washington, IN",38.69609,-87.076943,33397
9724,47820,15-19,1244,1342,2586,"Washington, NC",35.482313,-76.842014,44468
9725,47820,20-24,1084,1113,2197,"Washington, NC",35.482313,-76.842014,44468
9726,47820,25-29,1167,1111,2278,"Washington, NC",35.482313,-76.842014,44468
9727,47820,30-34,1176,977,2153,"Washington, NC",35.482313,-76.842014,44468
9728,47820,35-39,1146,1025,2171,"Washington, NC",35.482313,-76.842014,44468
9729,47820,40-44,1309,1209,2518,"Washington, NC",35.482313,-76.842014,44468
9730,47820,45-49,1395,1298,2693,"Washington, NC",35.482313,-76.842014,44468
9731,47820,50-54,1471,1401,2872,"Washington, NC",35.482313,-76.842014,44468
9732,47820,55-59,1638,1576,3214,"Washington, NC",35.482313,-76.842014,44468
9733,47820,60-64,1909,1698,3607,"Washington, NC",35.482313,-76.842014,44468
9734,47820,65+,6076,5061,11137,"Washington, NC",35.482313,-76.842014,44468
9735,47900,15-19,198623,205087,403710,"Washington-Arlington-Alexandria, DC-VA-MD-WV",38.798205,-77.486882,6356434
9736,47900,20-24,191781,190149,381930,"Washington-Arlington-Alexandria, DC-VA-MD-WV",38.798205,-77.486882,6356434
9737,47900,25-29,221835,216118,437953,"Washington-Arlington-Alexandria, DC-VA-MD-WV",38.798205,-77.486882,6356434
9738,47900,30-34,234424,231790,466214,"Washington-Arlington-Alexandria, DC-VA-MD-WV",38.798205,-77.486882,6356434
9739,47900,35-39,241375,237865,479240,"Washington-Arlington-Alexandria, DC-VA-MD-WV",38.798205,-77.486882,6356434
9740,47900,40-44,229157,226223,455380,"Washington-Arlington-Alexandria, DC-VA-MD-WV",38.798205,-77.486882,6356434
9741,47900,45-49,210185,207118,417303,"Washington-Arlington-Alexandria, DC-VA-MD-WV",38.798205,-77.486882,6356434
9742,47900,50-54,217285,213147,430432,"Washington-Arlington-Alexandria, DC-VA-MD-WV",38.798205,-77.486882,6356434
9743,47900,55-59,213370,207582,420952,"Washington-Arlington-Alexandria, DC-VA-MD-WV",38.798205,-77.486882,6356434
9744,47900,60-64,190096,182036,372132,"Washington-Arlington-Alexandria, DC-VA-MD-WV",38.798205,-77.486882,6356434
9745,47900,65+,494044,394052,888096,"Washington-Arlington-Alexandria, DC-VA-MD-WV",38.798205,-77.486882,6356434
9746,47920,15-19,879,981,1860,"Washington Court House, OH",39.555246,-83.461893,28906
9747,47920,20-24,811,812,1623,"Washington Court House, OH",39.555246,-83.461893,28906
9748,47920,25-29,820,872,1692,"Washington Court House, OH",39.555246,-83.461893,28906
9749,47920,30-34,865,875,1740,"Washington Court House, OH",39.555246,-83.461893,28906
9750,47920,35-39,872,822,1694,"Washington Court House, OH",39.555246,-83.461893,28906
9751,47920,40-44,888,873,1761,"Washington Court House, OH",39.555246,-83.461893,28906
9752,47920,45-49,927,872,1799,"Washington Court House, OH",39.555246,-83.461893,28906
9753,47920,50-54,974,968,1942,"Washington Court House, OH",39.555246,-83.461893,28906
9754,47920,55-59,938,993,1931,"Washington Court House, OH",39.555246,-83.461893,28906
9755,47920,60-64,1027,985,2012,"Washington Court House, OH",39.555246,-83.461893,28906
9756,47920,65+,2905,2367,5272,"Washington Court House, OH",39.555246,-83.461893,28906
9757,47940,15-19,6083,5733,11816,"Waterloo-Cedar Falls, IA",42.536796,-92.471608,167796
9758,47940,20-24,8646,8213,16859,"Waterloo-Cedar Falls, IA",42.536796,-92.471608,167796
9759,47940,25-29,5187,5491,10678,"Waterloo-Cedar Falls, IA",42.536796,-92.471608,167796
9760,47940,30-34,4856,5115,9971,"Waterloo-Cedar Falls, IA",42.536796,-92.471608,167796
9761,47940,35-39,5064,5189,10253,"Waterloo-Cedar Falls, IA",42.536796,-92.471608,167796
9762,47940,40-44,4800,5041,9841,"Waterloo-Cedar Falls, IA",42.536796,-92.471608,167796
9763,47940,45-49,4171,4337,8508,"Waterloo-Cedar Falls, IA",42.536796,-92.471608,167796
9764,47940,50-54,4402,4597,8999,"Waterloo-Cedar Falls, IA",42.536796,-92.471608,167796
9765,47940,55-59,4821,4720,9541,"Waterloo-Cedar Falls, IA",42.536796,-92.471608,167796
9766,47940,60-64,5288,5013,10301,"Waterloo-Cedar Falls, IA",42.536796,-92.471608,167796
9767,47940,65+,16411,13742,30153,"Waterloo-Cedar Falls, IA",42.536796,-92.471608,167796
9768,47980,15-19,1140,1227,2367,"Watertown, SD",44.852409,-97.177099,34682
9769,47980,20-24,936,1078,2014,"Watertown, SD",44.852409,-97.177099,34682
9770,47980,25-29,988,1063,2051,"Watertown, SD",44.852409,-97.177099,34682
9771,47980,30-34,1001,1076,2077,"Watertown, SD",44.852409,-97.177099,34682
9772,47980,35-39,1038,1113,2151,"Watertown, SD",44.852409,-97.177099,34682
9773,47980,40-44,1006,1082,2088,"Watertown, SD",44.852409,-97.177099,34682
9774,47980,45-49,870,993,1863,"Watertown, SD",44.852409,-97.177099,34682
9775,47980,50-54,955,1070,2025,"Watertown, SD",44.852409,-97.177099,34682
9776,47980,55-59,1126,1142,2268,"Watertown, SD",44.852409,-97.177099,34682
9777,47980,60-64,1167,1173,2340,"Watertown, SD",44.852409,-97.177099,34682
9778,47980,65+,3292,2942,6234,"Watertown, SD",44.852409,-97.177099,34682
9779,48020,15-19,3114,3282,6396,"Watertown-Fort Atkinson, WI",43.013804,-88.773985,84943
9780,48020,20-24,2375,2579,4954,"Watertown-Fort Atkinson, WI",43.013804,-88.773985,84943
9781,48020,25-29,2265,2359,4624,"Watertown-Fort Atkinson, WI",43.013804,-88.773985,84943
9782,48020,30-34,2427,2499,4926,"Watertown-Fort Atkinson, WI",43.013804,-88.773985,84943
9783,48020,35-39,2826,2736,5562,"Watertown-Fort Atkinson, WI",43.013804,-88.773985,84943
9784,48020,40-44,2668,2774,5442,"Watertown-Fort Atkinson, WI",43.013804,-88.773985,84943
9785,48020,45-49,2557,2767,5324,"Watertown-Fort Atkinson, WI",43.013804,-88.773985,84943
9786,48020,50-54,2838,2931,5769,"Watertown-Fort Atkinson, WI",43.013804,-88.773985,84943
9787,48020,55-59,3171,3225,6396,"Watertown-Fort Atkinson, WI",43.013804,-88.773985,84943
9788,48020,60-64,3152,3123,6275,"Watertown-Fort Atkinson, WI",43.013804,-88.773985,84943
9789,48020,65+,8168,7377,15545,"Watertown-Fort Atkinson, WI",43.013804,-88.773985,84943
9790,48060,15-19,3087,3626,6713,"Watertown-Fort Drum, NY",43.996389,-76.052968,116295
9791,48060,20-24,4090,6964,11054,"Watertown-Fort Drum, NY",43.996389,-76.052968,116295
9792,48060,25-29,4237,6053,10290,"Watertown-Fort Drum, NY",43.996389,-76.052968,116295
9793,48060,30-34,3860,4770,8630,"Watertown-Fort Drum, NY",43.996389,-76.052968,116295
9794,48060,35-39,3698,4222,7920,"Watertown-Fort Drum, NY",43.996389,-76.052968,116295
9795,48060,40-44,2974,3453,6427,"Watertown-Fort Drum, NY",43.996389,-76.052968,116295
9796,48060,45-49,2607,2728,5335,"Watertown-Fort Drum, NY",43.996389,-76.052968,116295
9797,48060,50-54,2961,3010,5971,"Watertown-Fort Drum, NY",43.996389,-76.052968,116295
9798,48060,55-59,3288,3255,6543,"Watertown-Fort Drum, NY",43.996389,-76.052968,116295
9799,48060,60-64,3350,3156,6506,"Watertown-Fort Drum, NY",43.996389,-76.052968,116295
9800,48060,65+,9122,7840,16962,"Watertown-Fort Drum, NY",43.996389,-76.052968,116295
9801,48100,15-19,861,970,1831,"Wauchula, FL",27.492846,-81.82158,25425
9802,48100,20-24,784,988,1772,"Wauchula, FL",27.492846,-81.82158,25425
9803,48100,25-29,735,1053,1788,"Wauchula, FL",27.492846,-81.82158,25425
9804,48100,30-34,735,860,1595,"Wauchula, FL",27.492846,-81.82158,25425
9805,48100,35-39,629,888,1517,"Wauchula, FL",27.492846,-81.82158,25425
9806,48100,40-44,650,782,1432,"Wauchula, FL",27.492846,-81.82158,25425
9807,48100,45-49,758,731,1489,"Wauchula, FL",27.492846,-81.82158,25425
9808,48100,50-54,636,857,1493,"Wauchula, FL",27.492846,-81.82158,25425
9809,48100,55-59,704,756,1460,"Wauchula, FL",27.492846,-81.82158,25425
9810,48100,60-64,660,674,1334,"Wauchula, FL",27.492846,-81.82158,25425
9811,48100,65+,2161,2125,4286,"Wauchula, FL",27.492846,-81.82158,25425
9812,48140,15-19,4773,5307,10080,"Wausau-Weston, WI",45.05398,-89.757905,166189
9813,48140,20-24,4112,4529,8641,"Wausau-Weston, WI",45.05398,-89.757905,166189
9814,48140,25-29,4758,5031,9789,"Wausau-Weston, WI",45.05398,-89.757905,166189
9815,48140,30-34,4628,4838,9466,"Wausau-Weston, WI",45.05398,-89.757905,166189
9816,48140,35-39,5125,5336,10461,"Wausau-Weston, WI",45.05398,-89.757905,166189
9817,48140,40-44,4969,5229,10198,"Wausau-Weston, WI",45.05398,-89.757905,166189
9818,48140,45-49,4670,4998,9668,"Wausau-Weston, WI",45.05398,-89.757905,166189
9819,48140,50-54,5406,5637,11043,"Wausau-Weston, WI",45.05398,-89.757905,166189
9820,48140,55-59,6086,6330,12416,"Wausau-Weston, WI",45.05398,-89.757905,166189
9821,48140,60-64,6213,6509,12722,"Wausau-Weston, WI",45.05398,-89.757905,166189
9822,48140,65+,16836,15234,32070,"Wausau-Weston, WI",45.05398,-89.757905,166189
9823,48180,15-19,1721,1920,3641,"Waycross, GA",31.133114,-82.36865,56009
9824,48180,20-24,1555,1788,3343,"Waycross, GA",31.133114,-82.36865,56009
9825,48180,25-29,1610,1905,3515,"Waycross, GA",31.133114,-82.36865,56009
9826,48180,30-34,1733,1877,3610,"Waycross, GA",31.133114,-82.36865,56009
9827,48180,35-39,1653,1738,3391,"Waycross, GA",31.133114,-82.36865,56009
9828,48180,40-44,1695,1704,3399,"Waycross, GA",31.133114,-82.36865,56009
9829,48180,45-49,1628,1725,3353,"Waycross, GA",31.133114,-82.36865,56009
9830,48180,50-54,1734,1810,3544,"Waycross, GA",31.133114,-82.36865,56009
9831,48180,55-59,1721,1739,3460,"Waycross, GA",31.133114,-82.36865,56009
9832,48180,60-64,1792,1678,3470,"Waycross, GA",31.133114,-82.36865,56009
9833,48180,65+,5559,4280,9839,"Waycross, GA",31.133114,-82.36865,56009
9834,48220,15-19,1221,1184,2405,"Weatherford, OK",35.645601,-98.997386,28163
9835,48220,20-24,1704,1762,3466,"Weatherford, OK",35.645601,-98.997386,28163
9836,48220,25-29,859,919,1778,"Weatherford, OK",35.645601,-98.997386,28163
9837,48220,30-34,801,795,1596,"Weatherford, OK",35.645601,-98.997386,28163
9838,48220,35-39,891,891,1782,"Weatherford, OK",35.645601,-98.997386,28163
9839,48220,40-44,801,843,1644,"Weatherford, OK",35.645601,-98.997386,28163
9840,48220,45-49,609,680,1289,"Weatherford, OK",35.645601,-98.997386,28163
9841,48220,50-54,673,659,1332,"Weatherford, OK",35.645601,-98.997386,28163
9842,48220,55-59,694,737,1431,"Weatherford, OK",35.645601,-98.997386,28163
9843,48220,60-64,789,777,1566,"Weatherford, OK",35.645601,-98.997386,28163
9844,48220,65+,2234,1783,4017,"Weatherford, OK",35.645601,-98.997386,28163
9845,48260,15-19,3454,3516,6970,"Weirton-Steubenville, WV-OH",40.388914,-80.701966,115585
9846,48260,20-24,3435,3502,6937,"Weirton-Steubenville, WV-OH",40.388914,-80.701966,115585
9847,48260,25-29,3116,3211,6327,"Weirton-Steubenville, WV-OH",40.388914,-80.701966,115585
9848,48260,30-34,3239,3362,6601,"Weirton-Steubenville, WV-OH",40.388914,-80.701966,115585
9849,48260,35-39,2882,2993,5875,"Weirton-Steubenville, WV-OH",40.388914,-80.701966,115585
9850,48260,40-44,3231,3217,6448,"Weirton-Steubenville, WV-OH",40.388914,-80.701966,115585
9851,48260,45-49,3484,3399,6883,"Weirton-Steubenville, WV-OH",40.388914,-80.701966,115585
9852,48260,50-54,3719,3892,7611,"Weirton-Steubenville, WV-OH",40.388914,-80.701966,115585
9853,48260,55-59,4175,4008,8183,"Weirton-Steubenville, WV-OH",40.388914,-80.701966,115585
9854,48260,60-64,4732,4501,9233,"Weirton-Steubenville, WV-OH",40.388914,-80.701966,115585
9855,48260,65+,14644,12041,26685,"Weirton-Steubenville, WV-OH",40.388914,-80.701966,115585
9856,48300,15-19,3804,4104,7908,"Wenatchee, WA",47.76611,-120.270197,123342
9857,48300,20-24,3306,3607,6913,"Wenatchee, WA",47.76611,-120.270197,123342
9858,48300,25-29,3540,3908,7448,"Wenatchee, WA",47.76611,-120.270197,123342
9859,48300,30-34,3716,4126,7842,"Wenatchee, WA",47.76611,-120.270197,123342
9860,48300,35-39,3845,4097,7942,"Wenatchee, WA",47.76611,-120.270197,123342
9861,48300,40-44,3684,3785,7469,"Wenatchee, WA",47.76611,-120.270197,123342
9862,48300,45-49,3333,3319,6652,"Wenatchee, WA",47.76611,-120.270197,123342
9863,48300,50-54,3401,3570,6971,"Wenatchee, WA",47.76611,-120.270197,123342
9864,48300,55-59,3783,3743,7526,"Wenatchee, WA",47.76611,-120.270197,123342
9865,48300,60-64,4272,4252,8524,"Wenatchee, WA",47.76611,-120.270197,123342
9866,48300,65+,12567,11422,23989,"Wenatchee, WA",47.76611,-120.270197,123342
9867,48460,15-19,1261,1280,2541,"West Plains, MO",36.774369,-91.887368,39975
9868,48460,20-24,1039,1093,2132,"West Plains, MO",36.774369,-91.887368,39975
9869,48460,25-29,1132,1161,2293,"West Plains, MO",36.774369,-91.887368,39975
9870,48460,30-34,1243,1175,2418,"West Plains, MO",36.774369,-91.887368,39975
9871,48460,35-39,1207,1156,2363,"West Plains, MO",36.774369,-91.887368,39975
9872,48460,40-44,1110,1150,2260,"West Plains, MO",36.774369,-91.887368,39975
9873,48460,45-49,1194,1119,2313,"West Plains, MO",36.774369,-91.887368,39975
9874,48460,50-54,1223,1186,2409,"West Plains, MO",36.774369,-91.887368,39975
9875,48460,55-59,1327,1289,2616,"West Plains, MO",36.774369,-91.887368,39975
9876,48460,60-64,1413,1278,2691,"West Plains, MO",36.774369,-91.887368,39975
9877,48460,65+,4381,3544,7925,"West Plains, MO",36.774369,-91.887368,39975
9878,48500,15-19,603,593,1196,"West Point, MS",33.65967,-88.782468,18535
9879,48500,20-24,563,546,1109,"West Point, MS",33.65967,-88.782468,18535
9880,48500,25-29,614,556,1170,"West Point, MS",33.65967,-88.782468,18535
9881,48500,30-34,608,558,1166,"West Point, MS",33.65967,-88.782468,18535
9882,48500,35-39,578,554,1132,"West Point, MS",33.65967,-88.782468,18535
9883,48500,40-44,593,474,1067,"West Point, MS",33.65967,-88.782468,18535
9884,48500,45-49,562,510,1072,"West Point, MS",33.65967,-88.782468,18535
9885,48500,50-54,585,528,1113,"West Point, MS",33.65967,-88.782468,18535
9886,48500,55-59,635,531,1166,"West Point, MS",33.65967,-88.782468,18535
9887,48500,60-64,709,621,1330,"West Point, MS",33.65967,-88.782468,18535
9888,48500,65+,2051,1547,3598,"West Point, MS",33.65967,-88.782468,18535
9889,48540,15-19,3890,4152,8042,"Wheeling, WV-OH",39.977687,-80.854826,137740
9890,48540,20-24,3618,4278,7896,"Wheeling, WV-OH",39.977687,-80.854826,137740
9891,48540,25-29,3612,4395,8007,"Wheeling, WV-OH",39.977687,-80.854826,137740
9892,48540,30-34,3826,4490,8316,"Wheeling, WV-OH",39.977687,-80.854826,137740
9893,48540,35-39,3781,4201,7982,"Wheeling, WV-OH",39.977687,-80.854826,137740
9894,48540,40-44,3830,4210,8040,"Wheeling, WV-OH",39.977687,-80.854826,137740
9895,48540,45-49,3838,4242,8080,"Wheeling, WV-OH",39.977687,-80.854826,137740
9896,48540,50-54,4262,4535,8797,"Wheeling, WV-OH",39.977687,-80.854826,137740
9897,48540,55-59,4810,4611,9421,"Wheeling, WV-OH",39.977687,-80.854826,137740
9898,48540,60-64,5468,5314,10782,"Wheeling, WV-OH",39.977687,-80.854826,137740
9899,48540,65+,16985,13839,30824,"Wheeling, WV-OH",39.977687,-80.854826,137740
9900,48580,15-19,3831,4234,8065,"Whitewater, WI",42.66811,-88.541731,106799
9901,48580,20-24,4872,4969,9841,"Whitewater, WI",42.66811,-88.541731,106799
9902,48580,25-29,2789,3010,5799,"Whitewater, WI",42.66811,-88.541731,106799
9903,48580,30-34,2485,2804,5289,"Whitewater, WI",42.66811,-88.541731,106799
9904,48580,35-39,2931,3031,5962,"Whitewater, WI",42.66811,-88.541731,106799
9905,48580,40-44,2976,3000,5976,"Whitewater, WI",42.66811,-88.541731,106799
9906,48580,45-49,2947,2944,5891,"Whitewater, WI",42.66811,-88.541731,106799
9907,48580,50-54,3403,3426,6829,"Whitewater, WI",42.66811,-88.541731,106799
9908,48580,55-59,3919,3862,7781,"Whitewater, WI",42.66811,-88.541731,106799
9909,48580,60-64,3995,4079,8074,"Whitewater, WI",42.66811,-88.541731,106799
9910,48580,65+,10724,9665,20389,"Whitewater, WI",42.66811,-88.541731,106799
9911,48620,15-19,21784,23147,44931,"Wichita, KS",37.637896,-97.246287,647919
9912,48620,20-24,20583,22140,42723,"Wichita, KS",37.637896,-97.246287,647919
9913,48620,25-29,21888,22709,44597,"Wichita, KS",37.637896,-97.246287,647919
9914,48620,30-34,21506,21411,42917,"Wichita, KS",37.637896,-97.246287,647919
9915,48620,35-39,21842,21496,43338,"Wichita, KS",37.637896,-97.246287,647919
9916,48620,40-44,19888,20214,40102,"Wichita, KS",37.637896,-97.246287,647919
9917,48620,45-49,17851,17751,35602,"Wichita, KS",37.637896,-97.246287,647919
9918,48620,50-54,18187,18101,36288,"Wichita, KS",37.637896,-97.246287,647919
9919,48620,55-59,19552,19441,38993,"Wichita, KS",37.637896,-97.246287,647919
9920,48620,60-64,21100,20341,41441,"Wichita, KS",37.637896,-97.246287,647919
9921,48620,65+,55659,47291,102950,"Wichita, KS",37.637896,-97.246287,647919
9922,48660,15-19,5064,6478,11542,"Wichita Falls, TX",33.776144,-98.501907,149013
9923,48660,20-24,5050,7120,12170,"Wichita Falls, TX",33.776144,-98.501907,149013
9924,48660,25-29,4634,5845,10479,"Wichita Falls, TX",33.776144,-98.501907,149013
9925,48660,30-34,4884,5590,10474,"Wichita Falls, TX",33.776144,-98.501907,149013
9926,48660,35-39,4666,5247,9913,"Wichita Falls, TX",33.776144,-98.501907,149013
9927,48660,40-44,3959,4606,8565,"Wichita Falls, TX",33.776144,-98.501907,149013
9928,48660,45-49,3647,4050,7697,"Wichita Falls, TX",33.776144,-98.501907,149013
9929,48660,50-54,3820,4030,7850,"Wichita Falls, TX",33.776144,-98.501907,149013
9930,48660,55-59,4535,4454,8989,"Wichita Falls, TX",33.776144,-98.501907,149013
9931,48660,60-64,4786,4689,9475,"Wichita Falls, TX",33.776144,-98.501907,149013
9932,48660,65+,13164,10731,23895,"Wichita Falls, TX",33.776144,-98.501907,149013
9933,48700,15-19,3528,3848,7376,"Williamsport, PA",41.343882,-77.055262,113605
9934,48700,20-24,3377,3468,6845,"Williamsport, PA",41.343882,-77.055262,113605
9935,48700,25-29,3404,3312,6716,"Williamsport, PA",41.343882,-77.055262,113605
9936,48700,30-34,3713,3935,7648,"Williamsport, PA",41.343882,-77.055262,113605
9937,48700,35-39,3570,3502,7072,"Williamsport, PA",41.343882,-77.055262,113605
9938,48700,40-44,3256,3182,6438,"Williamsport, PA",41.343882,-77.055262,113605
9939,48700,45-49,3226,2954,6180,"Williamsport, PA",41.343882,-77.055262,113605
9940,48700,50-54,3596,3495,7091,"Williamsport, PA",41.343882,-77.055262,113605
9941,48700,55-59,3878,3882,7760,"Williamsport, PA",41.343882,-77.055262,113605
9942,48700,60-64,4224,4117,8341,"Williamsport, PA",41.343882,-77.055262,113605
9943,48700,65+,12443,10391,22834,"Williamsport, PA",41.343882,-77.055262,113605
9944,48780,15-19,1146,1225,2371,"Williston, ND",48.355765,-103.501333,38484
9945,48780,20-24,991,1136,2127,"Williston, ND",48.355765,-103.501333,38484
9946,48780,25-29,1478,1723,3201,"Williston, ND",48.355765,-103.501333,38484
9947,48780,30-34,1608,2060,3668,"Williston, ND",48.355765,-103.501333,38484
9948,48780,35-39,1349,1672,3021,"Williston, ND",48.355765,-103.501333,38484
9949,48780,40-44,1004,1361,2365,"Williston, ND",48.355765,-103.501333,38484
9950,48780,45-49,825,1109,1934,"Williston, ND",48.355765,-103.501333,38484
9951,48780,50-54,903,1082,1985,"Williston, ND",48.355765,-103.501333,38484
9952,48780,55-59,947,1041,1988,"Williston, ND",48.355765,-103.501333,38484
9953,48780,60-64,828,1105,1933,"Williston, ND",48.355765,-103.501333,38484
9954,48780,65+,1957,1842,3799,"Williston, ND",48.355765,-103.501333,38484
9955,48820,15-19,1363,1538,2901,"Willmar, MN",45.152714,-95.004981,43767
9956,48820,20-24,1156,1292,2448,"Willmar, MN",45.152714,-95.004981,43767
9957,48820,25-29,1282,1394,2676,"Willmar, MN",45.152714,-95.004981,43767
9958,48820,30-34,1250,1329,2579,"Willmar, MN",45.152714,-95.004981,43767
9959,48820,35-39,1257,1377,2634,"Willmar, MN",45.152714,-95.004981,43767
9960,48820,40-44,1202,1340,2542,"Willmar, MN",45.152714,-95.004981,43767
9961,48820,45-49,1114,1140,2254,"Willmar, MN",45.152714,-95.004981,43767
9962,48820,50-54,1175,1167,2342,"Willmar, MN",45.152714,-95.004981,43767
9963,48820,55-59,1386,1415,2801,"Willmar, MN",45.152714,-95.004981,43767
9964,48820,60-64,1595,1583,3178,"Willmar, MN",45.152714,-95.004981,43767
9965,48820,65+,4517,4064,8581,"Willmar, MN",45.152714,-95.004981,43767
9966,48900,15-19,9769,9072,18841,"Wilmington, NC",34.426033,-77.889634,291833
9967,48900,20-24,12279,11312,23591,"Wilmington, NC",34.426033,-77.889634,291833
9968,48900,25-29,9341,9242,18583,"Wilmington, NC",34.426033,-77.889634,291833
9969,48900,30-34,8957,9122,18079,"Wilmington, NC",34.426033,-77.889634,291833
9970,48900,35-39,9435,8893,18328,"Wilmington, NC",34.426033,-77.889634,291833
9971,48900,40-44,9545,9143,18688,"Wilmington, NC",34.426033,-77.889634,291833
9972,48900,45-49,8895,9009,17904,"Wilmington, NC",34.426033,-77.889634,291833
9973,48900,50-54,9642,9242,18884,"Wilmington, NC",34.426033,-77.889634,291833
9974,48900,55-59,9935,9336,19271,"Wilmington, NC",34.426033,-77.889634,291833
9975,48900,60-64,10708,9179,19887,"Wilmington, NC",34.426033,-77.889634,291833
9976,48900,65+,30501,24297,54798,"Wilmington, NC",34.426033,-77.889634,291833
9977,48940,15-19,1380,1516,2896,"Wilmington, OH",39.416681,-83.804583,42004
9978,48940,20-24,1385,1402,2787,"Wilmington, OH",39.416681,-83.804583,42004
9979,48940,25-29,1223,1237,2460,"Wilmington, OH",39.416681,-83.804583,42004
9980,48940,30-34,1223,1219,2442,"Wilmington, OH",39.416681,-83.804583,42004
9981,48940,35-39,1205,1242,2447,"Wilmington, OH",39.416681,-83.804583,42004
9982,48940,40-44,1286,1293,2579,"Wilmington, OH",39.416681,-83.804583,42004
9983,48940,45-49,1245,1207,2452,"Wilmington, OH",39.416681,-83.804583,42004
9984,48940,50-54,1364,1318,2682,"Wilmington, OH",39.416681,-83.804583,42004
9985,48940,55-59,1433,1477,2910,"Wilmington, OH",39.416681,-83.804583,42004
9986,48940,60-64,1503,1494,2997,"Wilmington, OH",39.416681,-83.804583,42004
9987,48940,65+,4134,3416,7550,"Wilmington, OH",39.416681,-83.804583,42004
9988,48980,15-19,2602,2606,5208,"Wilson, NC",35.700357,-77.921598,78369
9989,48980,20-24,2473,2353,4826,"Wilson, NC",35.700357,-77.921598,78369
9990,48980,25-29,2413,2364,4777,"Wilson, NC",35.700357,-77.921598,78369
9991,48980,30-34,2469,2138,4607,"Wilson, NC",35.700357,-77.921598,78369
9992,48980,35-39,2315,2169,4484,"Wilson, NC",35.700357,-77.921598,78369
9993,48980,40-44,2376,2113,4489,"Wilson, NC",35.700357,-77.921598,78369
9994,48980,45-49,2466,2099,4565,"Wilson, NC",35.700357,-77.921598,78369
9995,48980,50-54,2627,2418,5045,"Wilson, NC",35.700357,-77.921598,78369
9996,48980,55-59,2863,2584,5447,"Wilson, NC",35.700357,-77.921598,78369
9997,48980,60-64,2801,2520,5321,"Wilson, NC",35.700357,-77.921598,78369
9998,48980,65+,8435,6417,14852,"Wilson, NC",35.700357,-77.921598,78369
9999,49020,15-19,4488,4907,9395,"Winchester, VA-WV",39.272974,-78.471828,145155
10000,49020,20-24,3980,4200,8180,"Winchester, VA-WV",39.272974,-78.471828,145155
10001,49020,25-29,4211,4412,8623,"Winchester, VA-WV",39.272974,-78.471828,145155
10002,49020,30-34,4445,4530,8975,"Winchester, VA-WV",39.272974,-78.471828,145155
10003,49020,35-39,4436,4536,8972,"Winchester, VA-WV",39.272974,-78.471828,145155
10004,49020,40-44,4485,4564,9049,"Winchester, VA-WV",39.272974,-78.471828,145155
10005,49020,45-49,4173,4279,8452,"Winchester, VA-WV",39.272974,-78.471828,145155
10006,49020,50-54,4872,4938,9810,"Winchester, VA-WV",39.272974,-78.471828,145155
10007,49020,55-59,5202,5255,10457,"Winchester, VA-WV",39.272974,-78.471828,145155
10008,49020,60-64,5074,4872,9946,"Winchester, VA-WV",39.272974,-78.471828,145155
10009,49020,65+,14439,12886,27325,"Winchester, VA-WV",39.272974,-78.471828,145155
10010,49060,15-19,1293,1308,2601,"Winfield, KS",37.234507,-96.837247,34496
10011,49060,20-24,1084,1199,2283,"Winfield, KS",37.234507,-96.837247,34496
10012,49060,25-29,929,1030,1959,"Winfield, KS",37.234507,-96.837247,34496
10013,49060,30-34,971,1074,2045,"Winfield, KS",37.234507,-96.837247,34496
10014,49060,35-39,1030,1135,2165,"Winfield, KS",37.234507,-96.837247,34496
10015,49060,40-44,999,1062,2061,"Winfield, KS",37.234507,-96.837247,34496
10016,49060,45-49,897,1014,1911,"Winfield, KS",37.234507,-96.837247,34496
10017,49060,50-54,990,1012,2002,"Winfield, KS",37.234507,-96.837247,34496
10018,49060,55-59,1050,1106,2156,"Winfield, KS",37.234507,-96.837247,34496
10019,49060,60-64,1160,1157,2317,"Winfield, KS",37.234507,-96.837247,34496
10020,49060,65+,3452,2840,6292,"Winfield, KS",37.234507,-96.837247,34496
10021,49080,15-19,549,602,1151,"Winnemucca, NV",41.407914,-118.127591,17648
10022,49080,20-24,465,485,950,"Winnemucca, NV",41.407914,-118.127591,17648
10023,49080,25-29,542,584,1126,"Winnemucca, NV",41.407914,-118.127591,17648
10024,49080,30-34,616,631,1247,"Winnemucca, NV",41.407914,-118.127591,17648
10025,49080,35-39,546,684,1230,"Winnemucca, NV",41.407914,-118.127591,17648
10026,49080,40-44,467,582,1049,"Winnemucca, NV",41.407914,-118.127591,17648
10027,49080,45-49,453,523,976,"Winnemucca, NV",41.407914,-118.127591,17648
10028,49080,50-54,487,545,1032,"Winnemucca, NV",41.407914,-118.127591,17648
10029,49080,55-59,513,544,1057,"Winnemucca, NV",41.407914,-118.127591,17648
10030,49080,60-64,543,599,1142,"Winnemucca, NV",41.407914,-118.127591,17648
10031,49080,65+,1296,1348,2644,"Winnemucca, NV",41.407914,-118.127591,17648
10032,49100,15-19,2444,2028,4472,"Winona, MN",43.981353,-91.777044,49630
10033,49100,20-24,3487,3433,6920,"Winona, MN",43.981353,-91.777044,49630
10034,49100,25-29,1316,1529,2845,"Winona, MN",43.981353,-91.777044,49630
10035,49100,30-34,1245,1337,2582,"Winona, MN",43.981353,-91.777044,49630
10036,49100,35-39,1350,1355,2705,"Winona, MN",43.981353,-91.777044,49630
10037,49100,40-44,1252,1399,2651,"Winona, MN",43.981353,-91.777044,49630
10038,49100,45-49,1167,1257,2424,"Winona, MN",43.981353,-91.777044,49630
10039,49100,50-54,1262,1336,2598,"Winona, MN",43.981353,-91.777044,49630
10040,49100,55-59,1436,1465,2901,"Winona, MN",43.981353,-91.777044,49630
10041,49100,60-64,1655,1624,3279,"Winona, MN",43.981353,-91.777044,49630
10042,49100,65+,4749,4291,9040,"Winona, MN",43.981353,-91.777044,49630
10043,49180,15-19,22659,22630,45289,"Winston-Salem, NC",36.078852,-80.345064,681438
10044,49180,20-24,21359,20330,41689,"Winston-Salem, NC",36.078852,-80.345064,681438
10045,49180,25-29,21562,20760,42322,"Winston-Salem, NC",36.078852,-80.345064,681438
10046,49180,30-34,22271,20596,42867,"Winston-Salem, NC",36.078852,-80.345064,681438
10047,49180,35-39,20764,19333,40097,"Winston-Salem, NC",36.078852,-80.345064,681438
10048,49180,40-44,20674,19305,39979,"Winston-Salem, NC",36.078852,-80.345064,681438
10049,49180,45-49,21390,19876,41266,"Winston-Salem, NC",36.078852,-80.345064,681438
10050,49180,50-54,24007,23340,47347,"Winston-Salem, NC",36.078852,-80.345064,681438
10051,49180,55-59,24914,23518,48432,"Winston-Salem, NC",36.078852,-80.345064,681438
10052,49180,60-64,24063,22389,46452,"Winston-Salem, NC",36.078852,-80.345064,681438
10053,49180,65+,68938,54658,123596,"Winston-Salem, NC",36.078852,-80.345064,681438
10054,49220,15-19,2122,2204,4326,"Wisconsin Rapids-Marshfield, WI",44.461413,-90.038825,74070
10055,49220,20-24,1855,1915,3770,"Wisconsin Rapids-Marshfield, WI",44.461413,-90.038825,74070
10056,49220,25-29,2049,2065,4114,"Wisconsin Rapids-Marshfield, WI",44.461413,-90.038825,74070
10057,49220,30-34,1948,2129,4077,"Wisconsin Rapids-Marshfield, WI",44.461413,-90.038825,74070
10058,49220,35-39,2171,2238,4409,"Wisconsin Rapids-Marshfield, WI",44.461413,-90.038825,74070
10059,49220,40-44,2034,2193,4227,"Wisconsin Rapids-Marshfield, WI",44.461413,-90.038825,74070
10060,49220,45-49,1930,2030,3960,"Wisconsin Rapids-Marshfield, WI",44.461413,-90.038825,74070
10061,49220,50-54,2361,2321,4682,"Wisconsin Rapids-Marshfield, WI",44.461413,-90.038825,74070
10062,49220,55-59,2780,2772,5552,"Wisconsin Rapids-Marshfield, WI",44.461413,-90.038825,74070
10063,49220,60-64,2954,2934,5888,"Wisconsin Rapids-Marshfield, WI",44.461413,-90.038825,74070
10064,49220,65+,8551,7316,15867,"Wisconsin Rapids-Marshfield, WI",44.461413,-90.038825,74070
10065,49260,15-19,761,791,1552,"Woodward, OK",36.331293,-99.500686,23967
10066,49260,20-24,622,766,1388,"Woodward, OK",36.331293,-99.500686,23967
10067,49260,25-29,669,927,1596,"Woodward, OK",36.331293,-99.500686,23967
10068,49260,30-34,642,884,1526,"Woodward, OK",36.331293,-99.500686,23967
10069,49260,35-39,708,872,1580,"Woodward, OK",36.331293,-99.500686,23967
10070,49260,40-44,700,914,1614,"Woodward, OK",36.331293,-99.500686,23967
10071,49260,45-49,649,828,1477,"Woodward, OK",36.331293,-99.500686,23967
10072,49260,50-54,608,722,1330,"Woodward, OK",36.331293,-99.500686,23967
10073,49260,55-59,687,704,1391,"Woodward, OK",36.331293,-99.500686,23967
10074,49260,60-64,768,781,1549,"Woodward, OK",36.331293,-99.500686,23967
10075,49260,65+,2216,1946,4162,"Woodward, OK",36.331293,-99.500686,23967
10076,49300,15-19,4061,4297,8358,"Wooster, OH",40.829661,-81.887194,116710
10077,49300,20-24,3655,3947,7602,"Wooster, OH",40.829661,-81.887194,116710
10078,49300,25-29,3333,3523,6856,"Wooster, OH",40.829661,-81.887194,116710
10079,49300,30-34,3391,3579,6970,"Wooster, OH",40.829661,-81.887194,116710
10080,49300,35-39,3303,3381,6684,"Wooster, OH",40.829661,-81.887194,116710
10081,49300,40-44,3204,3274,6478,"Wooster, OH",40.829661,-81.887194,116710
10082,49300,45-49,3190,3217,6407,"Wooster, OH",40.829661,-81.887194,116710
10083,49300,50-54,3416,3339,6755,"Wooster, OH",40.829661,-81.887194,116710
10084,49300,55-59,3761,3841,7602,"Wooster, OH",40.829661,-81.887194,116710
10085,49300,60-64,3990,3934,7924,"Wooster, OH",40.829661,-81.887194,116710
10086,49300,65+,11732,10091,21823,"Wooster, OH",40.829661,-81.887194,116710
10087,49340,15-19,32262,33731,65993,"Worcester, MA-CT",42.217311,-71.925535,978447
10088,49340,20-24,31191,31907,63098,"Worcester, MA-CT",42.217311,-71.925535,978447
10089,49340,25-29,30076,31571,61647,"Worcester, MA-CT",42.217311,-71.925535,978447
10090,49340,30-34,32378,33257,65635,"Worcester, MA-CT",42.217311,-71.925535,978447
10091,49340,35-39,32171,32503,64674,"Worcester, MA-CT",42.217311,-71.925535,978447
10092,49340,40-44,29900,30018,59918,"Worcester, MA-CT",42.217311,-71.925535,978447
10093,49340,45-49,30210,29904,60114,"Worcester, MA-CT",42.217311,-71.925535,978447
10094,49340,50-54,34439,34179,68618,"Worcester, MA-CT",42.217311,-71.925535,978447
10095,49340,55-59,36746,36397,73143,"Worcester, MA-CT",42.217311,-71.925535,978447
10096,49340,60-64,34671,34687,69358,"Worcester, MA-CT",42.217311,-71.925535,978447
10097,49340,65+,89074,74022,163096,"Worcester, MA-CT",42.217311,-71.925535,978447
10098,49380,15-19,739,785,1524,"Worthington, MN",43.677686,-95.763132,21991
10099,49380,20-24,576,683,1259,"Worthington, MN",43.677686,-95.763132,21991
10100,49380,25-29,568,684,1252,"Worthington, MN",43.677686,-95.763132,21991
10101,49380,30-34,583,680,1263,"Worthington, MN",43.677686,-95.763132,21991
10102,49380,35-39,600,751,1351,"Worthington, MN",43.677686,-95.763132,21991
10103,49380,40-44,598,673,1271,"Worthington, MN",43.677686,-95.763132,21991
10104,49380,45-49,533,628,1161,"Worthington, MN",43.677686,-95.763132,21991
10105,49380,50-54,531,720,1251,"Worthington, MN",43.677686,-95.763132,21991
10106,49380,55-59,627,733,1360,"Worthington, MN",43.677686,-95.763132,21991
10107,49380,60-64,641,698,1339,"Worthington, MN",43.677686,-95.763132,21991
10108,49380,65+,1934,1787,3721,"Worthington, MN",43.677686,-95.763132,21991
10109,49420,15-19,9756,10293,20049,"Yakima, WA",46.456558,-120.740145,256035
10110,49420,20-24,8469,8819,17288,"Yakima, WA",46.456558,-120.740145,256035
10111,49420,25-29,8774,8794,17568,"Yakima, WA",46.456558,-120.740145,256035
10112,49420,30-34,8305,8535,16840,"Yakima, WA",46.456558,-120.740145,256035
10113,49420,35-39,7790,7858,15648,"Yakima, WA",46.456558,-120.740145,256035
10114,49420,40-44,7508,7719,15227,"Yakima, WA",46.456558,-120.740145,256035
10115,49420,45-49,6783,6861,13644,"Yakima, WA",46.456558,-120.740145,256035
10116,49420,50-54,6821,6972,13793,"Yakima, WA",46.456558,-120.740145,256035
10117,49420,55-59,6869,7004,13873,"Yakima, WA",46.456558,-120.740145,256035
10118,49420,60-64,6624,6806,13430,"Yakima, WA",46.456558,-120.740145,256035
10119,49420,65+,19388,16805,36193,"Yakima, WA",46.456558,-120.740145,256035
10120,49460,15-19,701,732,1433,"Yankton, SD",43.006603,-97.388361,23297
10121,49460,20-24,688,752,1440,"Yankton, SD",43.006603,-97.388361,23297
10122,49460,25-29,571,847,1418,"Yankton, SD",43.006603,-97.388361,23297
10123,49460,30-34,559,852,1411,"Yankton, SD",43.006603,-97.388361,23297
10124,49460,35-39,603,863,1466,"Yankton, SD",43.006603,-97.388361,23297
10125,49460,40-44,567,822,1389,"Yankton, SD",43.006603,-97.388361,23297
10126,49460,45-49,566,721,1287,"Yankton, SD",43.006603,-97.388361,23297
10127,49460,50-54,639,763,1402,"Yankton, SD",43.006603,-97.388361,23297
10128,49460,55-59,709,848,1557,"Yankton, SD",43.006603,-97.388361,23297
10129,49460,60-64,849,849,1698,"Yankton, SD",43.006603,-97.388361,23297
10130,49460,65+,2539,2153,4692,"Yankton, SD",43.006603,-97.388361,23297
10131,49620,15-19,14129,15069,29198,"York-Hanover, PA",39.921751,-76.728889,458696
10132,49620,20-24,12320,13240,25560,"York-Hanover, PA",39.921751,-76.728889,458696
10133,49620,25-29,13544,14073,27617,"York-Hanover, PA",39.921751,-76.728889,458696
10134,49620,30-34,14548,14987,29535,"York-Hanover, PA",39.921751,-76.728889,458696
10135,49620,35-39,14708,14659,29367,"York-Hanover, PA",39.921751,-76.728889,458696
10136,49620,40-44,14030,14137,28167,"York-Hanover, PA",39.921751,-76.728889,458696
10137,49620,45-49,13687,13571,27258,"York-Hanover, PA",39.921751,-76.728889,458696
10138,49620,50-54,15513,15930,31443,"York-Hanover, PA",39.921751,-76.728889,458696
10139,49620,55-59,16327,16230,32557,"York-Hanover, PA",39.921751,-76.728889,458696
10140,49620,60-64,16236,15850,32086,"York-Hanover, PA",39.921751,-76.728889,458696
10141,49620,65+,45392,38335,83727,"York-Hanover, PA",39.921751,-76.728889,458696
10142,49660,15-19,15326,16880,32206,"Youngstown-Warren-Boardman, OH-PA",41.23646,-80.561784,538069
10143,49660,20-24,15504,16509,32013,"Youngstown-Warren-Boardman, OH-PA",41.23646,-80.561784,538069
10144,49660,25-29,15529,16828,32357,"Youngstown-Warren-Boardman, OH-PA",41.23646,-80.561784,538069
10145,49660,30-34,15061,16331,31392,"Youngstown-Warren-Boardman, OH-PA",41.23646,-80.561784,538069
10146,49660,35-39,14785,15105,29890,"Youngstown-Warren-Boardman, OH-PA",41.23646,-80.561784,538069
10147,49660,40-44,14885,15337,30222,"Youngstown-Warren-Boardman, OH-PA",41.23646,-80.561784,538069
10148,49660,45-49,15023,15289,30312,"Youngstown-Warren-Boardman, OH-PA",41.23646,-80.561784,538069
10149,49660,50-54,17126,17209,34335,"Youngstown-Warren-Boardman, OH-PA",41.23646,-80.561784,538069
10150,49660,55-59,18921,18456,37377,"Youngstown-Warren-Boardman, OH-PA",41.23646,-80.561784,538069
10151,49660,60-64,21308,19787,41095,"Youngstown-Warren-Boardman, OH-PA",41.23646,-80.561784,538069
10152,49660,65+,65943,52939,118882,"Youngstown-Warren-Boardman, OH-PA",41.23646,-80.561784,538069
10153,49700,15-19,6044,6618,12662,"Yuba City, CA",39.160969,-121.511833,182484
10154,49700,20-24,5420,6075,11495,"Yuba City, CA",39.160969,-121.511833,182484
10155,49700,25-29,6226,6713,12939,"Yuba City, CA",39.160969,-121.511833,182484
10156,49700,30-34,6743,6850,13593,"Yuba City, CA",39.160969,-121.511833,182484
10157,49700,35-39,6167,6446,12613,"Yuba City, CA",39.160969,-121.511833,182484
10158,49700,40-44,5678,5778,11456,"Yuba City, CA",39.160969,-121.511833,182484
10159,49700,45-49,4899,4834,9733,"Yuba City, CA",39.160969,-121.511833,182484
10160,49700,50-54,4979,5016,9995,"Yuba City, CA",39.160969,-121.511833,182484
10161,49700,55-59,5233,5420,10653,"Yuba City, CA",39.160969,-121.511833,182484
10162,49700,60-64,5287,5057,10344,"Yuba City, CA",39.160969,-121.511833,182484
10163,49700,65+,14368,12537,26905,"Yuba City, CA",39.160969,-121.511833,182484
10164,49740,15-19,6941,7761,14702,"Yuma, AZ",32.773942,-113.910905,206990
10165,49740,20-24,6568,9533,16101,"Yuma, AZ",32.773942,-113.910905,206990
10166,49740,25-29,6598,8361,14959,"Yuma, AZ",32.773942,-113.910905,206990
10167,49740,30-34,6348,7699,14047,"Yuma, AZ",32.773942,-113.910905,206990
10168,49740,35-39,5689,6859,12548,"Yuma, AZ",32.773942,-113.910905,206990
10169,49740,40-44,5145,5854,10999,"Yuma, AZ",32.773942,-113.910905,206990
10170,49740,45-49,4900,4965,9865,"Yuma, AZ",32.773942,-113.910905,206990
10171,49740,50-54,5105,4925,10030,"Yuma, AZ",32.773942,-113.910905,206990
10172,49740,55-59,5163,4845,10008,"Yuma, AZ",32.773942,-113.910905,206990
10173,49740,60-64,5083,4948,10031,"Yuma, AZ",32.773942,-113.910905,206990
10174,49740,65+,20983,19586,40569,"Yuma, AZ",32.773942,-113.910905,206990
10175,49780,15-19,2566,2665,5231,"Zanesville, OH",39.966046,-81.943506,86408
10176,49780,20-24,2686,2757,5443,"Zanesville, OH",39.966046,-81.943506,86408
10177,49780,25-29,2766,2810,5576,"Zanesville, OH",39.966046,-81.943506,86408
10178,49780,30-34,2670,2594,5264,"Zanesville, OH",39.966046,-81.943506,86408
10179,49780,35-39,2593,2486,5079,"Zanesville, OH",39.966046,-81.943506,86408
10180,49780,40-44,2600,2529,5129,"Zanesville, OH",39.966046,-81.943506,86408
10181,49780,45-49,2559,2472,5031,"Zanesville, OH",39.966046,-81.943506,86408
10182,49780,50-54,2803,2802,5605,"Zanesville, OH",39.966046,-81.943506,86408
10183,49780,55-59,2935,2861,5796,"Zanesville, OH",39.966046,-81.943506,86408
10184,49780,60-64,3144,2920,6064,"Zanesville, OH",39.966046,-81.943506,86408
10185,49780,65+,8876,7039,15915,"Zanesville, OH",39.966046,-81.943506,86408
10186,49820,15-19,553,641,1194,"Zapata, TX",26.996981,-99.182603,13908
10187,49820,20-24,489,504,993,"Zapata, TX",26.996981,-99.182603,13908
10188,49820,25-29,415,442,857,"Zapata, TX",26.996981,-99.182603,13908
10189,49820,30-34,419,385,804,"Zapata, TX",26.996981,-99.182603,13908
10190,49820,35-39,415,420,835,"Zapata, TX",26.996981,-99.182603,13908
10191,49820,40-44,437,394,831,"Zapata, TX",26.996981,-99.182603,13908
10192,49820,45-49,427,373,800,"Zapata, TX",26.996981,-99.182603,13908
10193,49820,50-54,399,327,726,"Zapata, TX",26.996981,-99.182603,13908
10194,49820,55-59,369,307,676,"Zapata, TX",26.996981,-99.182603,13908
10195,49820,60-64,277,294,571,"Zapata, TX",26.996981,-99.182603,13908
10196,49820,65+,964,861,1825,"Zapata, TX",26.996981,-99.182603,13908
